#漢字	音標	解釋
〇	零 星	
㐀	丘	
㐁	𦧖 𠀬	
㐅	五	
㐫	凶	
㐮	襄	
㐯	庸	
㐱	鬒	
㐴	攀	
㐵	儒	
㐷	傌	
㐹	㑶	
㐽	偑	
㑁	𠭴	
㑃	𢲷	
㑄	侮	
㑇	㑳	
㑈	倲	
㑌	尩	
㑔	㑯	
㑝	𢙱	
㑩	儸	
㑮	𫝈	
㑯	㑔	
㑳	㑇	
㑶	㐹	
㑺	儁	
㒄	㦓	
㒇	儛	
㒋	廝 厮	
㒎	𠎷	
㒓	𠉂 达 㣵 𠋽	
㒖	𮯵	
㒚	穩 懚	
㒜	𠇐	
㒞	儶	
㒟	㜵 𱏕	
㒠	𧭸 𠏪	
㒣	𬾖	
㒥	僼 仹	
㒩	𢥾	
㒯	𱏩	
㒰	全	
㒲	財	
㒷	興	
㒻	㫯 㝟	
㒼	䓣	
㒾	𦋤	
㒿	𣯤 𰖩 䍦	
㓁	网	
㓄	𣜣 𪠟 𱑯	
㓎	𠖶	
㓖	𰃻 䬛 䫾	
㓚	㓛	
㓞	𠛉	
㓢	㪾	
㓥	劏	
㓨	刾	
㓮	彫 雕	
㓱	𠞼	
㓴	𠟺	
㓵	𠟎 㗉	
㓷	劓	
㓸	斲	
㓼	𠞩 𠞻 𠞘 𠝱 㔑	
㓾	𠞂	
㔃	㔢 𫦌	
㔅	𫦅	
㔆	𠟆	
㔉	劚	
㔊	𨭖	
㔋	𪟎	
㔍	䥷 䈟 𠟬 𠠀	
㔓	𠚲	
㔗	𠡂	
㔙	𠡮	
㔝	𫦩	
㔡	𠢒	
㔢	𫦳	
㔣	𠢿	
㔤	𱐳	
㔧	勴 𠣊	
㔩	𩇠 𠤅	
㔮	𳍰	
㔱	斞	
㔶	𦽫 㯯 𥂃 𱑉	
㔸	𠥶 𠥃 𨔛	
㔾	卩	
㕋	庈 㕂	
㕑	厨 𢊍	
㕒	嶬 𰆕	
㕙	𠬍	
㕚	爫 爪	
㕞	刷	
㕢	𠭸 𰇀	
㕣	兖	
㕧	𣢁 吚 𣢎 䐖 𣢍 𧥤	
㕻	咅	
㖅	𠲌	
㖇	咡	
㖈	䎛	
㖊	噚	
㖏	𧨚 𧨤	
㖕	㖖 啈 𠯘	
㖞	喎	
㖟	䛵	
㖢	𠹂	
㖥	𠳁	
㖦	𰇎	
㖮	𪠵	
㖷	𠸭	
㗖	噉 啗 啖	
㗗	𠕩	
㗘	𪚈 𠽢 𪚂 𪙍	
㗙	𠴾 𫩩	
㗢	𰇖	
㗣	𫪺	
㗧	㗌 㖽	
㗨	𧥤	
㗫	𡂠	
㗬	𡖹	
㗰	𫩛	
㗲	𠵾 㕷 咟	
㗳	嗒	
㗶	𭇜	
㗻	𫪀	
㗼	𫩤 𡁖 㱉	
㗾	吙	
㗿	𪡛 𠽫	
㘀	𠹠	
㘅	啣 銜	
㘇	𱓲	
㘉	𠰱	
㘋	𱔊	
㘎	㘚	
㘑	囇	
㘓	囒 𪢌	
㘔	𫬐	
㘕	𲘚	
㘖	𰉁	
㘘	𱒢	
㘙	𡆑 𫪂	
㘚	㘎	
㘝	𡇄 𡆴 𢬻 囡 𡆣	
㘠	𡇒 𱕻	
㘤	𡈛	
㘰	𡉜	
㘽	㦳 栽	
㘿	𡍤 圼	
㙀	畂	
㙏	𡑉 𡐣	
㙔	𰉘	
㙡	𭎂	
㙢	𰊟	
㙣	㙊	
㙪	𡏃	
㙬	𫮜	
㙮	塔	
㙯	𮲐	
㙱	𡎪	
㙳	轗 堿	
㙷	𡏀	
㙺	𰊛	
㙾	𰉽	
㚀	隵	
㚋	奝	
㚒	𡙩 夾	
㚕	𡘉 𡗻	
㚖	𡘅 𤽈	
㚗	𡘍	
㚝	奎 奞	
㚟	𤟭	
㚣	姣	
㚯	㜄	
㚸	媤	
㛀	媰	
㛍	𡞡 𮰿	
㛎	𡜅	
㛒	𡟳	
㛗	𡟽	
㛛	娠	
㛝	𫝦	
㛟	𡞵	
㛠	𡢃	
㛣	㜏	
㛤	孋	
㛳	𢝃	
㛴	𡝲 𡜪 𡛛 𡢋 憹 𡡟 𡜣	
㛿	𡠹	
㜄	㚯	
㜅	妶	
㜇	𮱈	
㜍	𡠠	
㜏	㛣	
㜐	𫝧	
㜕	𮱇	
㜗	𡡖 𡣏 𡞋	
㜞	嬱 𰌆	
㜢	𡞱	
㜤	𡤲	
㜥	𫰨	
㜪	嫀 𡣎	
㜭	𫰠	
㜮	𡤱 𫱕	
㜰	𮰽	
㜷	𡝠 𡝡	
㜺	𫲗	
㜻	𱙥	
㝁	𢏔	
㝂	𧏄	
㝃	娩	
㝅	㨌 𡔵 𣫌 榖 𱥗	
㝗	䆡	
㝛	宿	
㝜	𡩤	
㝞	𫳃	
㝟	𫤸	
㝢	𱷇	
㝣	窫	
㝥	𡪘	
㝦	寯	
㝩	𡪼 䆲 𱠏	
㝪	𡫓 𡪐	
㝭	𡪟	
㝰	𡫛	
㝱	𥦡 𡪎	
㝵	礙 碍 䙷 㝶 䙸 㕌	
㝸	覍 𡭪	
㝾	𡯛	
㝿	𤿑	
㞁	𡯣 𡯧 𡰃	
㞂	㾼 𡯵	
㞃	𡯮	
㞄	𡯸	
㞇	𡰂	
㞋	𡰫 𡰦	
㞐	居	
㞒	屓	
㞓	𡱔	
㞛	𡱹	
㞜	𡲾	
㞞	𪨊	
㞴	岻	
㞷	𡴍 呈	
㟅	𡼔	
㟆	㠏	
㟋	𱛯	
㟏	㟔	
㟖	𳈟	
㟗	邠 豳	
㟙	𡽞	
㟜	𡾱	
㟞	𡸚 嶘	
㟢	埼 陭 𥔎 﨑 崎 嵜 碕	
㟥	嵾	
㟦	𮱩	
㟪	嵔	
㟶	㟲	
㟸	𡼗 𡻇	
㟺	𪩇	
㟽	㠒 磦	
㠁	𫶅	
㠆	𡼯 𮱯	
㠊	嶇	
㠍	㠎	
㠎	崨	
㠏	㟆	
㠑	𡽁	
㠘	𱛇	
㠚	𡽵	
㠠	𰎐	
㠢	𡾝	
㠣	𫵷	
㠥	𡿔 𡾊 𡻱	
㠧	𡻥	
㠯	以	
㠱	𢁂	
㠲	𢁦	
㠴	𢂻 𢁯	
㠵	𢂪 𢂠	
㠶	帆	
㠹	𢂵	
㠿	𢃌	
㡂	𢂥 𧙩	
㡄	䘩	
㡅	𢄴 𠕝 𠕰 𣍓	
㡆	㡃 𢂠 㠵 𢂾 㡛 𢁣 𢂩	
㡇	袩 𢃣 𧚊	
㡉	惤 𢮂	
㡊	幍	
㡎	幓	
㡐	𢃬	
㡓	𫷅	
㡘	𢅏 𢅖 𢅳	
㡚	褠 𧛥	
㡞	𰏜	
㡥	𧞎	
㡪	𢅼 𢆃	
㡮	𢇒	
㡳	底	
㡼	𢇸	
㡿	斥	
㢀	𢈠	
㢈	𢈹 㢂 㢑 隤	
㢊	躷	
㢋	㞔 㢁	
㢌	㢐	
㢗	𪪑	
㢚	𢋡 𢊔	
㢝	𢋈	
㢥	戙	
㢦	戨 𢎄	
㢪	弙 𢎰	
㢳	𢏾	
㢻	𢏴	
㣁	𢐖	
㣅	𢏵 𣩳	
㣆	𢑃	
㣇	𢑞 𧱈 𡱃 𱝠	
㣈	𨽼 𠭾 𠮇	
㣎	𤽖 𢒮	
㣤	𧗸	
㣫	徸	
㣬	𢕃	
㣭	𨔩	
㣶	邅	
㣺	心 忄	
㣼	忍	
㣿	𢗇	
㤄	𢘨 𢘀	
㤉	愘 𢗬 𱝽	
㤏	𧖂	
㤒	笨 𢙋 𢡋	
㤖	懧 詝	
㤘	㥮	
㤜	怴	
㤞	𢜬 𢖲	
㤡	㤠 𢤆	
㤭	憍	
㤮	𢞪	
㤲	悏 𫺁	
㤴	𢛏	
㤵	慈	
㤻	𢘵 𢘴	
㤽	懤	
㤿	𢜰	
㥃	懣 悶	
㥆	𢠻 𢘶 𱞩	
㥏	睓 𦖌	
㥚	㤤	
㥛	𢞳	
㥟	𢠟 𢞶	
㥢	𢢕 𱞙	
㥣	𢞨	
㥦	𱞝	
㥪	慺	
㥮	㤘	
㥯	㦩	
㥵	慁	
㥶	𢞝 𢥜 𢥛 𢤑	
㥷	𰑸	
㦁	慩 𢣜	
㦅	慸	
㦈	𢣏	
㦊	𫺆	
㦎	𢛯 𢟸	
㦖	𫺓	
㦚	𨐵 𢤴 𢣑	
㦛	𢗓	
㦝	𢤧	
㦞	𪫷	
㦡	𮲃	
㦦	𫻁 㤸	
㦧	憯	
㦪	𢥥	
㦬	𰑫 𩉙	
㦭	𭝋	
㦰	䇝 𢦝 𢦜	
㦳	㘽	
㦴	㪾	
㦸	戟 𢧢	
㦺	𢾯	
㦿	𣓅	
㧁	𢈊	
㧃	收	
㧊	𢫂	
㧏	掆	
㧐	㩳	
㧑	撝	
㧒	抭	
㧖	扼 搤	
㧚	𢭨	
㧛	擥	
㧜	擸	
㧟	擓 𲄗	
㧦	揈	
㧬	㧭 𢭤	
㧰	擽	
㧳	𢯌	
㧶	揁 𲦂	
㧹	𢰐	
㧺	𩎽	
㨃	𢵌 𲢶 𲡦 𢷮	
㨄	𠠄	
㨉	抿	
㨊	𢸦	
㨗	捷	
㨙	𢭁	
㨚	𢵀	
㨛	𰓔	
㨟	𫼥	
㨠	𢳡	
㨡	𢬼 捆	
㨥	𫽀	
㨧	撪	
㨨	㩅	
㨫	㩜	
㨷	挋	
㨹	𢴥	
㨻	𪮃	
㨼	撂	
㨾	𢵎	
㩁	搉	
㩄	𢳜 嘥 𲢊	
㩅	㨨	
㩇	𫽇	
㩋	𢱩 𢸳 𪮋 𢹱	
㩌	𫽧 𢴢	
㩍	㩞 㨲 拺	
㩕	拎	
㩜	擥 攬 㨫	
㩠	𲣁	
㩣	𫾉	
㩧	𢹯	
㩨	㨹	
㩩	𢹟	
㩭	𫽊	
㩳	㧐 㨦 𲢍 𢱤	
㩵	擜	
㩶	𢰀 𢲺 𢺊	
㩷	𰔲	
㩹	𢶣	
㩻	𤿡 𢼨 攰	
㩼	𢻈	
㩽	𢺷 𢻵	
㩿	㪂	
㪁	鈙	
㪅	更	
㪋	攼	
㪎	𪯋	
㪏	𢽛	
㪗	敨	
㪢	𢾐	
㪯	舉	
㪹	𬖠	
㪺	𣂏 𨟛 𨞜	
㪻	𢍶 𫿳	
㫃	偃	
㫎	𣄈 幑	
㫚	昒 曶	
㫞	㫦	
㫟	昖	
㫱	㬄	
㫶	晭	
㬂	𣈦	
㬅	曼	
㬎	𣊡	
㬓	𣊠	
㬙	𱡼	
㬟	𱤜	
㬢	𮲛	
㬣	𬀮	
㬮	𰖠 𣌖 𣋸	
㬱	朁 𲤎	
㬲	𣍙	
㬳	𦙗	
㬹	踭	
㬿	朜	
㭌	桙	
㭎	棡	
㭏	椲	
㭒	耜 杞 梩 𣐵	
㭙	㯖 棏 𣚅	
㭚	𣖺	
㭣	𣙎	
㭤	樢	
㭨	椰	
㭫	𣖵	
㭰	嘴 𠿘 𡁫 𱜧 𱜶	
㭴	樫	
㭺	𣚖	
㭼	𣒩	
㮃	𦓽	
㮇	𣕊	
㮏	𲵍	
㮓	𣕲	
㮕	𣚊 檽	
㮘	枆	
㮝	𣒗	
㮠	𣞁	
㮣	槩 槪 概	
㮥	桳	
㮧	𱣂 𱣠	
㮭	㮀	
㮯	䚠	
㮲	𣔖 𰗙	
㮴	𣔱 艘	
㮿	𮲰	
㯂	𰘀	
㯃	桼 漆	
㯆	𰗡	
㯔	𥳈	
㯗	𱣡	
㯛	𣝄	
㯤	𣘐	
㯭	樐 櫓	
㯯	𥂃	
㯰	𲢪	
㯱	𣙲 𣞉 𣝐	
㯶	棕	
㯸	𰗦	
㯺	𣠿	
㯻	𡚀 𣠔	
㯼	𣙥	
㯽	檳	
㯿	𲦷	
㰂	棯 𰗵	
㰄	𮲶	
㰅	𭫙	
㰌	𣒆 榷 𣓘	
㰍	櫳 𬺜	
㰙	𣗙	
㰚	樆	
㰟	𣢆	
㰡	𣣶	
㰢	𣢴	
㰣	𣢙 𣢃	
㰤	㗿	
㰥	𣢓	
㰬	𣱡	
㰰	𬅢	
㰱	歃	
㰲	𣤐	
㰳	𭭈	
㰻	歖	
㱆	𢨛 𣤴	
㱇	𢿿	
㱎	𣤿 𧥊	
㱙	𣧔 𣧬 𣦿 𱥍	
㱚	𣧻 𦚛 䏼	
㱞	𣧉	
㱟	𤿇 㨢	
㱠	𣧮	
㱤	𣨗	
㱦	𥏜	
㱩	殰	
㱫	𣩼	
㱮	殨	
㱳	𣩎	
㱴	𣩬	
㱶	𣨥	
㱸	𣩩	
㱾	𣪈	
㱿	壳 殼 𣪊 𱥖	
㲃	𣪙 𦀺	
㲉	𪄽 𣫘 𪇄 𣪹	
㲋	𣬋 𠜌 㚟 𤟭 𲨃	
㲏	𣬢	
㲒	勽	
㲓	毧	
㲔	𣮭	
㲖	𣭱	
㲥	𱥥	
㲪	𣰆	
㲫	𩯱	
㲯	𰚪	
㲰	𰚔	
㲲	𣯉 𣰸 𧟕 𣮨 𬇇 𣰭 𱥦	
㲳	𣱎	
㲴	𣱯 𣱪	
㲽	𱥻	
㲿	瀇	
㳁	汄	
㳄	涎	
㳏	𣳪	
㳐	𣲞	
㳔	濧	
㳕	灡	
㳠	澾	
㳡	濄	
㳢	𣾷	
㳦	𣸂	
㳪	𣳶	
㳷	𣴵 𣷤	
㳽	瀰	
㳾	溬	
㴂	𣼚	
㴋	潚	
㴑	溯	
㴒	湙	
㴔	潝	
㴛	洷	
㴥	𣹝	
㴬	𣽜	
㴵	淧 㵥	
㴸	㶒 𰛛	
㴽	㴮	
㴿	𰛽	
㵅	𲪀	
㵍	𬇰	
㵎	澗	
㵐	灍	
㵑	𰜢	
㵒	沸 𬈕	
㵗	𣳆	
㵞	𣿜	
㵤	𬉇	
㵴	𣻟	
㵺	𤀥 𣴪 渒	
㵻	𤁨	
㵾	𩇟 儬 濪 𪷍	
㶄	𤅸	
㶆	𫞛	
㶇	𦪗	
㶉	鸂	
㶌	𣾍	
㶍	𰝟	
㶏	𰝋	
㶒	𰛩	
㶕	𰝗	
㶖	𲪻	
㶗	𤀇 瀪	
㶛	𤄕	
㶣	𤇇 烎 苂 𱪩	
㶴	𤈕	
㶶	燶	
㶽	煱	
㶿	𤊹 𤉤 𤍗 𤎨 𤏮 𤏰	
㷃	𰝾	
㷅	焣 𤈨	
㷉	熨	
㷍	𤆢	
㷟	煺 𤍐	
㷠	燐 粦	
㷡	煛	
㷣	𤏽	
㷪	𤎱	
㷬	𦹪	
㷮	𤓗	
㷲	𰞉	
㷳	𤎝 𤏚	
㷴	爏	
㷶	𰞲	
㷹	𤒽	
㷻	煳 𭴊	
㷿	𤈷	
㸄	𱫅	
㸅	𰞍	
㸇	𤎺	
㸊	𬋍	
㸎	𲫻	
㸐	𬊾	
㸓	𥄃	
㸕	𬋦	
㸛	牊	
㸜	𤗇	
㸢	𤗌 𤗩	
㸰	㸱 𧣖 𧤓 牠	
㸶	𤚕	
㸸	𤘘 𤛐 𤘽	
㹁	𤚒 𤙝	
㹂	𬌛	
㹄	𤚠	
㹊	𤜅 𤛹	
㹍	𤠻	
㹎	𤛡 𤜖	
㹓	𰠴	
㹔	𤚖	
㹕	𤛰	
㹗	𤛴	
㹙	㹚	
㹚	𱭰	
㹛	𤛽 𤛾	
㹜	犾	
㹝	𤝬	
㹱	猎	
㹶	𤠜	
㹺	𤠡 𦧟	
㹽	𫞣	
㺁	𤠏 𧴙 𧳺 𤝾 𧳀 𧳦	
㺇	𤠒	
㺉	𤠼	
㺊	𤡀 𲮩	
㺍	獱	
㺏	𤠋	
㺐	𤜶	
㺑	𤡅 𤡙 𬌷 𤢖	
㺒	𤠖	
㺕	𤝏	
㺖	𤡘	
㺛	𤟨	
㺜	𪺻 𤣜 𤡤	
㺣	𧲘	
㺤	𤢷	
㺦	𤡨 𤣈	
㺧	𤣣 𤣠	
㺩	玌 㺫	
㺱	𱖌	
㺿	珆 𮴐	
㻅	璯	
㻌	𱯹	
㻍	珸	
㻏	𤫩	
㻘	𤪺	
㻝	㻋 瓎	
㻪	㻽	
㻶	𪼋	
㻷	𤤹 㻋	
㻹	𱗵	
㻽	㻪	
㻾	𤫔	
㼀	𮴘	
㼁	𮴂	
㼆	𬎆 𱯮	
㼈	𭹜	
㼉	𤫯	
㼊	𤫪 𤫭	
㼎	瓝	
㼓	𤬚	
㼔	𤬒	
㼖	𤬤 瓥	
㼡	𱰋	
㼢	𤭘	
㼣	㼟	
㼦	𦈩	
㼧	𤭁	
㼫	𠿜	
㼭	𱰍	
㼲	𤭃 𲰟 𤮁 𦓓 𰢥	
㼵	𦉁 𤭌 𲰢	
㼸	𤮇	
㼻	𬎧	
㼽	𤭪	
㽄	𤭦 𤮓 𤭣	
㽅	𤮘	
㽉	𦉞	
㽕	㕀 𣔴 𣓐	
㽘	奋 𤰢 𲨱	
㽛	𲰺	
㽠	𤲍	
㽢	䎨 䅖	
㽣	域	
㽨	𤳶	
㽩	𤳒	
㽱	𤶀 㽲 𤴮 疓 𤴪	
㽳	疞 𱱔	
㽽	痼	
㽾	𤴰	
㽿	𢈅	
㾁	𤴷	
㾃	𤵚 𤵩	
㾅	𤴹	
㾈	痡	
㾙	脪	
㾚	𤺎	
㾛	𩒸	
㾜	𤷾	
㾡	𤷽	
㾤	啌	
㾨	𥏜	
㾪	𩩭 𤵙	
㾫	𤺇	
㾭	癄 𱱠	
㾰	𤵡	
㾵	𬏟	
㾷	𤺊	
㾹	𤸍	
㾺	𬏜	
㿁	𤻁	
㿃	䐭	
㿄	𤻢	
㿉	𤸉 𰣶 㾯	
㿌	㾾	
㿎	𬏷	
㿒	𤺜	
㿖	𪽮 𬏞	
㿗	𤻊	
㿙	𤼟 𤼤 𤖤	
㿚	𣩿	
㿛	癧	
㿜	𱱰	
㿟	皎 皦	
㿧	𤽯 𤾊 𤾦 嚋	
㿩	𤾉	
㿱	𢯳 𢱺 𢼺	
㿷	糙 𥀞	
㿸	𥀤 𥀗	
㿹	𰤨 𤿹	
㿺	𤿈	
㿾	𧈚 𥃓	
㿿	𥁱	
䀀	𥁔 盕 𥁷 𥁩	
䀁	𥁓	
䀄	𥁶 𥁚	
䀇	𥂩	
䀉	𥁢	
䀊	𣟇 𥂔 𥃃	
䀋	鹽	
䀍	𰥊	
䀑	𮵅	
䀘	𥅝 𥅳	
䀛	䀜	
䀠	瞿 眗 𥇛	
䀢	瞬	
䀥	䁻	
䀨	𥆠	
䀮	𥆆 𥆰 𥉂 𥇫	
䀱	盽	
䀴	𬑏	
䀶	𥈘 㾗 䁁 𥇉	
䀸	䀿 𥇕 晢	
䀹	睫 𥅴	
䀺	𠌪	
䀽	𢌫 𢌨	
䁃	𥌜	
䁅	𥋝	
䁈	𢾥 䁉	
䁊	𥇄	
䁑	𱲥	
䁒	𥊬	
䁓	𥅢	
䁔	睻	
䁖	瞜	
䁙	𥍂 𥈔 𥅥	
䁛	𥍁 𧢦	
䁝	𰥞 覮	
䁥	眤	
䁨	𱳒	
䁩	䐳 𥆐 䏸	
䁪	𥇢	
䁰	𥊾	
䁱	瞘 𬑒	
䁲	𥋻 䚑 𥌚	
䁴	𥊳	
䁵	𥌡	
䁺	𥋭 𱲮	
䁻	䀥	
䁾	𥋚 𧂝	
䁿	𥊷	
䂀	𥋟	
䂆	𥍠 𥍰	
䂉	𥍶	
䂍	𢑾	
䂎	𥎤 𥎝 𥎥	
䂐	𥏞	
䂓	𰦔	
䂔	𥏢 𥏔	
䂘	𮵉	
䂟	𥑆	
䂥	珉 䃉	
䂦	𥒨 䂧	
䂪	𮵐	
䂫	夯	
䂬	𥒽	
䂮	㗉	
䂵	碽	
䂹	𨹾 𥓭	
䂺	𥑉	
䂻	𱳱	
䂽	䂪	
䂾	𱴄	
䃁	𰦴	
䃅	磾	
䃉	珉 䂥	
䃋	𥒏 𥔢	
䃑	斑	
䃕	𰦷	
䃖	𱳳	
䃗	𥓑	
䃘	硜 𬒎	
䃢	𰧎	
䃣	𰦨	
䃤	𬒕	
䃧	𱴶	
䃩	𲳜	
䃫	𥖷	
䃮	鿎	
䃲	𪿱	
䃴	𰧘	
䃸	䃱	
䃹	𥗺	
䄃	殃	
䄆	𥙱	
䄍	蜡	
䄐	𥛁	
䄔	𲀹	
䄚	𥛼	
䄤	襰	
䄥	𥜧	
䄪	𥞗	
䄯	𢆞	
䄶	𥞳	
䄺	稊	
䄼	䄽	
䄿	𥹞	
䅀	𥟜 𥣭 𠞜 𥟸	
䅃	𥞱	
䅆	𥝭	
䅉	稏	
䅌	𧆇 𪌭	
䅍	𥟐	
䅐	𫀨	
䅑	䅗	
䅘	麳 𪎂 𥟂	
䅟	穇	
䅢	粙 䊘	
䅣	䊗	
䅥	𥢸 𥠹	
䅪	𥢢	
䅭	𥻭	
䅱	𲵆	
䅳	𥟷 𫀬	
䅷	稌	
䅺	𥢕	
䆅	𰨳	
䆉	𥝧 𫁂	
䆋	龝 秋	
䆍	𪚗	
䆏	𥤑	
䆓	𥧐	
䆔	竉	
䆕	𥥞 䦑 䆢	
䆖	𥥈	
䆗	𥥎 𲉸	
䆟	㝓	
䆨	𥦏	
䆫	窓 窗	
䆮	𥧲	
䆯	𡢑 𩈽 𩈾 𡢷	
䆲	槺	
䆷	䆕 䆝	
䆽	𥧻	
䇀	𥨳	
䇁	𥩎	
䇂	𨐋 𠍴 愆	
䇅	𥩱 𥩦	
䇍	竐	
䇎	𥪶	
䇏	𥫉	
䇑	𥪎	
䇓	𥪥 𥪙 𩓣 𰩧 䇕 𥪃	
䇘	𥫻	
䇚	𥵜	
䇫	𥭱	
䇲	筴	
䈆	簤	
䈇	罩	
䈘	𥴺	
䈜	𣖯	
䈟	𱷸	
䈢	𥯲	
䈬	箁	
䈱	𥮛	
䈳	㯓	
䈽	𥭤	
䉁	䉹	
䉂	𥳮	
䉅	𥱩 𱷷	
䉆	𮵮	
䉈	𥷭	
䉋	𥶫	
䉌	𥴦 𥶼	
䉍	𬕊	
䉐	𬕛	
䉑	𫁲	
䉔	𥴷 𱸐	
䉙	𥬀	
䉜	𥴢	
䉞	𥴶 𢶦	
䉠	𥰙	
䉤	籔	
䉥	𥳺 𥵅	
䉧	𥳩 𥷢	
䉩	䉱 𱸂	
䉪	𲵹	
䉬	𫂈 𥳊 䕠 蕟	
䉭	𥶢	
䉰	𥰹	
䉱	𬕦	
䉲	𥮜 𥵸 籋 𥵨 𥸀	
䉳	𥬍	
䉵	籑 饌	
䉶	𫁷	
䉷	𥸇	
䉺	粠	
䉻	𥸳	
䉿	䊀	
䊃	𥹸	
䊍	𥣥	
䊎	𥻖 𥹳 𥽊	
䊛	𰪻	
䊜	糰 𰪫	
䊞	籷	
䊟	𰫋	
䊤	𥾁	
䊫	𥼺	
䊭	𥺅	
䊯	𰪩	
䊲	𬡻	
䊵	𮉠	
䊷	䌶	
䊺	𥾙 𫄚	
䋀	𥾩 𡱏	
䋂	𥾥 𥾤	
䋃	𫄜	
䋆	𰬁	
䋋	𱺘	
䋌	䋗	
䋍	𰬂	
䋎	𬘜	
䋏	𮉣	
䋐	𬘙	
䋑	𰬃	
䋔	紴 𫄞	
䋘	𱺛	
䋙	䌺 𦗕	
䋚	䌻	
䋛	𪓋 𥽲	
䋞	𮉦	
䋢	𦆰	
䋤	𦆗	
䋦	𫄩	
䋨	䌗	
䋪	䋍	
䋫	𰬑	
䋬	𦁔	
䋮	𲞯	
䋰	𦀥 𦀤 𦦆	
䋱	𱹴 𱺜	
䋲	繩	
䋵	㡫	
䋶	𦅓 𦄼 綇 𦅨	
䋷	𦃤	
䋸	𦅑 䙉	
䋹	䌿	
䋺	𬘴	
䋻	䌾	
䋼	𦁍 𫄮 𦀚	
䋽	𧛜 𰬭 𥀂 𦂌	
䋾	𬘲 𦅁	
䋿	𦈓	
䌁	𬘱	
䌇	𰬱	
䌈	𦈖	
䌋	𦈘	
䌌	𰬶	
䌏	𦆥 𱺫	
䌐	𬘮	
䌑	䋗	
䌖	𦈜	
䌝	𦈟	
䌞	𬘪	
䌟	𦈞	
䌤	𦆤	
䌥	縯 𦈠 𦅂	
䌨	𦷞 𱺯	
䌩	𦇪	
䌪	𬙁 𦇾	
䌫	纜	
䌬	𱺕 𰫞	
䌯	䙮	
䌰	𦈙	
䌴	䌱 𦇽	
䌵	𦅉 𦆂	
䌶	䊷	
䌷	紬	
䌸	縳	
䌹	絅	
䌺	䋙	
䌻	䋚	
䌼	綐	
䌽	綵	
䌾	䋻	
䌿	䋹	
䍀	繿	
䍁	繸	
䍆	𤱤 𤲑	
䍇	𦈮	
䍍	𦈴	
䍎	𦉙	
䍔	𦊫	
䍘	𥹐	
䍜	羄 𦋜	
䍡	𦌟 𦌏	
䍤	𫅅	
䍨	𦍜	
䍫	𦍔 𦍥	
䍮	𦎉	
䍱	𦍗	
䍶	𤟈	
䍷	𬙭	
䍸	𤝔	
䍺	𦏖	
䍼	𦏋	
䍽	𦏈 𦍠 𦏩	
䎂	𦐙 𲹖	
䎃	𦐘 𦐎 𦐃	
䎄	𣬸	
䎊	𦐦	
䎔	𦒊 䎍 𦐷	
䎕	𦐥 𦑟 𦒃 𦐳	
䎗	𦒓 𦑽	
䎘	𬚄	
䎙	𫅭	
䎛	㖈	
䎠	𦓏	
䎡	𨅲	
䎢	𦓪	
䎤	𦔁	
䎧	稖 𢮏 𦔑	
䎩	𦿨 𤰭	
䎬	䎱	
䎮	𦔝	
䎱	䎬	
䎺	𦕶	
䎼	𦗓	
䎿	𦖣	
䏂	𦖪	
䏆	𦗠	
䏇	𦗩	
䏊	𰭹	
䏐	𦚀	
䏕	飪	
䏖	𦙢	
䏝	膞	
䏠	𦚎	
䏳	𦠟 𦠔 𦠀 𦜋 𦠠	
䏹	𧡬	
䏺	胖 膖 䏾	
䏽	𦜟	
䏿	𦜹 𦜑	
䐁	𡰪 𢁁 𡱰 㞘 豚 叾	
䐄	𦜿 𤎡	
䐇	脗	
䐐	𦝱	
䐑	𦜪 𦜈 𠝝	
䐢	䐍 𰮙 𦛴 𦜻	
䐣	𦠆 𬁽	
䐪	臇	
䐰	饈	
䐱	膪	
䐴	𦟡 䏗	
䐵	𪏍	
䐷	𬂅	
䐹	𰮲	
䐽	𰯎	
䐾	𦡇	
䑀	𱼜	
䑂	𦚪	
䑃	䏵	
䑎	𦢙	
䑔	𤽌 𦥡 𦥥	
䑗	𬛹	
䑙	舚 𲻑	
䑜	𤝓 𤠟 𦧱 𦧢 𦧤	
䑤	𦨽	
䑥	䑪	
䑦	𦨓 𦩷	
䑬	𦩹 𦩄 艞	
䑱	𦨨	
䑴	𦪆 𦨘	
䑺	𱼸	
䑼	𰰌 𦩙	
䑿	𦪲 𦪓 𦪥	
䒀	䑧 䑰	
䒊	𦫦 𦫬	
䒌	𦫭	
䒍	𦫣	
䒒	苕	
䒓	𦫼	
䒢	𦯒	
䒦	𦭢	
䒩	萂	
䒷	𦧔 𦸈 𤫵	
䒸	𦶯	
䒼	𦮒 𧀍 筁	
䓄	𦱄	
䓉	𦳃	
䓊	茣 𦹊 𦸭	
䓓	薵	
䓕	薳	
䓖	藭	
䓙	𦴂	
䓛	𥮝	
䓜	𦽘 𥁼	
䓠	𦵺	
䓣	𬜯	
䓯	𦺇	
䓲	𱽹	
䓼	𦳨 𲼢	
䔀	𦵭	
䔂	𦭄 𦬷	
䔄	𦾾	
䔇	𰰴	
䔈	𰱀	
䔌	𦺆	
䔑	𦳃	
䔘	𧃘	
䔛	檾 𲼇	
䔡	𬝁 䓊	
䔯	𧃗 𨡱	
䔴	𦿎	
䔶	𧀖 𦻀	
䔷	𧂖	
䔸	𦼐	
䔹	𧁂	
䔺	𧁼 𧅢 𧄙 𦳉 𧃚	
䔻	𦼿	
䕀	𦽣	
䕃	蔭	
䕅	𦺋	
䕆	𦸄	
䕈	𦺯 𦼶	
䕌	稚	
䕍	𧃥	
䕏	𮶝	
䕙	𦿐	
䕛	𦽤	
䕞	𦺫 𲼣	
䕠	𱽱	
䕡	𰱩	
䕤	𫟕	
䕥	𱽲	
䕦	萾	
䕩	𧃉 𧀪 𧃬	
䕪	𲼭	
䕳	𦰴 𦱨	
䕵	𧀺 𲼱 𱾎	
䕸	𧅡 𦷓 稭	
䕹	𰰶	
䕺	𱽘	
䕻	𧅳	
䕼	𧅻 𧆖 𬝴	
䕽	薥	
䕿	𧆚 𧆖	
䖀	𰲖	
䖂	虊 𧄶 𲼤	
䖅	𫟑	
䖆	𧅼	
䖈	虐	
䖊	𧆦 𧆤 䖌	
䖍	虔	
䖏	處 処	
䖑	甝 𧇻 𧇅 𧆽	
䖒	𧆲	
䖗	𧇱 麙	
䖘	𧈒 𧇢	
䖙	𠥸	
䖚	𰲟	
䖟	蝱	
䖣	蚤	
䖦	𧌑 𪓭	
䖧	𤷈	
䖭	𧍨	
䖳	𩶱	
䖵	蜫 䐊	
䖶	䝅 鼿	
䖺	𧌁	
䖻	䗜	
䖼	𧍕	
䖿	蟍 𧑇	
䗂	𧌭 𲿋	
䗃	𰲳 𧔢	
䗅	𧐊 𫊪	
䗖	螮	
䗛	𬠡	
䗜	𧏓	
䗠	蜁 𧐗	
䗥	𧐱 𰲯	
䗩	𧐶	
䗯	𧎽 𱿩	
䗷	𧕢 𧔁	
䗸	𧖇	
䗻	𮔂	
䗽	𰳚	
䗿	𧉞	
䘆	𱿹	
䘋	䘂	
䘑	脉	
䘓	𧖾 𧗛 𧗜 𧗀 𧗐	
䘚	卒	
䘛	𧝞	
䘞	𧜗	
䘟	𧘨	
䘣	𧙁	
䘳	𧛛	
䘺	綻	
䘿	袦	
䙃	𧝍	
䙄	𧚎 𧛳	
䙅	䌁	
䙊	𧜵	
䙌	䙡	
䙎	𧜋 𦃝	
䙓	襬	
䙔	𫋲 𧞨	
䙕	𧛝	
䙘	𧞰 䙯	
䙙	𧞽 𧛺	
䙝	褻 褺	
䙟	𧝖 𧝕	
䙡	䙌 𧝷	
䙣	𧞁	
䙦	𧜩	
䙱	𧜭 襩	
䙲	𦧂 䙴 𧟨 𦦒 𦦉 𠨧	
䙹	𧠻	
䙼	𰴖	
䙾	𧠡 𧠉 𧠜	
䚅	𧡛	
䚆	𬢑	
䚉	𬢐 𧡘	
䚋	𧡡	
䚍	𧢔	
䚎	𥅾	
䚐	𧡐	
䚕	𥊨 矖 𧢮 𥉆 𥊂 𥌿 𰴗	
䚗	𧢸	
䚘	𧢴	
䚙	𧣰	
䚜	𧤃	
䚞	𰴤 䚟	
䚟	𲥞	
䚢	𧤇 𧤈	
䚣	𧤘	
䚦	𧤫 𧤧	
䚨	𧤔 𧢿 𧣘	
䚩	𫌯 𧤦	
䚪	𧤩	
䚮	𧦛 𧦯 𧥰	
䚳	𬣛	
䚵	𬣟	
䚻	𧦇 𧦗	
䚽	𬣜	
䛀	𰵐	
䛁	𠊌 𧦦 𧧛	
䛄	𫍠 𧩷 𧧁	
䛅	𲂆	
䛋	𧧟	
䛌	𰵜	
䛍	𬣧	
䛏	呢	
䛓	譼	
䛔	𲂈	
䛗	𧧰	
䛘	𬣯 䚾	
䛛	𬣬	
䛞	𬣸	
䛟	𰵢	
䛠	𰵫 𧪧	
䛡	話	
䛤	𬣹	
䛩	𧪛 䜑 𲂉	
䛬	䛌 𬤁	
䛭	啈 𧨫 𰵰	
䛳	𫍫	
䛴	𮷈	
䛻	誘	
䛼	譭	
䛽	𧪗 𬤌 𧬿	
䛿	𬤑	
䜀	䜧	
䜂	𰶅	
䜄	𰶈	
䜇	謴	
䜈	𧭄	
䜉	𧬠 𬤘	
䜊	嘈 𲂓	
䜋	𧭾 𬤉	
䜌	𤔪 𠧏 𤕍 𠮗 𠧎 𲬜	
䜍	𬤟	
䜎	𬣿	
䜏	䜐 𧨧 䜔 𧩭 𰶇	
䜒	𬤡	
䜕	𧮇 𧮚 𧮏 𧭡	
䜖	𫟢	
䜙	𲂒	
䜚	𬤪 𧮅	
䜝	𬤬	
䜣	訢	
䜤	鿁	
䜥	𧩙	
䜧	䜀	
䜩	讌	
䜪	𧮭	
䜰	𧯔 𧯌	
䜱	𧯐	
䜶	豇	
䜼	𧯸	
䜾	𧯹	
䝁	𦺜 𥢒 𧰉 𲮹 𲮑	
䝃	𧰁	
䝄	𳂃	
䝆	𣊸 𧰮	
䝇	豗	
䝋	豵 𧱭 𧱍	
䝏	𰶬 𧲕 㺏	
䝐	𧱫 𧲆 𧲚 𧱞 𤡪 𧲑	
䝒	𧱛	
䝕	𬥄 𤣒	
䝙	貙	
䝜	狻	
䝟	𧳳	
䝡	𬥊	
䝤	獠	
䝧	𧵣	
䝩	𧵉	
䝪	𧶳	
䝭	𫎧	
䝯	𬥵	
䝰	𧶱	
䝻	𧹕 𡨢	
䝼	䞍	
䞀	𬥽	
䞁	𬥺	
䞂	𧸀 𬥻	
䞆	𧶈 𧷣	
䞈	𧹑	
䞉	𰷩	
䞊	𧸥 賐	
䞋	𫎪	
䞌	𧵳	
䞍	䝼	
䞎	𧶧	
䞐	賰	
䞓	赬 𫎭	
䞔	𧹧 𧹹	
䞕	𧹸	
䞘	𧺞	
䞚	𧼘	
䞞	𧼗	
䞤	㣘 𠹪 跔	
䞫	𧼐	
䞵	䟾	
䞶	𬦅	
䞾	𧼥	
䟂	𧾈	
䟃	𫎺 𧾋	
䟄	𨖊 䞰 𲃏	
䟅	𧽯	
䟆	𫎳	
䟈	𧾞	
䟍	𧾫	
䟏	𰷴	
䟐	𢖙 𢔸 𧽺 𫎱	
䟒	𧼚	
䟘	𧿦	
䟛	𧿳 𧺡	
䟡	𧿟 𧿠	
䟢	躎	
䟣	𤝞	
䟫	𨅝 蹚	
䟸	䠏	
䟺	𬦥	
䟼	𨅐 𨖴 躌	
䟽	疎 疏 踈	
䠄	𨆁	
䠅	𨁉	
䠆	𫏃 𨅝	
䠇	𠡰	
䠑	𨅆	
䠜	𨒆	
䠟	𨄧 𰸈	
䠠	𰸛	
䠡	躦	
䠨	𨅧	
䠩	𰸊	
䠭	𳃦	
䠮	𬧃	
䠯	𨈋 𨈅	
䠱	躅 𨅛	
䠸	𨉀	
䡁	𬧢	
䡄	𮷖	
䡅	𰹳	
䡆	䡥	
䡇	軏 𰹷	
䡊	𰹺	
䡐	𫟤	
䡓	𲀝	
䡔	𨌋	
䡕	𨌱 𨋬 𨍗	
䡗	𬨆	
䡘	䡒 𬨉	
䡝	𰺑 䩩	
䡞	𨍯 𨋧	
䡟	𨌦 𬨌	
䡦	𬨑	
䡩	𫟥	
䡫	𨏕	
䡯	𨌪	
䡰	𨎁 𰺘 𨋔	
䡴	𰺝	
䡵	𨍨 𫟦	
䡶	𬨔	
䡷	𰺡 𳄍	
䡹	𬨕	
䡻	𰺤	
䡽	𨏘	
䡾	𨏾 𰺠	
䢀	𨊰	
䢁	𨊸	
䢂	𨋢	
䢆	𲆵	
䢈	𰺭	
䢌	𧺡 𨒠 𧺺	
䢖	𨀞	
䢙	敗 𠟻 𲅑	
䢡	𨓫 𨔋	
䢥	𨕐	
䢨	𨑹	
䢱	𨙜	
䢹	𨞙 𨞦	
䢼	䣏	
䣂	𨛙 𦓥 洡	
䣄	𨝛 𲆙	
䣊	䣣 𨜂	
䣔	𨝉	
䣕	䣖	
䣘	𨟐 𨞱	
䣢	䎰 𨞒	
䣩	醇	
䣪	𨠓 䣮	
䣬	𨟶	
䣵	䤊 𨠧	
䣽	𨢱 𨢰	
䣿	𨡖	
䤇	醙	
䤉	𨠔	
䤌	𮠞	
䤍	𨢥 𰼑	
䤎	𪊀	
䤏	𨢙	
䤓	䴿 𨣘 𨢊	
䤔	𳅝 𳅘	
䤘	𨣲 醦	
䤙	𨣰	
䤝	𲇳	
䤠	𰽠	
䤤	𫟺	
䤥	𰽺	
䤨	釽 𰽸	
䤩	𬭈	
䤪	𨦃 𬭆	
䤬	𨪍 𰾈	
䤭	𮸌	
䤴	䥁	
䤵	𰾐	
䤸	𰾦	
䤹	鎪	
䤻	𰾖	
䤼	𬭣	
䥀	捵	
䥄	𫠀	
䥇	䦂	
䥈	𳇰	
䥉	鋺	
䥊	𲈄	
䥏	𨯣 𨨶	
䥑	鿏	
䥓	𮸞	
䥔	𲈙	
䥕	𬭯	
䥖	𰾻	
䥗	𫔋	
䥛	𬭴	
䥝	𰿁 𨰅	
䥞	𬭻	
䥨	鑢	
䥩	𨱖	
䥪	𮸗	
䥯	𫔆 䎱 𨰟	
䥱	䥾	
䥴	𰿅	
䥶	𰽝	
䥷	㔍 𨰉 𰿇	
䥸	𨧮	
䥺	釾	
䥽	鏺	
䥾	䥱	
䥿	𨯅	
䦀	𨦫	
䦁	𨧜	
䦂	䥇	
䦃	鐯	
䦅	鐥	
䦆	钁	
䦈	𨲠	
䦊	𨲂 𩭑	
䦋	𨲶	
䦌	𮤬	
䦎	𰿨	
䦏	𨳿 𨳚 𨳜	
䦓	覘 𦕒	
䦖	𮸥	
䦘	𨸄 𨵬 𣐻 𢩆	
䦛	䦶	
䦜	𲉀	
䦝	𬮨	
䦟	䦷	
䦣	𮸦	
䦪	𰿴	
䦯	𫔵	
䦱	𰿫 𨷕	
䦳	𨷿	
䦵	𨳴	
䦶	䦛	
䦷	䦟	
䦹	𨙩	
䦼	𨼱 𨺤	
䧎	𨹆 𨸫	
䧞	𬮺	
䧢	𨸟	
䧤	𨽂	
䧨	𨼙	
䧴	鳷	
䨄	𩀂 䳺	
䨇	𫪉	
䨈	𧵯	
䨊	𩁵	
䨏	𩄚 𩆃 𩆂	
䨘	霰	
䨛	𩄜 𩂨	
䨡	𩄥 𩄙	
䨥	𩆀	
䨲	㝹 𢉕 𩆟	
䨴	𩅆 𩅲 𩅫 𩅥 𩆰 𩄮 𱁒	
䨺	𩅣 𲐈	
䨽	𩇯	
䨿	𩇺 䪞	
䩁	靟	
䩄	靦	
䩉	𩒺 𩈨 𩠤	
䩊	𩈱	
䩋	𩉑 𩉚	
䩌	𩉈 𤎂	
䩐	𩉟	
䩒	𩉞	
䩕	𩊕	
䩖	𩊮	
䩛	𩉫	
䩞	韂	
䩠	鞓	
䩤	䩐 𮸮	
䩫	𬰥	
䩯	𩏊	
䩰	𩍮	
䩳	𩌱 𩌅	
䩸	𣮩 㲨 𩊐 𩉪 𣯏	
䪁	𩍩 𩋼	
䪂	𩎎	
䪊	龓 𫖅	
䪍	𱁽	
䪎	鞖	
䪏	𩏼	
䪐	𱂅	
䪑	𩎼	
䪓	𬰳	
䪗	𩐀 𩋥 縀	
䪘	𩏿	
䪙	䪖 𩋟 𩏮 䪔	
䪜	𬰷	
䪝	𱂌	
䪡	𩐒	
䪤	𩇾 𩐏 𩇼	
䪥	𱂎	
䪦	𠲓	
䪫	𩐺	
䪬	𥩾	
䪯	𳊮	
䪱	𩒁	
䪴	𩑜 𫖫	
䪸	𩔉	
䪼	𱂢	
䪾	𩒉 𫖬 𩒀 𩒈	
䪿	囟	
䫀	𫖱 𩑡 𩓓 𩒝	
䫁	𩓑	
䫂	𫖰	
䫇	𩓿	
䫈	𬱣 侺	
䫉	𬥈	
䫌	𱂮	
䫏	𬱦	
䫐	𬃲	
䫑	䫏 𠎞	
䫒	䪸 𩔉 𩑥	
䫖	𲊾	
䫜	𬱮	
䫟	𫖲	
䫠	𬱰 𩓭 𩔌 𩓄	
䫥	𱆚	
䫦	𩕭	
䫧	𩕍 𩔇	
䫨	𩓁 𩕀 𩕣	
䫩	𬱬 𩕞	
䫫	𲋀	
䫬	𩕗	
䫲	𲋃	
䫴	𩖗	
䫶	𩕒 𫖺	
䫸	𩖙	
䫺	𩖢 𲋎	
䫻	𫗇	
䫼	𬱷	
䫽	𲋏	
䫾	𩘆 𫠈 䬛	
䬀	𱃖 𩘈	
䬂	𬱸	
䬅	𱃚	
䬆	𩘟	
䬌	𩗸	
䬍	𩗛 𩙤 𩘐 𬲀 𩖨	
䬎	𬱿	
䬐	𱃜 𡣉 𩗯	
䬑	𩙊 𩘤	
䬒	颼	
䬓	𫗊	
䬔	𱃞	
䬘	𩙮 𩘲	
䬝	𩙯 𩙁 䬖	
䬞	𩙧 𩘿 𩗡	
䬟	𩙗 𩙔 𩙄 𩗩 𱃙 𩗌	
䬡	翥	
䬣	𱃱 𩜐 𩚋	
䬦	𳋨	
䬧	𫗟	
䬪	𱃳	
䬫	𬲮 𩚨 𩚞 𩛀	
䬬	𱃵	
䬯	𬲫	
䬰	𲋤	
䬲	𩚘 𬲯	
䬳	𱃷	
䬶	𬲷	
䬷	𩜉	
䬹	𱃸	
䬼	𩟁 𩝤	
䬽	䭨 𩟥	
䬾	𬲻	
䬿	𥹹 䅏 䊊	
䭀	𩠇 𩛓 𨑏	
䭂	𨜀 𦤡	
䭃	𩠈 飪 餁 𪌿	
䭅	𬲾	
䭇	𬳀	
䭈	𩱤 飦 𩱡 𩱃 𱄃 𩛧 䊕	
䭉	𩟆 𪍳 𬳅 𩞢	
䭐	𩞭 䭥 䬺	
䭑	𫗱	
䭒	𬳋	
䭓	𱃹 䅱	
䭔	𫗰 𩛍 𪌤 䊚 𩜀	
䭕	𬲕 𩞏 𩟗	
䭘	鐛 䬬 䭗 𬳑 䭊	
䭙	𩞲	
䭚	噇	
䭞	𬲳	
䭡	𱄉	
䭢	𬲲	
䭣	𬲶	
䭤	𳋲	
䭧	䭩	
䭪	𩞯	
䭭	𬱯 𩠬	
䭮	髴 𩠷 𩭻	
䭱	𩠿 𩡡 𩡀 𩡈 𩡄 𩡅	
䭴	𩡪	
䭷	𳌗 𰚧	
䭷	𧲢	
䭹	𩣍 䭺	
䭻	𩡱	
䭾	馱	
䭿	𩧭 𩡹	
䮂	𩢚 𱅄	
䮄	𫠊	
䮈	𬳾	
䮉	𩥜	
䮎	𩥀	
䮔	𩦛 𩥗 𩦁 𩣷	
䮗	𬴁 𩤧	
䮝	𩧰	
䮞	𩨁	
䮠	𩧿	
䮢	𩤪 𩣙	
䮤	𩧏	
䮧	𱅠	
䮫	𩨇	
䮰	𫘮	
䮲	𱅦	
䮳	𩨏	
䮴	𲌋	
䮵	𩦍	
䮷	𩧈	
䮸	𬳸	
䮽	𬴍	
䮾	𩧪	
䮿	𬴏	
䯀	䯅	
䯃	𩣑	
䯄	騧	
䯅	䯀	
䯆	𢎀 骮	
䯈	𩩁	
䯊	胢	
䯋	𳌙	
䯌	尻 𩩾	
䯍	𩪥	
䯏	𩩎	
䯔	𩨛	
䯘	𩩕	
䯚	𩩣 𩨴 𩩓	
䯣	𩪹	
䯤	𩩈	
䯦	𩪻	
䯰	𩬉	
䯱	𩬋 𣬾 𩬴	
䯻	髻	
䯽	𩭍 𩭸 𩔻 𢒷	
䯾	𩯦	
䰃	𩮗	
䰈	𩯸	
䰉	䰔	
䰎	𩯿 𱆃	
䰐	𱆅	
䰒	𩮡	
䰓	𩮇 𩯠	
䰖	𱆈 𩯳 𨳄 𩯒	
䰗	鬮	
䰙	鈘	
䰟	魂	
䰠	𩴋 𩳱	
䰡	𩲥 𩳦 𣧞 𩲫 𩳂	
䰧	𩳰 𩲼	
䰩	𩴟	
䰫	𱆙 𲑹	
䰬	𩴢	
䰯	𩴷	
䰰	𩴶 䰭	
䰲	𱇍	
䰳	𳎑	
䰶	𲍈	
䰷	𬶆	
䰸	魟	
䰻	𱇕	
䰼	𩷒	
䰽	𱇑 𩶚	
䰾	鲃	
䱀	𫚐	
䱁	𫚏	
䱂	𱇤	
䱅	𱇚	
䱇	鱓 𱇞	
䱊	𲍐	
䱋	𲍎	
䱌	𱇬	
䱍	䱎 𬶊	
䱎	䱭 䱴 𱈈 𳍱 䱍 𮫵 𱇥	
䱏	𩶃	
䱐	𱇲	
䱒	𱇰	
䱓	𬶓 𩹇	
䱕	𧉯 𩶋	
䱗	𮬞 𳍺 𳎀 𩼇 𩽐	
䱙	𩾈	
䱚	𮬠	
䱛	𮬟	
䱜	𩻶 𱇷	
䱝	𲍕	
䱞	𩺚	
䱟	𱈀	
䱠	𩻣 𩹆	
䱡	𱇽 𩽘 𩼥	
䱤	𩹴 𱇻	
䱥	𱇹 䱨 鯯	
䱧	𫚠	
䱬	𩾊 𩸠	
䱭	𱈇	
䱮	𩹃	
䱰	𩾋	
䱱	𬶤 𩹋	
䱴	𱈈 𳍱 䱭	
䱵	𮬢	
䱷	漁 䲣 𲌶	
䱸	𫠑	
䱹	𬶣	
䱻	𮬡	
䱽	鯧 䲝	
䱾	𱈆	
䲀	𩻉 𳎖	
䲁	鳚 𩻍	
䲅	𫚜	
䲉	𱈒	
䲊	𩼐 鰖 𩷷 𩼂	
䲌	𩺶	
䲎	𲍙	
䲏	𬶗	
䲑	𲍇	
䲒	𩼠	
䲕	𬶴	
䲖	𩾂	
䲗	𮬣	
䲘	鳤	
䲙	𬶎	
䲚	𩽓 𱈖	
䲛	𱈛	
䲝	䱽	
䲞	𩶘	
䲟	鮣	
䲠	鰆	
䲡	鰌	
䲢	鰧	
䲣	䱷	
䲤	鿐	
䲦	𩿁	
䲨	𬷾	
䲬	𪀍 𨾛	
䲰	𪉂	
䲸	𮭡 𩾴	
䲹	𱉖 𪀇	
䲼	𬸆	
䲽	𡫰	
䲾	𨾢 𩿸	
䳁	䳊 𨾩	
䳂	𲍲	
䳃	𪂭	
䳄	𲍵	
䳅	𩿦 𱉙	
䳆	𳐆	
䳇	𱉞	
䳍	𮭥	
䳎	𨾹	
䳏	鴂 𱉤	
䳑	𲍳	
䳒	𱉧	
䳓	𱉦 𪀧 𳐇	
䳔	𨿀 䳎	
䳕	𪃽 𨿚 𱉺	
䳙	𩿭	
䳚	𨿑 𱉶	
䳜	𫛬	
䳝	𨿦	
䳟	𱊂 𪂡 𪆌	
䳡	𲍾	
䳢	𫛰	
䳤	𫛮 𪂟	
䳥	𮹗	
䳦	𩀈 𪃗	
䳧	𫛺	
䳨	𬸛	
䳩	𩀄	
䳫	𫛼	
䳭	𱉼	
䳮	𱊓 𪅚 𪃻	
䳲	𪁧 𱊙	
䳳	𪃚 𪅁	
䳴	𩀚	
䳵	𪄪	
䳺	𱊣	
䳻	𩀧	
䳽	𮹙	
䳾	𳐕	
䳿	𪆈	
䴀	𳐔	
䴃	𩀸	
䴅	𩿜 𩀴	
䴇	𱊪 𩁎	
䴈	𬸩	
䴉	鹮 𩙽 䴋	
䴋	𫜅	
䴌	𲎈	
䴏	𮹜	
䴑	𳏶	
䴓	鳾	
䴔	鵁	
䴕	鴷	
䴖	鶄	
䴗	鶪	
䴘	鷈 鷉	
䴙	鷿 鸊	
䴚	𨟼 𪉛 𮭰 𪉡 㽘	
䴛	𳐜	
䴝	𱊼 𪉼	
䴠	𪊏	
䴨	𳐻	
䴬	𪎈 䄩 𪍋	
䴭	𬹅 𪌎	
䴮	𱋆	
䴯	𪍃	
䴱	𫜒 𥹈	
䴲	𥽘 𱋊	
䴳	𱋎	
䴴	𪎋	
䴵	𱋔	
䴷	𬹉	
䴸	𱋗	
䴹	餜 𪍯 䴷 𪌽 𱋙	
䴺	𱋝	
䴻	𪍆	
䴽	𫜔	
䴾	𪍰 䑘 𪎀 𱋧	
䴿	䵆	
䵀	𪍨	
䵂	𱋪 𪍼	
䵃	𪍿 𱋫 䊣	
䵆	𱋮	
䵈	𪎤	
䵉	𪎨	
䵋	𪏇 𪏞	
䵎	𪏝 𪏖	
䵏	𪏧	
䵐	𱋴	
䵑	䵒	
䵒	䵑 𪐌	
䵔	𪐈	
䵖	𬹔	
䵘	𬓸 𱤅	
䵝	𪐘	
䵡	𪐡	
䵣	𪐪 𪐵	
䵬	𪒂 𪑥	
䵯	畽	
䵳	𪒜 𪐹 𪑅	
䵴	𪓱 𫜙	
䵵	𧅌	
䵶	𪓩 𱌁 𪚶 𪓟 𪓞 𡳟	
䵷	𱌃	
䵻	𪔊	
䶀	鞈	
䶂	𪕺	
䶃	𪕛	
䶅	𪕘	
䶆	𪕪	
䶊	𪖔	
䶎	𪖨 𪖗	
䶏	涕 𪖦	
䶒	𠆜	
䶕	𫜨	
䶗	𮯙 𳑪	
䶛	𪘼 𪙂 𪗿	
䶝	𪘘	
䶞	𪗞	
䶠	䶢 𬺍	
䶢	𬺍 䶠	
䶣	𤘑 𬺃	
䶥	𪙁 𪙵 𲎥	
䶦	𬺉	
䶧	𱌰	
䶨	𱌵	
䶩	𪗊 𪙘	
䶪	𪙻 𬺕	
䶬	𪚟 𪚜 𪚒	
䶮	龑	
䶱	𪚽 𱍇	
䶲	𪚮 𫜳	
䶳	𤒀	
䶴	𪛐 龡 𪛑	
一	壹 弌 𭟮 𠤪 𫜢	
丁	𠆤	
七	柒 漆 𠀁 𠀣	
丄	上	
丅	下	
万	卍 卐 萬 𮯵	
丈	𠀋	
三	叁 叄 參 弎	
上	丄 𱝫	
下	丅 𠄟	
丌	亓 其	
不	㐬 𠙐 𠀚	
与	與	
丐	匃 𠣣 𠣏 匄	
丑	醜 丒 𠃠	
专	專 専	
且	𠀃 𣅂 𠀇 𱑲	
丕	𠦓 㔻 㶨	
世	卋 丗 芔 𠦔 㔺 𲓤	
丗	世 卋	
丘	丠 坵 㐀 业 㘳 𠀈 𠤢 𡊣 𤤘 𠀉	
丙	𱒑	
业	業 𱬠	
丛	叢	
东	東 𱣟	
丝	纟 絲	
丞	㞼 𱝟	
丟	丢	
丠	丘 坵	
両	兩 两	
丢	丟	
丣	酉	
两	兩 両	
严	嚴 厳	
並	竝 并 幷 併 𡘋 傡	
丧	喪	
丩	𠃏 𢒥 𠂈	
个	個 箇	
丫	椏 亞	
丬	爿	
中	𠁩 𠔈 𠁦 𠔗 𠁧	
丮	𢩦	
丯	丰	
丰	豐 𡴀 䒠	
丱	卝	
丳	𠁷	
临	臨	
丶	𪐴	
丸	𠁽	
丹	𠕑 𠁿 㣋 𢒈 𮯱	
为	爲 為	
丽	麗	
举	挙 舉 擧 𱣅	
乀	乁	
乂	刈 㣻	
乃	迺 廼 𢎧 𠄎 弓 𠚝 𢏩 𠧤 𠄕 𱍹	
久	乆 镹	
乆	久	
乇	𦬃	
么	幺 麽 庅 麼	
义	義	
之	㞢 𡳿 𠔇	
乌	烏 𱹸	
乍	𠆦	
乎	虖 𠂠 𠂞	
乏	𣥄 𠂜 𠓟	
乐	樂 楽	
乑	众 㐺	
乔	喬	
乕	虎	
乖	𦭅 𠦬 𦮃 𠁰 𠂯	
乗	乘	
乘	乗 𠨇 𠅟 𠓸 𨍱 椉 𠅞 𨌤 𣔕 𠓽 𲑻	
乙	乚 𠃊 乛	
乚	乙 隱 隠 毫	
九	玖 𣲄 𢌬	
乞	气	
也	𠔄 𠃟 𦬀 𦫴	
习	習	
乡	鄉 鄕 郷	
书	書	
乪	𱰤 𮴽	
买	買	
乱	亂 𱚢 𲀢	
乳	𦜘 𠂏 𡇲	
乸	𱥜 𲏛	
乹	乾	
乾	亁 干 漧 𨺩 𠄊 𣦖 𠄋 𠄄 乹 𲓭	
亀	龜 龟	
亁	乾 干	
亂	乱 乨 𠃶 𤔔 𤕍 𠮗 𤔦 𤕅 𠧏 𢮣 釠 𠧎 𲬿	
亃	𠄈	
亄	𠃸	
亅	𠄌	
了	瞭 𱒠	
予	余 𱑷	
争	爭	
亊	事	
事	亊 𤔇 𠫺 叓 𠁱 𠭏	
二	貳 弍 貮 𢎐 𠄠	
亍	街	
于	於 扵 亏	
亏	虧 於 扵 𱿓	
云	雲	
互	㸦	
亓	丌 其 卞 开 亣	
五	㐅 伍 𠄡 乂	
井	丼	
亗	岁 歲 歳 嵗 𡻕	
亘	亙 𠀥 𠄢 𲦛	
亙	亘 𣘰 𠄣 㮓 𲦛 𦚹	
亚	亞 亜	
些	𡭟 㱔 呰	
亜	亞 亚	
亝	斉 齊 齐	
亞	亜 亚 俹 䢝 𠄮	
亟	焏 𠄹 𦱩 𠯉 𦯃 䓧	
亡	兦 亾	
亢	𪜠 頏 𠕵	
交	㬵	
亥	㐪 𧰧 𢁓 𢁳 𠀅 𠦇	
亦	𥩖 𡖋 𡗕 𠅃	
产	產 産	
亨	享 𠅖 亯	
亩	畝 畒 畆 畮 𮲕	
享	亯 亨 𦴒 𦕺 𠅖 𠅠 畗 𱑓 𱲡	
京	亰 𦣿 𡬱 𢂋	
亭	𠅘	
亮	𠅙	
亯	享	
亰	京	
亱	夜	
亲	榛 親	
亳	𠅢	
亵	褻	
亷	廉	
亸	嚲	
亹	𱡧	
人	亻 𠔽 𤯔	
亻	人	
亼	集 𠓛	
亾	亡 兦	
亿	億	
仁	忈 忎 𡰥 𱎚	
仃	停	
仄	𠨮 𥎦 𤴩 𠨻 庂 𠩩	
仅	僅	
仆	僕	
仇	讐 讎 𱟝	
仉	𠆰 𮯴	
今	𱎜	
介	𡗟 𣎴	
从	從 従	
仏	佛	
仑	侖	
仓	倉	
仕	𠇾	
他	她 牠 佗 𲰼 𲎿	
付	仅	
仙	佡 仚 屳 𠇈 𠏡 𲬺 僲 僊 㒨 𠑣 𠊼 𠎣	
仝	同	
仞	仭	
仟	阡 千	
仡	㐹	
以	㠯 叱 㕥 𠙋	
仪	儀	
们	們	
仭	仞	
仮	假	
仯	仦	
仰	𢓋	
价	價 価 𲐡 𠇴 㑘	
任	𢓩 仼	
仼	任	
份	分 彬 斌	
仾	低	
仿	彷 髣 倣 𩬝 㑂 㧍	
伀	彸	
企	𠈮 仚 𨀣 𧾺 𧿍	
伃	妤	
伊	𦯴 𠈽 𡭕 𠜰	
伎	𠇞 𠆸	
伏	𥧜 𥦸 㐲	
伐	牫	
休	𠇲 咻 烋 𠇾	
众	眾 衆	
优	優	
伙	夥	
会	會	
伛	傴	
伜	倅	
伝	傳 传	
伞	傘	
伟	偉	
传	傳 伝	
伡	车 俥	
伣	俔	
伤	傷 𱎩	
伥	倀	
伦	倫	
伧	傖	
伩	信	
伪	僞 偽	
伫	佇	
伭	玄	
伱	你 儞 妳	
伶	𱎦	
伷	胄 冑	
伸	𠈐	
伺	覗 𣱇	
似	佀 𠚦 仏 価 𠋨	
伾	伓	
佅	𠇱	
但	𠇙 𱎞	
佇	竚 伫 𲐝 㑏 𡀐	
佈	布	
佋	紹 巶 昭	
位	𢓔	
低	仾 𠍪	
佐	𠡃	
佑	祐	
体	體 躰 骵 軆	
佔	占	
佖	𠉘	
佗	它 𱐯	
余	餘 𪜬 𠎳 𱒱	
佛	仏 㘬 𦤲 仸 彿 𠇛 𲑦	
作	㑅 𠈨 𠆯 𢓓 𢼎	
佞	侫 𧦣	
佟	𢓘 㣠	
你	伱 儞 妳 伲 𤙌	
佣	傭	
佥	僉	
佩	𮱼	
佰	百	
併	倂 并 幷 𠊧	
佸	𠈲	
佹	㩻	
佻	𢓝 𨋫	
佽	㐸 𲐢	
佾	𢔍	
使	𠉕 𡷮 𡥐	
侁	駪 詵 𢓫 𢓠	
侂	託 仛 𠈁 𠊴 托	
侃	偘 𠈉 𲐨	
侄	姪	
侅	賅	
來	来 徠 𧼛 倈 逨 𲚿	
侈	𠈎 𠕝 𠕰 𣆚	
侉	𱎶	
例	𣖊 𠊖	
侎	敉	
侐	䦗 𠗅 伵 𨴎	
侒	𠊢	
侔	𠉖	
侖	仑 崙 𠎚 𠌈	
侚	殉 狥 𠊫 𠋹 伨	
依	𲑂 𲲀 𢲙 𧙿	
侠	俠	
価	價 价 𲐡	
侣	侶	
侥	僥 徺 儌	
侦	偵	
侧	側	
侨	僑	
侩	儈	
侪	儕	
侫	佞	
侬	儂	
侭	儘 尽	
侮	㑄 𠆸 㚢 𢘃 娒	
侯	𠨶 𥎦 矦	
侳	𠋿	
侵	𢔀 㑴 𱟜	
侶	侣	
侸	𠍄 𠊪	
便	𠊳	
俁	俣 㒁 𠋼	
係	系	
促	䟟 趗	
俅	𩒮	
俇	𢓯 𠉫 仼 𢔷	
俈	嚳	
俊	儁 𨶊 儶 㑺 㒞	
俎	爼 𤕲	
俐	悧	
俓	徑 逕 𠆻 𠇹	
俔	伣 悓	
俗	圱 𢓾	
俙	𢓬	
俛	頫	
俜	𠏬	
保	𤞥 𠈃 㙅 𠊻 𤔃 𡥀 𠦀 𠌀 𣎼	
俞	兪	
俟	竢 逘 𢈟 𢓪 𥏳 𲷉 𡱢 䇃 𢉡	
俠	侠	
信	伩 訫 𡥪 䚱 㐰 𲁢	
俣	俁	
俥	車 伡	
俦	儔	
俨	儼	
俩	倆	
俪	儷	
俫	徕 倈	
俭	儉 倹	
修	俢 𢔜 脩 臹	
俯	頫 俛	
俱	倶 𱲞	
俲	効 效	
俴	𠈙	
俵	䞄 㧼	
俹	𱎫	
俻	備 偹 备	
俾	𢔌	
倀	伥	
倂	併 并 幷	
倃	𧧖 䛮	
倅	伜	
倆	俩	
倈	徠 俫 勑	
倉	仓 𡶍 仺 𠥐	
個	个 箇 𠇂 亇	
倍	𧴥 俖 𠊑 𠋭	
倏	倐 𢞣 𤟏 焂 翛	
倐	倏 𱘳	
們	们	
倓	𠋴	
倔	𩋎 𩍞 誳	
倕	𠍮	
倖	幸	
倘	儻	
候	𠋫 𠊱	
倚	𠋣	
倛	𠎞	
倝	𠐱 𣉙	
倞	傹	
借	藉 徣	
倠	婎	
倢	𠌿 偼	
倣	仿 㑂	
値	值	
倥	𱎧	
倦	勌 𢛗 惓 𠉮 𠢏 劵	
倪	俔 𮯴	
倫	伦	
倬	𠍬	
倯	𢔋	
倲	㑈	
倶	俱	
倹	儉 俭	
债	債	
值	値 𰁲	
倾	傾	
偁	稱 穪	
偃	㫃 𤑅	
偆	𠎲	
假	仮 叚 𪝒 𠭊 𬽥	
偉	伟	
偊	踽	
偐	贋 贗 赝	
偑	㐽	
偒	蕩 𱎟	
偙	僀	
停	仃	
偞	僷 𠉪	
偠	婹	
健	徤	
偩	𰁾	
偪	逼	
偫	𠍰 𲟥	
偬	傯	
偭	𠎡	
側	侧	
偵	侦 𠏄 遉	
偶	媀	
偷	偸	
偸	偷	
偹	備 俻 备	
偺	咱 昝	
偻	僂 𠎪	
偽	僞 伪	
偾	僨	
偿	償	
傀	𤪿 𧝛 𠐤 𠎺 𠐦 𲑙	
傁	叟 叜	
傂	俿 𠈩	
傅	傳 𱙠	
傊	𱎯	
傌	罵 駡 㐷	
傍	䧛 徬	
傏	搪 㑽	
傑	杰 𱏚 𮯼	
傒	𧧹	
傕	𠐶	
傖	伧	
傘	繖 伞 𠎃 𠋔 𡙫 𠍘 𡙘	
備	偹 俻 备 僃 𤰅 𦯞 𠃰 𤰇 𠈍 𤖤 㑲	
傚	俲	
傜	徭 𠌠 㑾	
傢	家	
傤	儎	
傥	儻	
傧	儐	
储	儲	
傩	儺	
傪	𢕕 𫢺	
傭	佣 𦟛	
傮	𠑤 𣩒	
傯	偬 𠏨 倊	
傰	𦷛 𦰿	
傱	𢔩 𢕇 𰁧	
傲	𢢡 㥿 慠 𢕟	
傳	伝 传 𪫖 𫝊	
傴	伛 𢉴 𤹪	
債	债	
傷	伤 𮰁	
傻	儍	
傽	慞	
傾	倾 𨻺	
僀	𰂗	
僁	𠋱 㣰	
僂	偻 𨊖 軁 𲑛	
僄	徱 𠑎 𤡑 𢖣 𠎼 𠐆	
僅	仅 㢙 𲑔	
僆	𫢪	
僈	𣍑	
僉	佥 𠑲	
僊	仙	
働	𫢙	
僎	𠊨	
像	傢 𰁼	
僐	𠑫	
僑	侨 㝯	
僒	侰	
僓	𰂜	
僕	仆 𢖃 䑑 𲐾	
僗	𫢬	
僚	𠏗 𠆨	
僛	𠐾	
僝	𠊩 𲓽	
僞	偽 伪 𲖗	
僣	僭	
僤	𫢸	
僥	徺 儌 侥 憢	
僦	𠎂	
僨	偾	
僩	僴 𰂎	
僫	𱏀	
僭	僣 𠍴	
僮	偅	
僰	𠒹 𠍷 𢣡	
僱	雇	
僴	僩 𰂋	
僵	傹	
僶	勔 𠊟	
僸	嬐	
價	価 价	
僺	𲑘	
僻	𠒱	
僽	偢 𱟓	
僾	𫣊 𢙸 𠎹	
儀	仪 𥫃 𪜧	
儁	俊 㑺	
儂	侬	
億	亿 𢡃 𠐥 𠌼	
儅	𰁸	
儆	警	
儇	𠐛	
儈	侩	
儉	倹 俭 𠈏	
儌	僥 徺 侥	
儍	傻	
儎	傤	
儐	傧	
儒	𠍶 偄 㐵 𰁡	
儓	枱 檯 㒗	
儔	俦 𠍻 𡕑	
儕	侪	
儖	𫣉	
儗	擬 拟	
儘	侭 尽	
儚	𩕫 𢟼 𠐧 顭	
儛	㒇	
儞	你 伱 妳	
償	偿 𱏐	
儡	㒦 𦇄 𲑓	
儢	𰂦 𠐳 𡣭	
儣	𠆲	
儤	忁	
儥	𧶠 𰂏	
儦	𢖐	
儧	儹	
儩	𰂭	
優	优 𢖒	
儭	襯 𠋆	
儮	𮯸	
儯	𱎾	
儰	𫢭	
儱	𫢒	
儲	储	
儳	𢖞 𠍈 𠋂	
儵	𡤥 𢖛 𨤨	
儶	㒞	
儷	俪 𠏊 𠌯 㒧 𠐚	
儸	㑩	
儹	儧 𰃆	
儺	傩 𠹈 𩙎 𩘾	
儻	倘 傥 㒉 儅	
儼	俨 偘 𲐯 𫤖 𠑊 𪝫 𲑧	
儽	㒍 傫	
儾	𧟘 𦈃	
儿	兒 児	
兀	㐳	
允	㽙 𠃔	
充	𠘺 𠑽	
兆	𡉵 宨 𠧞 𡊥	
兇	凶 𧦙 忷 恟	
光	灮 𤑋 𠈑 炚 𤎫 烡 𤉭 炛 茪 㫕 炗	
克	剋 尅 𠧳 𠅡 𡱠 𠧻 𠧹 𠅏 𠅔 𣳂 𠑽 𡱀	
兌	兑 𠫞 兊	
免	兑	
兎	兔	
児	兒 儿	
兑	兌	
兒	児 儿 𠒆 皃 𧠇	
兔	兎 菟 𱽔	
兕	𧱃 𧰽 𧤄 𧣶 𤉡 𠒊 咒 𠒃 𠒅 𱮃	
兖	兗	
兗	兖	
党	黨	
兜	兠 𦋌 㿡 𱏧 𱏫 𮰋	
兢	𠓆 𲪝	
兦	亡 亾	
內	内 𡗠	
全	㒰 𠓳 𠓴 仝 𲍭	
兩	両 两 刄 𢎏 㒳 刅	
兪	俞	
八	捌	
公	㒶 㕣	
六	陸 𠫪	
兮	𠔃 𲑾 𲐗	
兰	蘭 𮶜 𮶟	
共	𠔏 𩇿 𦱹 𱏬 𱝗	
关	關 闗 関 𲈪	
兴	興	
兵	𠦛 𠡿 𡲍 𠊏 𠈯 𠬿 𠉔	
其	亓 丌 亣 卞	
具	倶 𥃲 俱 𰋙	
典	𠔩 𥮏 䓦 𠔓	
兹	茲 玆	
养	養	
兼	𠔥 𥡝 𱕢 𱙲	
兽	獸 獣	
兿	藝 蓺 芸 埶 秇 艺	
冀	兾	
冁	囅	
冂	坰 冋	
冄	冉	
内	內	
円	圓 圎 圆	
冈	岡	
冉	冄	
冊	册 𠕁 𠕋 𥮫 𥬰 笧 𠕐 𲓟	
冋	坰 冂	
册	冊 𲓟	
再	𠕂 𱎒	
冐	冒	
冑	胄 伷 𩊄 䩜 冐 𲊜	
冒	冐 𡇾 𠕬 𡈘 𥄲 㒻 𠕚 𱢕	
冔	𠕮 𦊯 𦀒	
冕	𡩄 㡈 絻 𱺾 𱻁 𲒊	
冖	冪 羃 鼏	
冗	宂 冘	
冘	𢓕	
写	寫	
军	軍	
农	農	
冝	宜 宐	
冞	罙 䍘 𥹐	
冠	𠖌 𢃙 𠙙 𱺼 𱺽 𱺿 𲜡	
冢	塚 塜 冡 𠣥	
冤	寃 惌	
冥	𡨶 窅 㝠 㫥 窴 䆩 𣩆 𱚇 𱷒	
冦	寇 宼	
冨	富	
冩	寫	
冪	羃 鼏 冖 幂 冂	
冫	冰 氷	
冬	鼕 𠔙 𠘀 昸 𣆼 𠘗 㫡 𣅈	
冯	馮	
冰	氷 冫 𣲝 𨻱 𣲙 仌 𱐂	
冱	沍 冴 𠖱	
冲	衝 沖	
决	決	
况	況 湟	
冷	𠘤	
冻	凍	
冽	洌 𠗢 𲒕 𠗗	
净	浄 淨 凈	
凂	浼	
凃	塗 涂	
凄	淒 悽	
凅	涸	
准	準 凖	
凈	淨 净 浄	
凉	涼	
凋	淍 𱥑	
凌	𣎐 𠗲 𱼾	
凍	冻 涷	
减	減	
凐	𠗃	
凑	湊	
凓	𠘍	
凔	𰃷 𠖸	
凖	準 准	
凘	𠗧	
凙	𪞝	
凚	澿	
凛	懔 凜	
凜	凛 癛 𠘅 𠘡 澟 𱪕 𲒗	
凝	𣲝 𡷪 𠘥 𱩆 𱩢 𱩨	
凟	𰃿	
几	幾 机 𠀃	
凡	凣 凢	
凢	凡	
凣	凡	
凤	鳳 鳯	
処	处 處 䖏	
凨	風 风	
凫	鳧	
凭	憑 凴 𱝕 𱫫	
凯	凱	
凰	䳨 𲍥	
凱	凯 𧇔	
凳	櫈 橙	
凴	憑 凭 𮰉	
凶	兇 㐫 𣧑	
凷	塊 块	
凹	𠕄 䆟 𢈈 𱖎 𱛗	
出	岀 𲐂 齣	
击	擊 撃 𱹺	
凼	幽	
函	圅 凾 䤴 𦞞 𠚗	
凾	函 圅	
凿	鑿 𲇍 𲇔	
刀	刂 釖 𠚣	
刂	刀	
刃	刄	
刄	刃	
刅	創 剙 𠛂	
刈	苅 艾 𠛄	
刉	刏 𣱕 𣱞 𣱚	
刊	刋 栞 𣓁	
刋	刊	
刌	𠚳 𢩭	
刍	芻	
刎	𠚼	
刏	刉 𣱕	
刑	𠛬 㓝 𠜚	
划	画 劃 畫 找	
刓	园 㝴	
刔	抉	
刖	𧿁 跀	
列	𠜺 𠛱	
刘	劉	
则	則	
刚	剛	
创	創 剙	
初	𠫎 𠜆 𥝢 𣦂 𢀯 䥚 𡔈 𥘉	
刞	耝	
删	刪	
刡	鈱	
刢	𠠱	
判	牉	
別	别 𠔁 𠛰	
刦	劫 刼 刧	
刧	劫 刼 刦	
刨	鉋	
利	𥝢 𥝤	
刪	删 𠜂 𠛹 𡬬 𨚿	
别	別	
刬	剗 鏟 剷	
刭	剄	
刮	颳 劀 𠜜	
刱	剏 創 剙	
刲	𠝥 㨒	
刳	㓬 𠛒	
刴	剁	
制	製 𠛯 剬 𠜿 𠛐 𠜔 𠝁	
刷	㕞 𠛚 𢼞	
券	劵	
刹	剎	
刺	刾 㓨 捇 剌 𣐁	
刻	𠞫 𠜇 𠚰 𱐘	
刼	劫 刧 刦	
刽	劊	
刾	刺 㓨	
刿	劌	
剀	剴	
剁	刴	
剂	劑 剤	
剃	鬀 𩮜 𲌝	
剄	刭	
剅	𧯠 㓸	
剆	𣂞 㔏	
則	则 𠞋 𠟭 𠟔 𠟻	
剈	𠜠 𠛭 𠜟	
剉	𠞐	
削	𮰌	
剋	尅 克 勊 勀 𠧶	
前	𠝣 𣦃 𣥑 歬 𱽴 𲧳	
剎	刹 𠜽 𠛴	
剏	刱 創 剙	
剐	剮	
剑	劍 劎 劒 劔 剣 剱 𮷪	
剒	𠟏	
剔	𢱦 𠠡 𠜓 𲭴 掦 𰄝	
剕	䠊 𨅥	
剖	𠝒 𠞌	
剗	鏟 剷 刬 铲	
剙	創 刱 剏 刅 戧 创	
剚	𨧫	
剛	刚 𠜛 㓻 𣗵 𠇝 𠝾 鎠 𡬺 𠇙	
剜	𠛠 𣪰 鋺	
剝	剥 𠚬 𠚪 𠠴 忉 𠧓 𠛧 𠚩	
剞	𠚽 𣂦	
剟	𱐢	
剣	劍 劎 劒 劔 剱 釰 釼 剑	
剤	劑 剂	
剥	剝	
剦	閹	
剧	劇	
剨	𠜻	
剩	剰 賸 𠟇	
剪	翦 𣦃 𠝣 𣦟	
剭	𪑱	
剮	剐 叧 另 㱙 𠮠	
副	㨽 㽬 𠠦 疈	
剰	剩 賸	
剱	劍 劎 劒 劔 剣 釰 釼 剑	
割	㓣 𠛛 𠛷 㓮 𧗶 𱾩	
剳	箚 札 劄	
剴	剀	
創	剙 刱 剏 刅 戧 创 𠟐 𠝀 㓝 瘡	
剶	𠛮	
剷	鏟 剗 铲 刬 𣂧 𱐙	
剸	𩠹 剬 𰄞	
剺	𢾨 𠞲 𣪤 剓 𢍛	
剻	䣙	
剼	𱐠	
剽	𠣆 勡 𠠧 𨭚 𡬽 𡭓	
剾	𠛅	
剿	勦 𠞰 𣩓 𠟿 𠟾 劋 𠟘 𠜅	
劀	𠟽	
劂	𠜾 𱐝	
劃	畫 划 画 𠞷 𠜻 𠟱 劐	
劄	剳 箚 札	
劆	鐮 鎌 镰	
劇	剧 𠟵	
劈	擗 𤖼 𲣙	
劉	刘 鐂 鎦 𡭈 𠭱	
劊	刽	
劋	𠟯 剿	
劌	刿	
劍	劎 劒 劔 剣 剱 釰 釼 剑 釖 𠠆	
劎	劍 劒 劔 剣 剱 釰 釼 剑	
劏	㓥	
劑	剤 剂 𠜸 鑇	
劒	劍 劎 劔 剣 剱 釰 釼 剑	
劓	㓷 𨞳	
劔	劍 劎 劒 剣 剱 釰 釼 剑	
劖	𠠥	
劗	𭄛	
劘	𠠒 𠞥	
劙	𠠞 𠠫 𠠂 㓯 蠫	
劚	㔉	
力	𠠲	
劝	勸 勧	
办	辦	
功	糿 㓛 糼 切	
务	務	
劢	勵 勱 励	
劣	𢚃	
动	動	
助	𦔳 㫑 𧴧 𤋰 𱫤	
努	伮	
劫	刧 刼 刦 𠛗 𠞏	
劮	妷	
励	勵 劢	
劲	勁	
劳	勞 労	
労	勞 劳	
劵	券	
劶	㔚	
劸	𠡬	
効	效 俲	
劻	𤝿 㑌	
劾	𠡌 𠜨	
势	勢	
勀	勊	
勁	劲 𠡍 䑒 𠡕	
勃	艴 𠃱 㪍 㔜	
勄	敏	
勅	敕 勑 𮰍 𲒨	
勇	𢦨 勈 恿 㦷	
勉	𠢖 勔	
勋	勛 勳 勲	
勍	𠡽	
勑	徠 敕 勅 倈 𠡠	
勒	𩩸	
動	动 𨔝 働 㣫 勭 𲆊	
勖	勗 朂 𠡼	
勗	朂 勖 𠡼	
務	务 㳇 𱳜	
勚	勩	
勛	勳 勲 勋 𠢼	
勝	胜 𠢧 𠅫 𡕲 𠙠 𠙟 𢾶	
勞	労 劳 憥 𣬄 𢚄 僗 𠣁 𣬃 𢥒	
勠	戮 勎 𢑕 𠢯 𠝧	
勢	埶 势 𡎐	
勣	𪟝	
勤	懃 𠢀 𠢄 𰅉	
勥	犟 強 强 彊	
勦	剿 𠢶 䜈	
勧	勸 劝	
勨	𠢰	
勩	勚 𠡫 𦘓	
勰	恊 協 𢣢	
勱	劢 勵	
勲	勛 勳 勋 𱪿	
勳	勛 勲 勋	
勴	𰅔	
勵	劢 励 勱	
勸	勧 劝 勌	
勹	包	
勻	匀	
勼	𢜥	
勽	菢 㲒	
勾	句	
勿	𣃦	
匀	勻	
匃	丐 匄	
匄	匃	
包	勹 𠣒	
匆	怱 悤 忩 匇	
匈	胸 匃 胷	
匊	掬	
匋	陶	
匏	瓟	
匐	𨄩 𨄑 𠣵	
匑	匔	
匕	𠤎	
化	匕 𠆧 𠤎 𠏁 𠯒 㐶 𫁉	
北	𧉥	
匘	腦 脳	
匙	鍉 㮛 㔭 𥫽 䈕 𪰯	
匚	𠥓 𠤬 匸	
匜	釶 𳅳 𠃟 鉇 也	
匝	帀 迊 𠂝	
匠	匞	
匡	匩	
匢	𠥋 匫	
匣	㭱 筪 𱎮 𲅚	
匦	匭	
匧	篋	
匪	𩇪 𦃄 篚	
匭	匦	
匮	匱	
匯	滙 汇	
匰	𰅦	
匱	匮 鑎 樻 𨙑 櫃 饋 㙺 鐀 𲆀	
匳	奩	
匴	𥮞 㔯	
匵	櫝 𰅥	
匸	匚	
匹	疋 𤴓 𲅋 𲅏	
区	區	
医	醫	
匼	𢈈	
匾	𱖄 𲶋	
區	区 塸	
十	拾	
千	仟 韆	
卄	廿 廾	
卅	𠦃 卉	
卆	卒	
升	昇 陞 㚈	
卉	芔 𦴬 𮰰	
卋	世 丗	
卌	𠦜 𠦌	
卍	卐 万 萬	
华	華 崋	
协	協 恊	
卐	卍 万 萬	
卑	𡮁 𤰞 𢌿 𱚋	
卒	卆 䘚 𠥾 𲞹 𨒳	
卓	㔬 𢂚 𠤞 𢂦 桌 𠤚 𠤟	
協	恊 勰 旪 协 叶 𠦢	
单	單 単	
卖	賣 売	
南	𡴟 𡴖 𲓜	
単	單 单	
卙	𠦫	
博	愽 𩫯	
卜	蔔 𠁡 𠁢	
卝	丱 礦 砿 鑛 鉱	
卟	𲔏	
占	佔	
卢	盧	
卣	𠧪 㔽	
卤	鹵	
卦	𤌻	
卧	臥	
卨	𫧯	
卩	部 㔾 卪 𢎟	
卫	衛 衞 𱎞	
卬	卭 𠨐 夘	
卭	卬	
卮	巵 𠨬 𠂬	
卯	戼 夘 卬 丣 𩇨 𠨍 𩇧 𤕰 𩇦 𦕔 邜 𱻸 𱻺	
印	𠘄 币 𱬷	
危	𡴸 厃 𡴲 𡵁	
即	卽 皍 䢸	
却	卻	
卵	卝 𤓲 𡖉 𱤦 𮷩 𲺭	
卷	巻 捲 𩁫 𨤖 𢎥 𠨟 𢎚 㢧	
卸	缷 䣃	
卹	恤 賉 𨟰 𨜧 䘏	
卺	巹	
卻	却 㕁 郤 𲆕	
卼	𠨜 𠒄 㐳	
卽	即	
卿	𠨍 𨜮 𠨞 𮱍	
厂	廠 厰 厈	
厄	阨 戹 阸 𠨬 𢨤 𠂬 𢀴 𠂘 𢨩	
厅	廳 庁 廰 厛	
历	歷 歴 曆 暦 厲 𱤽	
厉	厲 𱣟	
压	壓 圧	
厌	厭	
厍	厙	
厎	砥 𠨿 㕄	
厏	𠩎	
厐	庞 龎 龐 庬 厖 尨	
厒	𠪈 𠪦 𠩂 𠩧	
厓	崖 崕	
厕	廁 厠	
厖	庬 尨 龐 龎 庞 厐	
厗	𲟆 𥔈	
厘	釐 𭀖	
厙	厍	
厚	𢈲 垕 𣆉 𠪋 𠩞 㫗 𠩰 𡦩	
厛	庁 廰 廳 厅	
厜	𠪪	
厝	𠪞 𥕉	
厞	𩇪 陫 䨾	
原	𠪥 厡 亰 𠩤 𨘡 𠫐 𠩠 𠪰 𰆖	
厠	廁 厕	
厢	廂	
厣	厴	
厤	歷 歴 曆 暦	
厥	𣅲 𨈑 𠪼 𣅞 𨈐 𠪆 氒	
厦	廈 𱑝	
厧	𠫉	
厨	廚 㕑 𢊍	
厩	廐 廄 廏	
厪	廑	
厬	𣷾 𣽞 𣲼	
厭	厌 懕 㦔 𢣽 𱱢 𱱨 𱴴	
厮	廝 㒋 𱠾	
厯	歴 歷	
厰	廠 厂	
厱	𰆚	
厲	厉 历 𠪄 𠪿 𧓽 𢋭 𲆽	
厳	嚴 严	
厴	厣	
厵	源 沅	
厶	私 某	
厷	肱	
厹	叴 㕤 禸	
去	㚎 弆 𠫥 厺 𠬑 𠫟 𲐠	
县	縣 𱤛	
叀	𡵏 𡴗 𠧢 𡴁	
叁	三 叄 參	
参	參	
參	叅 蓡 三 叁 叄 参 曑 喿 𠬅 𠻝 㕘 𠫰	
叄	三 叁 參	
叅	參	
叆	靉	
叇	靆	
又	叹 𡯉	
叉	扠 义	
及	𨕤 𢎜 乁 𠃍 𲅱 𲅺	
友	𱻚	
双	雙	
反	仮 𠬡	
収	收	
发	發 彂 発 髮 髪	
叔	尗 𠦑 𡭫 𡬟 𡬧 𢆑 𠁮	
取	耴 𱑴 𲹨 𬚓	
受	𤓾 𣄁 𡬳 𠭧	
变	變	
叙	敘 敍	
叛	炍 𧼦	
叜	叟 傁	
叟	傁 叜 𠪇 𡨎 𡨨 𠋢 𠬲 𠌌 𡨼	
叠	疊 曡 疉 畳	
叡	睿 壡 𣦲 㲊 𲲻 𠮉 㪫	
叢	樷 丛 菆 欉 𱾜 𱾬	
口	𠮚	
古	𠖠 𡇣	
句	勾 𤖮 𠯶	
叨	饕	
叩	敂 𨙫	
只	隻 祇 祗 衹 𧙋 𠮡 子	
叫	呌 嘂 𠶼 𠸵 𠮪 叽 哯 𠮧 訆 噭 䚯 嘄	
召	𠮥 𠮦 𱖵	
可	𠍟	
台	臺 颱 檯 𠮯 𠘭 㣍 𱼫	
叱	𠻟	
史	㕜	
右	𠮢 厷	
叴	厹 𠮬 㕤 𠮫	
叵	尀 𠰐	
叶	葉	
号	號 𱿒	
叹	嘆	
叽	嘰	
吁	籲 龥 𠯊 𠮱 𠮞	
吃	喫 𠯡 㰟 𠯏 𡄊	
吅	喧	
合	閤 闔	
吉	𠮷	
吊	弔 𢁔	
同	仝 衕	
后	後 𠮮	
吏	叓	
向	曏 嚮 𥥩 𤖾 𤖽	
吒	咤 喥	
吓	嚇	
吕	呂	
吗	嗎	
吚	咿	
君	𠁈 𠱭 𠱰 𠱩	
吝	悋 恡 𠲲 𠳻 𠳺 㖁 𢙵 𠫤 𠴽 𠯌 𠯛 𠳈	
吞	呑 吴 𦙖 㖔	
吟	唫 䪩 訡 㕂 噖 𱑋	
吠	𤝜 𠲎 㕹	
吣	唚	
否	𡃠 吥 𠘶	
吨	啍 噸	
吪	𠷸 𨅌	
含	𱼳	
听	聽 聴 聼	
吭	頏	
吮	𠵷 𦧊	
启	啟 啓 啔	
吲	哂	
吳	呉 吴 㕦 𡗾 𡗿 𠯵	
吴	吳 呉	
吶	訥 呐 㕯	
吸	噏 𲖈	
吹	龡 𪛐 䶴 𪛑 𠷕 𲎯	
吺	𠱒 𡂛 𠱑	
吻	呡 肳 𦝮 㗃 呅 𠞍 㖧 脗 𠯳 䐇 𱓍	
吼	吽 呴 㖃	
吽	呴 𠴣	
吾	𨖍 𢓲 𠮣 𲜳	
吿	告	
呀	𲔯	
呂	吕 膂 𦛗	
呃	𧦠 呝	
呆	騃 獃 𣎼	
呇	启	
呉	吳 吴	
告	吿 𢍎 𠰛	
呌	叫	
呐	吶	
呑	吞	
呒	嘸	
呓	囈	
呕	嘔	
呖	嚦	
呗	唄	
员	員	
呙	咼	
呛	嗆	
呜	嗚	
呠	歕 噴	
呡	吻	
呢	𠽬	
呥	𠯍	
呦	𠸰 𠲵 𣢜 𠲭 𣢄 㗀	
呧	𠯝 𠱱 𠰋 𠱎 𠳉	
周	週 𠣘 𠱬 𠄗	
呪	詋 咒	
呬	𠰝 嚊 𧦁	
呰	啙 㖢	
呱	哌 𠶩 𠽿 𠲐	
呵	啊 嗬 訶 诃 㰤 哬	
呸	啡	
呺	𧦢 㕺	
呻	𠲳 㕥 𣢘	
呼	嘑 𲗌 虖 謼 𢧶 歑 𧦝 𠰗	
命	𠋒	
呿	𠳷 㰦	
咀	觜 嘴	
咂	𠯗 𱒤	
咄	嚉 𠷅	
咅	㖣 哣	
咆	𠿙 𡂘	
咈	𠲽	
咉	𠮴	
咊	和 龢	
咋	𠷆 唶	
和	咊 龢 惒 𤧗	
咎	𠧨	
咏	詠	
咒	呪 詋 䛆 詶	
咙	嚨	
咛	嚀	
咝	噝	
咠	𠶻	
咢	㕺 㖾	
咤	吒	
咥	㗌 𠽧	
咨	諮 谘 𪡌 嗞	
咩	哶 𱻋	
咫	𦐖 𣥉	
咬	齩 𠸀 𪗡 䶧 嚙	
咮	𠰍	
咯	詻	
咰	𠲾	
咱	偺	
咲	笑	
咳	欬 𤸺 孩	
咶	𠳂	
咷	啕	
咸	鹹	
咼	呙 𩰬 𣅻 喎	
咽	嚥 𠰸 㖶 𠽥 𠾰 𡲙	
咿	吚	
哀	𢜺	
品	𠯮	
哂	吲 𧧍 𢏓 弞	
哄	鬨 閧 𠹒 𠹅	
哅	㕼	
哉	㦲 𠳆	
哌	呱	
响	響 𲊧	
哑	啞 唖	
哒	噠	
哓	嘵	
哔	嗶	
哕	噦	
哗	嘩 譁	
哙	噲	
哚	𲔦	
哜	嚌	
哝	噥	
哟	喲	
員	员 貟 𪔅 𲎙	
哢	咔 𠱚	
哥	𱒭	
哦	誐	
哨	𠱝	
哪	㖠	
哭	𠴃	
哮	㫴 𧱐 嘋	
哯	𠯟 唺 咞	
哲	悊 喆 啠 𠺤 𲔺 𳁮 埑 嚞 𱡫	
哳	𠹗 𠻯 𠽻 唽	
哴	喨	
哶	咩	
哹	𠸷	
哽	𠶺	
哾	𠱕	
哿	𠵲 𲕇	
唁	喭 𣨌 𣨹 囐	
唂	唃	
唄	呗 𠼚 𠼕 𡁭 㗑	
唇	脣 㖘 𠸸	
唉	欸 誒	
唊	硤 𰇕 䛟	
唌	𦧝	
唏	欷	
唐	鄌 𥏬 𡃯 啺 𣉺	
唓	𪠳	
唔	𲔖	
唖	啞 瘂 哑	
唚	吣	
唛	嘜	
唝	嗊	
唠	嘮	
唡	啢	
唢	嗩	
唤	喚	
唧	喞 吇 𠷌	
唫	吟	
唬	謼 諕 嚇 虓 猇 𠶪	
售	𨾜 𨿞 𨿈	
唰	𠴪	
唱	誯 𪛋	
唵	𠵵	
唷	唹 哊	
唸	𠿍	
唹	唷	
唻	𫪁	
唼	𱓻	
唾	涶 𠴯 𠾊	
啀	㹞 嘊 𠺓	
啃	齦 𲭘	
商	𠹧 𧶜 𳂜 𥫐 𡅟 𡃬 𨝗 𠿧 𠘾 𡄚 𡂦 𧷞 𠾃 謪 𱷭	
啈	𱒙	
啉	𠵂	
啊	呵	
啍	吨 噋 𡃥	
啎	忤	
問	问 𠳅	
啐	𠵒 𠯥	
啑	𠰏	
啒	唿	
啓	啟 啔 启	
啔	啓 啟 启	
啕	咷	
啖	啗 噉 㗖 餤 嚪	
啗	啖 噉 㗖	
啙	呰	
啜	諁 歠 欼 嚽 𠼣 涰 𡂜	
啞	唖 瘂 哑 𤺘 𣣾 䛩 𱱒	
啟	啓 啔 启 諬 𠶳 𠭎 𢻻 闙 唘 𥔩	
啢	唡	
啣	㘅 𱓵	
啥	𱒞	
啧	嘖	
啪	㕷	
啬	嗇	
啭	囀	
啮	嚙 囓	
啯	嘓	
啰	罗 囉	
啴	嘽	
啸	嘯 嘨	
啺	𱒂	
啻	𥩶 𠺏	
啼	嗁 渧 㖷 㖒 謕	
啽	𠹞	
啾	𠷘 𠿈	
喀	䘔 衉	
喁	𠷸	
喂	餵 餧	
喃	諵 娚 嫐 䛁 𠲸	
善	譱 𦏟 𧬆 𧮟 𦏯 𠾄 𦎍 𠵊 𧨅	
喆	哲	
喉	𦞕 㗋	
喊	𠿑 㘕 嚂	
喋	𠿚 𠴬	
喌	㖄 𠱙	
喎	㖞	
喏	𧧏 𠰒	
喐	郁	
喒	昝 偺 㑑	
喕	𠲶	
喗	𠲰	
喘	𠽴 𡄠 歂	
喚	唤 喛 𡅻 嚾 𧠮	
喜	憙 𢝫 𡔯 𢐭 𠶮 歖 憘 𦬅 𱓎	
喝	𠿒 𡀽 𲖷 𲖎	
喞	唧	
喟	𠣠 𠣱 欳 𠷝 嘳 𡃪 𠿥 㕟	
喡	𮰔	
喢	䛽 𠽣 𠴯	
喣	煦	
喤	𠹡	
喦	嵒 𠹜	
喧	諠 吅 𧮥	
喨	哴	
喩	喻	
喪	丧 𡂧 䘮 𠸶 𠷔 𦦭 𦱺 𡴧 𡂤 𡚏	
喫	吃 𠿊 𠲹 噄 𠹙 𡁒	
喬	乔 𠳮	
喭	唁	
單	単 单 𠫹 𠦤	
喲	哟	
営	營 营	
喷	噴	
喻	喩	
喽	嘍	
喾	嚳	
喿	噪 𠹏	
嗀	𣪳 𣪥 㱿 𨖣 𣪎 𣪛 𲖛	
嗁	啼	
嗂	𠿌	
嗄	𣣺	
嗅	齅 𪖻 㗜 𲎡	
嗆	呛	
嗇	廧 啬 𠹫 𠎸 𠻮 𠾂 𤲝 𤳋 𢋦 𤲷	
嗉	膆	
嗊	唝	
嗌	𠍳 𡁐 𣣼 𱓀 𲖅 𲗅	
嗎	吗	
嗑	㗐 𧪞 𱌻	
嗒	㗳	
嗓	𰇢	
嗔	謓	
嗖	𠷃	
嗘	𠳸	
嗚	呜	
嗜	𩝙 呩 𦞯 𨢍	
嗞	咨 諮	
嗟	𧬑 𨲠 𧪘 𧫯 𩬡 𨲻 䦈	
嗢	𱓛	
嗣	孠 𮹑	
嗤	㰞 𧏬 𣣷 𠱟 𲗁	
嗥	嘷 嚎 𠶪 噑 獆 䝥 獋 獔 𠰘 𣽎	
嗧	𰇠	
嗩	唢	
嗫	囁	
嗬	呵	
嗯	㕶	
嗳	噯	
嗶	哔	
嗷	嗸	
嗹	𪡏	
嗼	𠻶	
嗽	瘶 𲱞 嗍 𲃒	
嗾	𠻣 㖩 𡂡 𠻛	
嗿	𰇲	
嘀	唙	
嘁	𠻏 𡂔 㗤 𡄱	
嘄	𫪧 𡂢	
嘆	歎 叹 𡂥	
嘇	𰇼	
嘈	䜊 𠻥 𡅰	
嘌	𡄺	
嘍	謱 喽 𠳴 𠶭	
嘎	尜	
嘐	𡀒	
嘑	呼 虖 謼	
嘒	嚖	
嘓	啯	
嘔	呕 𠴰	
嘖	啧 㖽 謮	
嘗	甞 尝 𨣛 𠹉 𨡔	
嘘	噓	
嘜	唛	
嘤	嚶	
嘨	嘯 歗 啸	
嘩	譁 哗	
嘪	𪡃	
嘬	𠽶 𠻕 𲿰	
嘮	唠 哰	
嘯	嘨 歗 啸	
嘰	叽	
嘱	囑 𰇰	
嘲	謿	
嘳	𡃪 𪡞	
嘴	咀 觜 𠾋 𠿘 𡂗 𡁫	
嘵	哓 𠵰	
嘷	嗥 噑	
嘸	呒	
嘹	𠮩 𲗣	
嘺	𪡀	
嘻	𡃨	
嘼	𠾧	
嘽	啴	
嘾	𡅿	
嘿	默 黙	
噁	恶 惡 悪 𫫇	
噂	譐	
噅	噕 𠯠	
噈	𧫾 𣤶	
噉	啖 啗 㗖	
噍	𱕀 𱕘 𲗡	
噎	䭇 𩜺 饐	
噏	吸	
噐	器	
噑	嚎 嘷	
噓	嘘	
噕	噅	
噚	㖊	
噜	嚕	
噝	咝	
噞	𪡋 䲓	
噠	哒	
噢	𣤡 𠮞	
噤	䫴 齽	
噥	哝	
噦	哕 𧬨 𣤠	
噧	䜕 𡂖 𱒀	
器	噐 𦈯 𠾖 𡄛 𫩏	
噩	𡅡	
噪	譟 喿 𠴵 𠹏	
噫	𧮒 𢤏 譩 䪰	
噬	唑 齛 𲞊	
噮	𠾪	
噯	嗳	
噰	𡄸	
噱	𠻔 㖸 㘌	
噲	哙	
噴	呠 歕 喷 喯 𠽾 𠴮 㖹 吩	
噸	吨	
噹	当 𪠽	
噼	𲘕	
噽	𱍨	
噾	𠽨	
嚀	咛	
嚂	𡅞 㘕 𰈓	
嚄	嚿	
嚅	吺	
嚇	謼 諕 唬 吓 哧	
嚈	𫩫	
嚋	𱒦	
嚌	哜 𠻎	
嚍	𫩺	
嚎	噑 嗥	
嚏	嚔 𪖮 𪖰 啑 㗣 𪖣 𡄶 䶍	
嚐	𰈇	
嚔	嚏	
嚕	噜	
嚗	𡄗	
嚘	㗀 㱊	
嚙	囓 齧 啮	
嚚	𠾅 𡓶 𡂨 𡅚 𡁬 𠽺 𡓿 𠿦	
嚛	𪠸 䤕	
嚝	𫩕	
嚠	瀏 浏 𭇯	
嚡	𱕦	
嚢	囊	
嚣	囂 嚻	
嚥	咽	
嚦	呖	
嚧	𠰷	
嚨	咙	
嚩	𰈶	
嚪	𫫦	
嚫	𰈍 䞋	
嚬	顰 𫫾 𲗞	
嚭	𧯻 噽 𱘡	
嚮	向 𡪥 𡩉	
嚱	𰇣	
嚲	亸 䯬 軃	
嚳	俈 喾 𠿟	
嚴	厳 严 𡅮 𡃫 𡅔 𡅾 𡅝 𡆉 𱳕	
嚵	饞 𡁅	
嚶	嘤	
嚸	𰈊	
嚹	𡅈	
嚻	囂 嚣	
嚼	𠻘 噍 𲘔	
嚽	𪢕	
嚿	𫩥	
囀	啭	
囁	讘 嗫 𠲷	
囂	嚻 嚣 𩫳 𠾯 𠽸	
囃	𠱞	
囅	冁	
囆	𧔺	
囇	𫪃	
囈	呓 讛 𡂞 𠾁 𲂀	
囉	羅 啰 罗	
囊	嚢 𣡏 𢑿 𣡪 𧛦 𰀉	
囋	𡂐 囐 𰉄	
囌	苏 蘇 𱓁	
囐	𰈯	
囑	嘱	
囒	𪢠	
囓	嚙 齧 啮	
囔	𰀉	
囕	𰈆	
囖	𱕌	
囘	回 囬 迴 逥 廻 廽	
囚	㘝	
四	皿 𠁤 亖 龱 肆 𦉭	
回	囘 囬 迴 逥 廻 廽 𡇌	
囟	顖 䪿 𩔙 𠚁 𠙷 𦥓 𲘟 𩔨 𩒦 龱	
因	㧢 囙 𤇀	
囡	𱙏	
团	團 団	
団	團 团	
囤	𥫱 𡆰 𥭒	
囧	𡆾 𡇇 冏	
囪	囱 𡆧 牎	
囫	𲘡 𰿜	
囬	回 囘 迴 逥 廻 廽	
园	刓 園	
囮	𡈙 㘥 𡈱 𡈸	
囯	圀 國 国	
困	睏 𣏔	
囱	囪	
囲	圍 围	
図	圖 圕 图	
围	圍 囲	
囵	圇	
囹	𡈍	
固	𡇈 怘	
国	國 圀 囯	
图	圖 図	
囿	𡈹	
圀	國 囯 国	
圃	圑 𡇊	
圅	函 凾	
圆	圓 円 圎	
圇	囵	
圈	圏 𡈕	
國	圀 囯 国 囶 𡆻 𡈑 𡇎 䆐 𢧌 𡇕 𡆸 囻 𠰧 戜 𤦒 𡆿 𢧰	
圍	囲 围 𪢫	
圎	圓 円 圆	
圏	圈	
圐	𲘬	
園	园 薗 𡈤 𱾒 𱾓 𱾔	
圓	円 圎 圆 园	
圔	𡈮	
圕	圖 図 𱕸	
圖	図 圕 图 𧖳 𡈇 啚 𡇴 圗 𠚎 𡈖 𱨭	
團	団 团 园	
圝	圞 𲘣	
圞	圝 𪢮 𡈻 𲘩	
土	𡗓 圡 士	
圢	町 䵺	
圣	聖 垩 堊 𱑱	
圥	𠒶	
圧	壓 压	
在	扗 𡉄 𥩴 𡉠	
圩	𱖇	
圪	𡉛	
圬	杇	
圭	珪	
圮	䤏 圯	
地	𨹛 坔 嶳 𡑸 𠏂 𡓬 𡍑 埅 𡏇 埊 𤅴 墬 𨻐 𡒴 𮴃	
圱	圲 𱖇	
圲	𱖇	
圹	壙	
场	場 塲	
圻	垠	
址	阯	
坁	坻	
坂	阪	
坄	炈	
坆	墳	
均	圴 𡉲 袀	
坉	𡉒	
坊	埅 𨹛	
坋	坌	
坌	坋	
坍	𡉱 㘱 𣲹 𣲕	
坎	埳 輡 𡸞	
坏	壞 壊 坯 𠂾 阫 𤬭 𱖨	
坐	座 㘴 𡉡 𠱯 𡋲 𡊎 㘸	
坑	阬 𡌖 𡊬	
坒	㘩	
块	塊 凷	
坚	堅	
坛	罈 壇	
坜	壢	
坝	壩 垻 𮰤	
坞	塢	
坟	墳 𱖸	
坠	墜	
坡	𡶅 𡶆 岥	
坤	堃 𠔧 巛 𡘩 𡿭 𠔜	
坦	憻	
坩	㽍	
坪	𡊞	
坫	店	
坬	𲝋	
坭	泥	
坯	壊 壞 坏	
坰	冋 冂 冏 埛 垧 𡹫	
坳	㘬 㘭 垇 𱖎 𱗅	
坵	丘 丠 𠤢	
坶	㙁	
坺	墢	
坻	坁 𣹡 㞴 坵 𡌟 𡉬 𡊓 𣲋 𡊈 𡉶 𡊆 𡍓 坘 𡊇 𡉳	
坼	拆 𡍩 𤇚 𣂙 𡍔 𤗙 𲭋 𤖴 烢 𢯪 𱗗 𲢄	
坾	垨	
坿	䂤	
垂	埀 𡍮 𠂹 𲐬 𠦬 𲑅 𠣔 𡷩	
垄	壟	
垅	壠	
垆	壚	
垇	𱖎	
型	𡌁 𠜚 𡌒 坓	
垑	𡋝	
垒	壘 塁	
垓	陔 畡 𡌟	
垔	堙 陻 𡋘 𡌓 𡓓 𡐲 㘻 𡎱 𡊹 𡍏 𡍯 䧣	
垗	𤱩	
垙	𤱦 𨹂 𤱳	
垛	垜 𲙀 𨸳 𨹄 𨹃	
垜	垛 𲙀	
垝	陒 𨹣	
垠	圻 𡋳 㙬 𡊷 𡹊 𡏴 垦	
垡	墢 㘺	
垢	坸 𡊦	
垣	𩰵 𥥣 𩫧	
垦	墾	
垩	堊 聖 圣	
垫	墊	
垭	埡	
垯	墶	
垱	壋	
垲	塏	
垴	堖	
垵	埯	
垶	㙚	
垷	𰉚	
垸	𡌗	
垹	挷	
垻	壩 坝	
垼	坄	
垽	㴈	
垿	㘧	
埀	垂	
埂	𡎩	
埄	𲙬 𡓄	
埇	甬	
埉	𰉥	
埋	薶 𱼭	
埍	𲙙	
城	𩫨	
埐	𡎹	
埒	埓 㽟	
埓	埒	
埘	塒	
埙	塤	
埚	堝	
埜	野	
域	㽣 䧕 𢨊 𡌳	
埡	垭	
埤	壀 𡌸 𡌹 𡐕	
埨	𫭢	
埬	𪣆	
埭	𡐡 𥓏	
埯	垵	
埰	采 釆	
埲	埄 𲙬	
埳	坎 塪	
埴	𡑠 𡌴 𡍠	
埵	𡑊	
埶	藝 兿 蓺 芸 秇 勢 㙯 𡎐	
執	秇 执 𡚺 𦎃 𡘺 𢦕 𠌷 𡙕	
培	㟝 垺 𡌮	
基	𡋵 𡉝 踑 𨄎 𡉊	
埻	𡓑 𡓣	
埼	崎 嵜 碕 陭 𥔎 﨑 㟢	
埽	掃	
埾	𡒍	
堀	𡒈 窟	
堂	隚 㙶 坣	
堃	坤	
堅	坚 𡉢	
堆	𡺾 𡸠 𡸬 𡻛 㢈 垖 𣳨 𡌙 䜃 塠 㕍 𡒌	
堇	菫 蓳 𡐳 𡎸 𡏳	
堈	罁 缸 𰉙	
堊	垩 聖 圣 𡌥	
堋	𠳫 𥦜 𡊤 𡐐	
堑	塹	
堕	墮 𱘂 𲉑	
堖	垴	
堘	塍	
堙	陻 垔 𲃰	
堚	𪣒	
堛	㽬	
堜	埬	
堝	埚	
堞	𡍕 𡑢	
堡	堢 𡋠 㙅	
堤	隄 埞 𡐾	
堦	階 阶	
堧	𡑂 壖	
堩	𡍷	
堪	𢦟	
堫	䎫 𦔕	
堭	隍 墴	
堮	𡑇 𡓐	
堯	尭 尧 垚 𡋰	
堰	墕 隁 𱖨 𪣈 𲚂	
報	报 𡙈 𨖪	
堲	垐 㘹	
場	塲 场 㙊 𲘵 㘯 𮰬	
堵	𡦡 𩫭 𱖻	
堶	𤭨 𥓿 砣 𡊵	
堺	畍 界	
堽	𡌕	
堿	鹻 鹼 鹸 碱 礆 硷	
塁	壘 垒	
塂	𱴘	
塆	壪	
塈	墍 𡒖 𡏲 𡍳 𡉙	
塊	凷 块 𠚛 㙕 墤 𡒽	
塋	茔	
塌	𡓲	
塍	堘 畻 塖 𣎒 𤳔 𤳮 𦩱 𰊷 𲙖	
塎	𲙪	
塏	垲 𧯧	
塐	塑	
塑	塐	
塒	埘	
塓	㨠 𱖴	
塔	墖 𩫊 㙮	
塗	凃 涂 𡒎 嵞 𱦑 𱧕	
塘	䧜	
塙	㱋 墧	
塚	冢 塜	
塜	塳	
塞	𥤧 𡺶 㩙 𡩿 𡫼 𡔂 𡫩	
塟	葬	
塡	填 窴	
塢	隝 鄔 隖 坞 䃖 嵨 埡 𨻑	
塣	浧	
塤	壎 埙 𡎖	
塩	鹽 盐	
填	塡 窴 𡒆 𰉰	
塯	㙧	
塲	場 场 畼 𤳈	
塳	塜	
塵	尘 𡐪 𡔚 𪋻 𡒲 𱼲	
塸	𫭟	
塹	壍 堑 㟻 𡐛 𲙏	
塺	㙁	
塼	𫭞	
塾	𨷙 𨶝 𡔊 𱘁	
塿	𪣻	
墀	𡎰 𡉶	
墁	𡑦	
墆	𰊂	
墇	㢓	
墈	磡	
墉	牅 𤰎 䧡 牗 𩫱 𩫃	
墊	垫 埝	
墋	𫮅	
墌	坧	
墍	塈	
墏	𰊈	
墐	𡒣	
墓	𱥕	
墖	塔	
増	增	
墙	牆 墻	
墜	坠 𨽎 礈 𨼾 䃍 𨺵 𱴮 𲚠	
墝	磽 𫭪	
增	増 𢴣	
墠	𫮃 𡐕 𥑲	
墡	磰	
墢	𫭨 坺 𡍰	
墣	圤 㙸 𡓙	
墤	隤 𲙢	
墧	𰉩	
墨	𱗐	
墩	墪	
墫	樽 罇 壿	
墬	𡒰	
墮	堕 𡐦 𲿵 𡺆 隓 陊 𡓉 𲉠	
墰	罈 壜	
墲	𪢸	
墳	坟 坆 隫 𡏶 𡼝 𲙟	
墶	垯	
墷	𰉪	
墹	𱖲	
墺	圫 𡐟 𲚒 𡋮 𡌱 𡋸 𡶮	
墻	牆 廧 墙	
墼	𤮛 𡒼	
墽	𡒋	
墾	垦 𡓚 𡍭 𲚌	
墿	𰉣	
壅	𡔏 𡓱 㽫 㙲	
壆	𱖐 𲘿	
壇	坛	
壈	𡒄 𡓔	
壊	壞 坏 坯	
壋	垱	
壌	壤	
壍	塹 𰊢	
壎	塤 壦 坃	
壏	𰊑 𱗏	
壐	璽 𡊑 𱖚	
壑	𡓛 𡔗 𧯉 𡺻 㕡 𡓼 𱪐 𱴅 𲂛 𲂜 𲙗 𭐋 𲚢	
壒	𡑷 𭏦	
壓	圧 压 𰉧 𲚜 𲪮	
壔	𭎜 𡑹 𡑏	
壕	𨼍 𱴽	
壖	𡑂 堧	
壗	𡋤	
壘	塁 垒 㙼 壨 畾	
壙	圹	
壚	垆	
壛	𰊡	
壜	墰 罈	
壝	𭏸	
壞	壊 坏 坯 𡎯 𣀤 𢸬 𲚣	
壟	垄 𡾩 壠 𲉥	
壠	垅	
壢	坜 𡐰	
壣	𪤚 𡑜	
壤	壌 𦦶 𠧑 𱼱	
壧	𫭲	
壩	垻 坝 䃻 埧	
壪	塆	
士	土	
壬	王 𡈼	
壮	壯	
壯	壮 牡 壵 𩡽 𡉟 扗	
声	聲 𱰎	
売	賣 卖	
壳	殼 殻 㱿	
壴	𧯛	
壶	壺 壷	
壷	壺 壶	
壸	壼	
壹	一 弌 𡔹 壱 𡔾 𡘵 𡕌 𡕍 𡕋 夁 㚃	
壺	壷 壶 𡐎 𡔥 𥁖 𡔦 𠻭 𢑹 𱴕 𳆷	
壻	婿 聟	
壼	壸 𡔶 𠁕 𡈋 𠆊 𡆵	
壽	夀 𲜢 寿 𤕋 𦓁 𡔽 𠷎 𠭵 𠋮 𦓃 𱻩 𱻫 𱻬 𱻮 𲅟	
壾	𥂷 𥂇	
壿	蹲 墫	
夀	壽 寿	
夃	𡕔	
处	処 處	
夅	降	
夆	𡕖	
备	備 偹 俻 𱏌	
変	變	
夊	攵 夂	
夌	麦	
复	複 復 覆 𡕨 𠰞 𱵡	
夎	䟶	
夏	𨂮 𩖳 昰 𡕻 𠍺 𡔰 𣋗 𡕾 𤴞 𠌘 夓 𲅵 𲊱 𮶖	
夐	敻 𡕷	
夔	𣦞 𩠰 𧃰 𲽠 𡕿 䕫 𣀚 𱾱 𱿇	
外	夘 𡖄	
夗	夘 𲚲	
夘	卯 戼 夗	
夙	𠉦 𣦽 𠘵 𡖆 𡖊 𡖕 𠈇	
多	夛 𢑰 𡖈 𡏗 𡖩 𢑑	
夛	多	
夜	亱 𠙇 𠙑	
夝	殅 甠	
够	彀 夠	
夠	彀 够 𡖜	
夢	夣 梦 㝱 𦴋 𧁌 𱘬	
夣	夢	
夤	𡖷 𡖴 𡖸	
夥	伙 𡖿 㚌	
大	𠘲 亣	
天	靝 靔 𠀡 䒶 𩇞 𩇗 𠀘 㕦 𠑺 兲 𦴞 𠕹	
太	𣡳 夳	
夫	𧥱	
夬	叏 𡗒	
夭	殀 𡰭 𡕟 叐 𫯛	
夯	䂫	
夰	㚏	
失	𢩥	
夲	本 𠦍 𠇏 𠦂	
头	頭	
夷	𡖴 𡰥 𡗝 𲐟	
夸	誇 𡗴 𡘆 𱒪	
夹	夾	
夺	奪 𱡚	
夾	夹	
奁	奩 𲅬	
奂	奐 𱫌	
奃	𡗨 𡗰 𡘄 𣱋	
奄	𡘹	
奇	竒	
奈	柰	
奉	𣩌 𠬻 𱝔	
奊	𨾗 𥸸 𱑆	
奋	奮	
奌	点 點	
奎	奞 㚝 䖯 𡌤	
奏	𡙹 𢽥 𡳡 𡲱 𡘶 𡴨 𡴝 𠭕 𡲯 𠭡 㔿	
奐	奂 𢍅	
契	𡬨 𢍠 𢍆	
奓	𡘐	
奔	犇 逩 𧾭 𨃦 𧿣 𩣺 𩦥 𧾜 𨁼 𠬼 𥝯 𢍃	
奕	弈	
奖	獎 奬 奨	
套	𡘷 𡘂 㚐 𲀾	
奘	弉	
奜	猆	
奞	奎 㚝 𨾮	
奠	𠪝	
奢	奓 𲊴	
奣	奛	
奥	奧 𫤭	
奧	奥 𡪿 𡪃 𢍢 𠆇	
奨	奬 獎 奖	
奩	匳 奁 𡙗 匲 𨕏 𣫢 𢅸 𨘰 籢 𲶓 𢊴	
奪	夺 敓 𠔟 𡜎 𡙸 𡙜 𡙬 𱚡	
奫	𫯶 𡙨	
奬	獎 奨 奖	
奭	𠁗	
奮	奋 𱡠	
奯	𫯥	
奰	𧹈 𡚤	
奲	𫰂	
女	𠨰	
奴	仅 㚢 𱰾	
奶	嬭 妳 𠂏	
奸	姦 姧	
她	他	
奻	𡠛	
奼	姹 仛	
好	㝀 𡥆 㚥 𩐔 𡥃 𢑒	
奿	𡚺	
妃	婓 𡝞 𡝑 𡚱 妑	
妄	𡔞	
妅	娂	
妆	妝 𱹆	
妇	婦	
妈	媽	
妊	姙 𨉃 𡜟	
妍	姸 蔅	
妎	𡛐	
妒	妬 姤	
妓	姼 𲛍	
妖	𡝩 𡣡	
妘	𡛍 㜏 𡞩 𪔈 𡤀	
妙	玅 𡭹 𮰹	
妝	粧 妆 娤 䊋 糚 籹 𡞓 𤖩	
妠	𡜴	
妣	𡚨	
妤	伃 𱙓	
妥	𡛎 𢼻	
妦	㛔 𡜠	
妨	㤃	
妩	嫵	
妪	嫗 𱠫	
妫	嬀 媯	
妬	妒	
妯	㛩	
妳	你 伱 儞 奶 嬭	
妻	𡜌 𡜈 𡜽 𡝣 𡜛 𲝟	
妾	㛙	
妿	㚳	
姆	姥 娒	
姉	姊	
姊	姉 𡛷	
始	兘 𠃭 乨 𠙉	
姌	㚩	
姍	姗 𡜜 㛽	
姐	她 毑 媎	
姒	㚶 娰 𱝼	
姓	𤯧 𤯣 𤯬 𤯕	
委	𮰼	
姗	姍	
姙	妊	
姛	𩒗 𡜝	
姜	薑 葁 𡜠	
姝	𡚾	
姞	𡜩	
姡	𡜶	
姢	娟	
姣	㚣 𤕢	
姥	姆	
姦	奸 𡜑 𢙶 𢛝 姧	
姨	𫰆	
姩	𡝟	
姪	侄 𡥺 妷	
姫	姬	
姬	姫 㚦 姖 㚶 𲛠	
姰	𡟱	
姳	𠋶 佲	
姶	㛕 䏩	
姸	妍	
姹	奼	
姺	䢾 㜪	
姻	婣 𡜭 𤯠	
姼	𡚼 𡛜	
姿	姕 𱦢 𱧢	
娀	𡞨	
威	𤰴 𤱫 𱰨	
娄	婁 𮱅	
娅	婭	
娆	嬈	
娇	嬌	
娈	孌	
娍	𡡛	
娎	𡝊	
娐	𡣷 𱙠	
娑	𣯌 𣯢	
娕	𡣒 𨃢 孎	
娖	𡣒 𨃢	
娘	孃 嬢	
娙	𫰛 𡜇	
娚	喃 諵	
娛	娯 娱	
娜	𡟦	
娟	姢 𲛓	
娠	㛛	
娥	䄉	
娩	㝃 嬎 嬔 㛯	
娬	嫵	
娯	娛 娱	
娱	娛 娯	
娲	媧	
娴	嫻 嫺	
娹	婱 妶	
娿	婀	
婀	娿 妸	
婁	娄 𡡋 𡝨 𡜰 𡝤 𡞔 𡇔 𡡼 𱼰	
婆	𡣩 㜑 𡟖 𱥜	
婉	䛷	
婎	𡠓	
婐	婑	
婓	婔	
婕	媫	
婗	𱙂	
婘	𡤡 孉 𡢸	
婚	𡕽 𡖀 𡝪 𡕼 㛰	
婜	𫰐	
婞	𡟡	
婟	嫭	
婡	𫝫	
婣	姻 𫰿	
婦	媍 妇 𢽰	
婧	婙	
婨	𱙇	
婩	𡛢	
婪	𮱌	
婬	淫	
婭	娅	
婳	嫿	
婵	嬋	
婶	嬸	
婸	𢢘 𰋸	
婾	媮	
婿	聟 壻 𡎎 𡠸 𦕓 𦖜 𱻹	
媁	𫰍	
媄	㜫	
媅	妉 㚮	
媆	嫩	
媈	𫝨	
媊	𡠔	
媌	㑤 𪝌 㚹	
媍	婦	
媐	𡟮	
媕	㜝	
媚	𡡾 𡡚 𰋻	
媜	𰌂	
媞	姼	
媟	𡤏 𡝥 𡜄	
媦	𡣃	
媧	娲 𡢓	
媩	𡛚	
媪	媼	
媭	嬃	
媮	婾	
媯	嬀 妫	
媰	㛀 𡦅	
媵	𦩩 㑞 𠈪 𠊶	
媸	妛	
媼	媪	
媽	妈	
媿	愧 謉 聭	
嫂	㛮 㛐	
嫈	𰌀	
嫉	𡜱 愱 𡜍 𢞱	
嫋	裊 嬝 袅	
嫌	𱻒 𢙝	
嫐	喃 娚	
嫔	嬪	
嫕	嫛	
嫖	闝 𡤚	
嫗	妪	
嫘	𡤯	
嫙	𡡍	
嫛	嫕 𡤖	
嫟	𡠷 嬺	
嫡	𡡿 𲛪	
嫢	𡣅 𡠝 𫰹	
嫥	𡞤 𰋹	
嫧	𰌇 𡢲	
嫩	媆 𡞾 𦠫 𤯦 嫰 㜛 𤯯	
嫫	嬷 𡠜	
嫭	𡢙 𲛞 𡞛 𡛚 𡚯	
嫯	㜜	
嫱	嬙	
嫳	𡡹	
嫴	𨐞	
嫵	娬 妩 𡣆	
嫷	媠	
嫸	𡣌 𡤮	
嫺	嫻 娴 𱙗	
嫻	嫺 娴	
嫼	𡣫	
嫽	𡢴	
嫿	婳	
嬀	媯 妫	
嬂	𡛰	
嬃	媭 𡡓	
嬅	𫰡	
嬇	𫝬	
嬈	娆	
嬋	婵 𡠐	
嬌	娇 撟	
嬎	娩 嬔 婏 𡤹 㛯	
嬐	𫰰	
嬒	𫰢	
嬔	娩 嬎	
嬘	𡟝	
嬙	嫱 𡣰	
嬛	妚 𡣱	
嬝	裊 嫋 袅 㜵 𮱒	
嬟	𮰸	
嬡	嫒 𲛖	
嬢	孃 娘	
嬣	𪥰	
嬤	嬷 𡡉	
嬦	𫝩	
嬧	𮱁	
嬩	𱙄	
嬪	嫔 𡣕 𡣑 𡝏 𨊕 娦 𡤁 𲄮	
嬬	𡢉	
嬭	奶 妳 㚷 𡤘 𡇲 𡛾	
嬮	𰋽	
嬰	孾 婴 孆 𦦿 𰋷 𲛣	
嬲	𠒰 𢣲 𤲶 𱰛	
嬳	𡤬	
嬴	𡣍 㜲 𦏝 𡢣 𡢔 𱻓 𱻕	
嬵	婂	
嬷	嫫 嬤	
嬸	婶	
嬻	䢱 𪥿	
嬽	𡣬	
嬾	懶 懒 孏 孄 𰌙 𢛔 㦨 𲠫	
嬿	嬊 𡤈	
孀	霜	
孂	𥶞 𤃾	
孃	嬢 娘	
孄	𫝮	
孆	𫝭	
孇	𪥫	
孈	𡣸	
孉	𱙴	
孋	㛤 𡠈	
孌	娈 𡤣 㜻 𡤨 𡡗 𡢛	
孍	𱙔	
孎	𡠟	
孏	𮰾	
子	𡿹 㜽 𡐫 只 𢀇 𢀈 𠙭 𢀉 𱾲 𣕓 𱒅	
孑	𠆨 𡤼	
孒	𠀔	
孔	𡤿	
孕	𡢘 𥀨 𣎜 𡥗 𨈼 㚺 㞌	
字	𥤪 𡥜	
存	侟 𠩯 𡥅	
孙	孫	
孚	孵 𤓽 𱬻 𱻽	
孛	𡥞 𡥇 𱙼	
孝	𡥉 𡥍 𡥈 𢻯	
孟	𥁪 𱲌 𱲏	
季	𩐄 𡥞 𡦠 𩐖	
孤	𦣮 㜾	
孥	𠩨	
学	學	
孩	䪱 姟 㜾 𠹛	
孪	孿	
孫	孙 𡤾	
孭	𧴯 𱙷	
孯	𡦋	
孰	𠅩 𩪿	
孲	𰌦	
孳	孶 𡥝 𢀐 𢇖	
孴	𡦏 𡥦 孨 𡥨	
孵	孚 𡥭	
孶	孳	
孷	𡥽	
學	斈 学 斅 𡕕 𢻯 𣁃	
孺	𡦘 𡦗	
孻	𡦌 𡥧	
孼	孽	
孽	孼 𦽚 𧃯 𦽆 㜸 𡦣 𰰟	
孾	嬰 𪧀	
孿	孪 㝈 𤲶	
宁	寧 寜 寍 寕	
宂	冗	
它	牠 佗	
宄	𢗐 究 𡧫 𡧌 𠬚 𱚍	
宅	𡊾 𡧜 㡯 𡧪 垞	
宇	𡧈 㙑 㝢 㡰 𢉠 穻 𠨯	
守	𡬴 㝊 𡬮 垨	
安	侒	
宊	突	
宍	肉	
宏	䆖	
宐	宜 冝	
宓	虙 𧶡	
宕	雼 𥥔 𡇵	
官	𡧺 𡦹 𠕍	
宙	㣙 𥥉	
定	㱏 㝎 𱶰	
宛	惌 𱚆	
宜	冝 宐 㝖 𡪀 𲜚 𠣨 𡨆	
宝	寶 寳 寚 𱯕	
实	實 実	
実	實 寔 实	
宠	寵 𮱞	
审	審	
宣	𡨈 𡪏 𡩦 𠖚	
宥	䆜	
宦	䆠 𠋪 𠈄	
宧	𥦪	
宪	憲	
宫	宮	
宬	窚	
宮	宫	
宯	窙	
宰	𡨔 𡪤 𲜍 𠈾 𡨧 𱚎	
害	𡨟 𤇵 𠕛 𡧱	
宴	讌 醼 燕	
宵	𣆺 𲉱	
家	傢 𡩀 𡧚 宊 𰍀 𡩙 𡩵 𡩅 𠖔 𱚃 𱚅 𡦼	
宸	䆣	
容	㣑 㝐 𠕺	
宻	密	
宼	寇 冦	
宽	寬 寛	
宾	賓 賔 𮱫	
宿	㝛 𡩤 𡪴	
寀	宷	
寁	𢧺	
寂	𡨁 𥥒 𡧯 𡧴 𢚍 𡧘 𡨜 𧧌 𥤽 䆥	
寃	冤 𡨚 𲒊	
寅	𦦚 𡩟 𡩪 𢁐 𡓵 㝙 𱶺	
密	宻 𡪖 𡶇 𢛬 𱚙	
寇	冦 宼 𡨥 𥦆 𡯷 𢽉 窛 𥦲 㓂 𱏽	
富	冨 𫲷 𲜋	
寍	寧 寜 寕 宁	
寐	𥧴 𱶽 𱷁 𱷍 𱷐 𱾺	
寑	寢 寝 𠖗 𡩠 𡪢	
寒	𣽬 𡫮 𡫾 㥶 𡫜	
寓	庽 𡪾	
寔	實 実 𥦽 𥥐	
寕	寧 寜 寍 宁	
寖	𣹦	
寗	甯	
寘	置 𱚇	
寚	寶 寳 宝	
寛	寬 宽	
寜	寧 寍 寕 宁	
寝	寢 寑	
寞	𡖶	
察	詧	
寠	窶 𪧘	
寡	關 𡩼 𧵿 𠆣	
寢	寑 寝 𡨞 𡫒 𡬓 𡪢 𡨦 㝲 𥨊 𱶼 𱷊 𱷓 𱷔 𱷕 𱷖 𱷘 𲊃	
寣	𡩺	
寤	𡨟 𡬑 𡨂 窹 𲜖	
寥	𡽦 廫 𡽐 𱕐	
實	実 寔 实 𡾍 宲	
寧	寜 寍 寕 宁 𡨴 𡬛 㝕 𡩬 𱶹	
寨	砦 𱖞 𱛜 𰌻 𲜉	
審	审 宷 讅 𡩨	
寪	𰌷	
寫	冩 写 𧭠 䥱 㝍 㕐	
寬	寛 宽 㝟 𥦀 𲁎	
寮	竂	
寯	㝦	
寰	𡕅	
寱	㦣 䆿 囈 𡬒	
寳	寶 寚 宝	
寴	𡩁	
寵	宠 𠖥	
寶	寳 寚 宝 𡩧 𩇉 𡪓 𤥖 㻄 𠋾 宲 珤 𡫷	
寷	𫲸	
对	對	
寻	尋 𱑵 𲇈	
导	導 𱵯 𲀣	
寿	壽 夀	
尀	叵	
封	𡊋 𡉘 㞷 𡊽 𡉚 𱛣	
専	專 耑 专	
尃	旉 敷	
射	𨈡 𨉛 𢎤 䠶 𲄞 𲄟	
尅	剋 克	
将	將 𤕭	
將	将 𤕭 𢪇 𢪽 𱭗 𲅳	
專	専 耑 专 叀 𠧡	
尉	㷉 𤈫 叞	
尊	𥈪 𢍜 𡭆 僔 𰃝	
尋	寻 㝷 𢒫 𡬻 𡬰	
尌	𠊪	
對	对 𡭊 𡁨 対	
導	导 𡭎 𣜦 𡭑 𧘀 𧘄 𱵮 𲅾	
小	𡮐	
尐	𧉍	
少	尐 𮱡	
尒	尔 尓 爾	
尓	尔 尒 爾	
尔	尓 尒 爾	
尖	𡭞	
尗	叔	
尘	塵 𱖉 𱖦	
尙	尚	
尚	尙	
尜	嘎	
尝	嘗 甞	
尟	尠 鮮 鱻 鲜 赻	
尠	尟 鮮 鱻 鲜	
尢	尤 尪 尫 尣 𡯂 兀	
尣	尪 尫 尢	
尤	尢 怣 𡯊 𱺷	
尥	尦 𡯡	
尦	尥	
尧	堯 尭	
尨	厖 庬 狵 龐 龎 庞 厐 龍 竜 龒 龙	
尩	㑌	
尪	尫 尣 尢 𡯪 𠅪 𡯲 㑌 尩 𡯭	
尫	尪 尣 尢	
尬	魀 𠆷 𡯔	
尭	堯 尧	
尯	𣧼 𥎾	
尰	腫 𡰒 𡰕	
就	𡰜 𡯶 𡰔 𡰗 𲧤	
尲	尷	
尳	㾶 𡰊	
尴	尷	
尵	𪨇 𡯺 𮱣	
尷	尲 尴 𡰉 魐 尶 凲	
尸	屍 𡰣	
尹	𢂫 𢂟 𢂬 𢁨 𢃂 𢃵 𢃹 𢃁	
尻	䯌 𡱧 𦙷 𡰼 凥	
尼	𡰥	
尽	盡 儘 侭	
尾	𡱓 𲜷 𡱲 𡲵 㞑 𡱕 𲜸	
尿	溺 脲 𣭼 㞙 𡱤 𣻨 𡲳 㳮 𡱴 𡲘 𲜼	
局	𢩁	
屁	㞑 𥤶 𡲩 𥥓 𥧔	
层	層	
屃	屓 屭	
屄	毴 𡚦 𲨋	
居	㞐 𡨢 㝒 𧿃 凥	
屆	届	
屇	㧂	
屈	𡲶 𡲬 𡲒 𡲗 𡕜 𣮈 𡳘	
屉	屜	
届	屆	
屋	𦤿 𡲃 𦤼	
屍	尸	
屎	𡲔 𦳊 𡱁 𡲑 𡲖 𥺶 𱚵	
屏	屛 摒 拼 幈	
屐	𡰸 𱚽	
屑	㞕	
屓	屭 屃	
屔	泥 𡲌 𢇀 𥩥 𡎿	
展	㞡 𰍰 𲓻	
屖	𡥷	
屙	㢐 𡱻	
屛	摒 屏 拼	
屜	屉 𡲕 屟	
属	屬 𡱆 𰍱	
屡	屢	
屢	屡 𡜸	
屣	蹝 躧 𩌦 𩌳 𩎉 𩋀 𳊥 𦁡	
層	层	
履	𩕎 𢔃 𨂠 㞛 𡳐 𡲟 𱽅 𲊷	
屦	屨	
屧	屟 𧀢 屜 𡲕	
屨	屦	
屩	蹺 蹻 跷 𪨗 𩌡 鞽 屫	
屪	𡳇	
屬	属 𡱆	
屭	屓 屃	
屯	𮯲	
山	𡶸 𠙸	
屲	𱛘	
屹	阣 𨸛 𤣮 𡵊 𡵋 𡴭	
屺	𡵆 㞯	
屿	嶼	
岀	出	
岁	亗 歲 歳 嵗 𡻕 𱜁	
岂	豈	
岃	𱛏 𱛐 𮱥	
岈	㗿 谺 𧯋 𧯓	
岉	𱛎	
岊	𡴱 𡸎 𡷦 𡴼	
岏	𲞭	
岐	歧 𨙸 㞿 㟚	
岑	埁	
岓	𡵱	
岖	嶇	
岗	崗	
岘	峴	
岙	嶴 𱖎 𱜓	
岚	嵐	
岛	島 嶋 嶌	
岜	𲝐	
岝	岞	
岡	冈 堽 𲙷 𠆼 㟵 㓻 㟠 𦊤 𡶬 𡶩 罡 𡷇 𨹽 崗 𡹤 𱯒	
岢	㞹	
岣	𡵺	
岧	岹	
岨	砠 𥕅 𪂓 𥥐	
岩	巖 巌 𱛢	
岪	𡶒	
岫	峀 䜬 𥥉	
岬	𥑐	
岭	岺 嶺 𡿡 𮱭	
岯	𡶌 坯 𠃂 𲝆	
岱	倵 𮰣 𮱧	
岲	𡶢	
岳	嶽 𡶓 𡵹 𡶳 𱷱	
岵	𠰛	
岶	𣶎	
岷	𡼐 㞴 崏 𣊽 渂 𡹋 㞶 㟭 𡸧 㟩	
岸	屽 㟁 𲘸 𡵱 垾 𮱨	
岺	岭 嶺	
岻	𡵮	
岽	崠 崬	
岿	巋	
峀	岫	
峃	嶨	
峄	嶧	
峇	𡸡	
峉	𡾆	
峋	𱳺	
峍	𡷏	
峒	洞 峝	
峔	𡶰	
峗	峞	
峘	𡴿 𡵎 𡷗 𡷆	
峙	崻 𱝶	
峛	峢 峲	
峡	峽 𱛑	
峣	嶢 𱜐	
峤	嶠	
峥	崢	
峦	巒	
峨	峩 𡽥 𠩙 𡻍	
峩	峨	
峭	陗 𡹺	
峮	㟒	
峯	峰	
峰	峯 𡵞 𡷅	
峱	𡾂 巎 嶩	
峳	𩥘	
峴	岘	
島	嶋 嶌 岛 嶹 㠀 隝 隯	
峹	𡷣	
峺	硬	
峻	埈 𡻴 𨺮 𡍵 𡋴 𡺲 𡼕 陖 𨻅	
峽	峡 硤	
峿	𡷤	
崂	嶗	
崃	崍	
崄	嶮	
崇	崈	
崈	崇	
崋	華 华 𡼙	
崍	崃 㟈	
崎	嵜 埼 碕 陭 𥔎 﨑 𡼋 㟢	
崐	崑	
崑	崐	
崒	崪	
崔	磪 嵟	
崕	崖 厓	
崖	崕 厓	
崗	岗 𡹏 岡 𲝥	
崘	崙 𱛍	
崙	崘 𪨧 侖	
崚	𡺿 𡻴 𪌨 𡹃	
崛	𡽈 崫 𡶏	
崞	𡾘 䧐	
崟	嶔 嵚 㖗 崯 碒 㕂 𡷧	
崠	岽 崬 𰎏	
崢	峥 崝 𡸵	
崤	㠙 𡵔 𱜆	
崦	𡹮 嶖	
崧	嵩	
崩	𡷌 𲝌 𨹹 𡹔 𨻱 𡶤 𲉔	
崪	崒	
崬	岽 崠	
崭	嶄	
崮	崓	
崰	𡸟	
崱	𰎖 𲝅	
崴	㟪	
崵	𫵵 𡼍	
崷	𡺚	
崾	岆	
崿	𡼑 𡼰 㞻 㠋 𡾙 㟧	
嵂	𱛼	
嵆	嵇	
嵇	嵆 𬓠 𲵉	
嵋	𠃜	
嵌	㟛 㠌	
嵍	𥓺 𡺱	
嵐	岚 㞩	
嵒	嵓 碞 喦	
嵕	嵏 𡽀	
嵗	岁 亗 歲 歳	
嵘	嶸	
嵚	嶔 崟	
嵜	崎 埼 碕 陭 𥔎 﨑 㟢	
嵝	嶁	
嵞	峹 𡽚	
嵟	崔 𡷜	
嵠	谿 溪 渓	
嵢	𲝈	
嵩	崧	
嵬	𡸖 㟴 峞	
嵯	嵳 𡽓 𡾑 𠪉	
嵲	𡸣 嶭 𡺼 𡶫	
嵳	嵯	
嵴	𡹒	
嵵	𱛬	
嵷	𡵝 𰎌 嵸	
嵸	𡵝	
嵺	𡽟 嶛 嶚 𡻪	
嵻	𡻚	
嵼	𡶴	
嵽	崹 𫶇	
嵾	㠁 㟥 𡼶	
嶀	𡹻	
嶁	嵝 㟺	
嶃	磛	
嶄	巉 崭 㟻 嶃	
嶅	㟼 㠂	
嶇	岖 㠊 䧢 岴	
嶈	𡺃	
嶋	島 嶌 岛	
嶌	島 嶋 岛	
嶍	㠄	
嶎	蔚	
嶒	𡿘	
嶔	崟 嵚 䃢 𡼽	
嶕	嶣	
嶗	崂	
嶘	𡺄	
嶙	𡽤	
嶚	嶛 𡻪	
嶝	磴 𲞆	
嶞	𡽃	
嶠	峤 㠐	
嶢	峣 嶤	
嶤	𰎔	
嶧	峄	
嶨	礐 峃 㙾	
嶩	𰎞	
嶪	𰎑 嶫	
嶬	㠖	
嶭	𡾲 𡾦 𡺰	
嶮	崄 𡽃	
嶰	𱜒	
嶲	巂 𡾧	
嶴	岙 㠗 𱜓 𲚞	
嶵	㠑	
嶷	𡷪 㠜	
嶸	嵘 巆 峵 嵤 𡵓	
嶹	𫝵	
嶺	岭 岺 阾 𱜇	
嶻	巀	
嶼	屿 𡽬 㠘	
嶽	岳 𡴳 𡽺 𰎫 𡷒 𡶳 𡶓 𮱬	
嶾	𡾯 𡽸	
巀	嶻	
巁	𡽇 𡿋	
巂	嶲 雟	
巃	𡶹 巄 𡾩 𰎎	
巄	𱛓	
巅	巔 巓 𱂪	
巆	𫶕	
巇	𡾟 𡾞 隵	
巉	嶄 𡿣 嶃 𡽡 𡷭 𡸊	
巊	𪩎	
巋	岿 𱜔	
巌	巖 岩	
巍	魏 𡿆 𡿁	
巏	𡺹	
巑	𰏁 㠝	
巒	峦	
巓	巔 巅	
巔	巓 巅 𡻗 嵮	
巖	巌 岩 嵒 礹 嵓 巗 𰎠 𱛳	
巗	𪨷	
巘	𪩘 𲞗	
巚	𰎹	
巛	川	
川	巛	
州	刕 𣧓 𠚴 𠃕 𠄓 𢏝 𠛏 𱐕	
巟	𡿫 𣺬 𡿬 𠯚 㐬 㠩 𡿰	
巠	𡿱 𢀖 𱑱	
巡	廵 𨑾 𡿽	
巢	巣 𤔥	
巣	巢	
巤	鬣	
工	𠜝 𢒄 㣉	
左	屮 𠂇 𢀡 𱮉	
巧	𢩨 㤍 𮰷	
巨	鉅 钜 㠪 𠫕 𢀑 𢀓	
巩	鞏	
巫	𠮎 𢍦 𢀣 𢍮 𡉊	
差	荖 𢀠 𢀩	
巯	巰	
巰	巯	
己	𢀒	
巳	𱒄	
巴	芭 笆	
巵	卮	
巷	閧 𨙵 𨛜 䣏 鬨 䣈 衖 㟟 𨜕 𨞠 䢽 𨞔 𲆘 𲆡	
巸	𣢮 𦣤 戺	
巹	卺 𢬬 𢀿 𧯷 𧯢 𲼛	
巺	巽	
巻	捲 卷	
巽	巺 㢲 𢁅 𢍳 𢁌 𢌴 顨	
巾	䘜	
帀	迊 匝	
币	幣 幤	
市	𡴄	
布	佈 𢁙 㱛	
帅	帥	
帆	㠶 忛 䑺 𤖫 𩗋 𱜥 𱞈	
帇	𦘒	
师	師	
帉	𢁥	
帊	袙	
帋	紙	
希	𠬯 𢂞 𢁙 㠻 𠬹	
帏	幃	
帐	账 帳	
帑	伖	
帒	袋	
帕	絔 帞 絈	
帗	𢁵	
帘	簾	
帙	袠 怢 袟 𢁪 𲀶	
帚	菷 箒 𦲅 榋	
帜	幟	
帝	𢂇 𠫦	
帡	帲	
帢	𩉉 𧚧 𢂿 𠕣 㡊 𢃫	
帥	帅 𨸲	
带	帶 帯	
帧	幀	
師	师 𢂖 𨸲 𩇱 𠵀 𢃋 𠦵	
帬	裙 裠	
席	蓆 𥔆 𠩌 𠩛 廗 𱸩	
帮	幫 幚 幇	
帯	帶 带	
帰	歸 皈 归	
帱	幬	
帲	帡	
帳	賬 帐	
帴	𰏕	
帶	帯 带 𢄔 𨗼 㿃 𢂸	
帷	𠥎 𠥛	
常	㦂	
帺	𢃛 𧚈 褀	
帻	幘	
帼	幗	
帽	𧛕 㡌 冃 𫷀	
帿	𢃨	
幀	帧 㡧 𥨰 𢹑 幁 㡠 𱷚	
幂	冪 鼏	
幃	帏 𠥎 褘 愇	
幄	𧛐 楃 𢄰 𲠓	
幅	䋹 愊	
幇	帮 幫 幚	
幋	褩	
幌	𱜳	
幎	𢃮 幂 𢁽	
幐	𦩫	
幒	𢃭 𢃪 𧛤 𧜢 䘴 䙂 𢃓 衳 𢃧	
幓	㡎	
幔	㡢	
幕	幙 𫯜	
幖	𢅚	
幗	帼 簂	
幘	帻 𢅙	
幙	幕	
幚	帮 幫 幇	
幞	襮	
幟	旘 帜 𣄞 𢂴	
幠	𢅿 𭘓	
幡	旛 𢟷	
幢	橦 𣄢	
幣	幤 币 𧝬 𢄞 𧸁	
幤	幣 币	
幦	簚 𢅓 𧜀	
幧	㡑 幓	
幨	𢃔 裧 𢅐	
幩	𪩸	
幪	𢄐	
幫	帮 幚 幇 縍 䩷 㿶	
幬	帱 𢄛 𢅱 𢅂 𢃖	
幭	簚 𢅓 𢅵	
幯	擳	
幰	𫷉	
幱	襕 襴 𢆄 𰏟	
干	乾 亁 幹 榦	
平	𠀒 𠀭 𤔁	
年	秊 𠦅 𠦚 𠡦 𠫺 𦼌 䄭	
幵	开 𢆛	
并	幷 併 倂 並 竝 𢆙 𮵕	
幷	并 併 倂 並 竝	
幸	倖 𡴘 羍 𢆎 𦍒 𠂷 𱹬	
幹	榦 干 䯎 𩩃 𠧄 𱘹	
幺	么	
幻	𣥌 㕕 𢆱 𠄔 𲜯	
幼	糿 糼 𠣎 㓜 𢆲 𢆱 𢈗	
幽	凼 𤄘 𠫬 𢆶 𱐍	
幾	几 𢆻 𢆼 𨗂	
广	廣 広 𲅅	
庀	䚹 䚰 𠨬	
庁	廰 廳 厛 厅 𥑈	
広	廣 广	
庄	莊 荘	
庅	麽 麼 么	
庆	慶	
庇	芘	
庉	𢇠	
床	牀 𤴷 𱭏	
庋	庪 㨳	
庍	𢇩	
庎	楐	
序	𨹘 䦽	
庐	廬	
庑	廡	
库	庫	
应	應 応	
底	㡳 厎 𢇝 𢇨 𢇹	
店	坫 痁	
庘	𤵭	
庙	廟 庿	
庚	𧟴 𠩖	
庛	𢊳 𢉪	
府	㾈 𢇯	
庞	厐 龐 龎 庬 厖 尨	
废	廢 廃 𱷬	
庡	㕈	
庢	厔	
庤	𤲵 𤲔	
度	㡯 𲟁 𢜬 𡧪 𤸿	
座	坐	
庫	库 𲟀	
庬	厖 尨 龐 龎 庞 厐	
庭	𨓍 𨓀 𲅝 𲅞 𨑳	
庮	𢈞 𢈬 𠩚	
庲	𫷬	
庳	𢈷 𡲎	
庵	菴 广 蓭 𲟉	
庶	庻 𠪜 𠦜 𤈲 𠪛 𠩽 𠪌 𠪤 𢉙 𱝅	
康	𢊪 𥹺 𠭳 𱥽 𱹜	
庸	𠆌 㐯 𦤘 𧆿 𠭻 𱰢	
庻	庶	
庼	廎	
庽	寓	
庾	斞 㔱 𤶉	
庿	廟 庙	
廀	廋	
廁	厠 厕 𨕟	
廂	厢	
廃	廢 废	
廄	廐 廏 厩 𠤙 𣉑 𢋁	
廅	㕎	
廇	𢊺	
廈	厦 𤹉 𢌂 𢌉 𢇗	
廉	亷 槏 𠪊 㢘 𢋯 𢈬 𢉧	
廊	㾿	
廋	廀	
廌	豸 𧣾 𤙪 𢊁 𤞝	
廎	庼 䯧 𢊼	
廏	廄 廐 厩	
廐	廄 廏 厩	
廑	厪 㢙 𢋓	
廒	厫 𠪭	
廓	𢋽	
廔	𫷹	
廕	蔭 𫷮 𱝍	
廖	𭙏 𲟃	
廗	𰏼	
廙	𢇙	
廚	厨 㕑 㕏	
廛	鄽 㢆 𨷅 㙻 𡏂 𲚋 䣑 厘	
廜	𢉜	
廝	厮 㒋 𤺊	
廞	𫷷 𢉄	
廟	庿 庙 𤸠 庴	
廠	厰 厂 𮰑	
廡	庑 庄 𢇜 𢋑 𢋰 𢌋	
廢	廃 废	
廣	広 广	
廥	𰏶	
廧	牆 墻 嗇 𢋾 𢊉 𢊂 𢋢 𪪞	
廩	廪 稟 㐭 𢈺 𥠌	
廪	廩 稟 𱶨 𲋡	
廬	庐 𡳬 𱱲 𪪏	
廮	癭 𫷾	
廰	庁 廳 厛 厅	
廱	雝 㢕	
廲	𢌒	
廳	庁 廰 厛 厅 𤘖 庍 㕔	
廴	𱝪	
廵	巡	
延	𨒌 𲅕	
廷	𱍓 𲅔 𮷞 𨑳	
廸	迪	
廹	迫	
建	䢖 㨴	
廻	迴 逥 廽 回 囘 囬	
廼	乃 迺	
廽	迴 逥 廻 回 囘 囬	
廾	卄 廿 㫒 𠬞 𢪒	
廿	卄 廾	
开	幵 開	
弁	辨 辧 辯 㝸 𢍘 𢍙 𢍍 𥿋 𡭪	
异	異	
弃	棄 𱎘	
弄	挊 卡 挵 拤 𠧗 𠱚 𲟗	
弆	去	
弇	𥤴 𥦍 𢍔 𥦦 𱰖	
弈	奕 𢌸 𢌾 𱪶	
弉	奘	
弊	𡚁 𧷍 獘 𰐉	
弋	𢍺	
弌	壹 一	
弍	貳 二	
弑	弒	
弒	弑 𢎍 𢎓 𢎊 𢨓	
弔	吊 𢎣 𢎱 𢎨	
引	㧈 𢪉 𢎢 𢎤	
弗	𱭸	
弘	𢎪 𣧀	
弙	𢎰 㢪	
弛	㢮 𢐋 𢐏 𢏯	
弞	𣢁 哂 㰨 𣢀 吲	
弟	𢦢	
张	張	
弡	𢏷	
弢	韜	
弤	𢎸 𢏁	
弥	彌 瀰 𢏏	
弦	絃 𲸃 𲯚 𢏸 㢺 𢐁 𢎺 𲹪	
弨	𢐕	
弪	弳	
弫	𢏈	
弭	𢏱	
弯	彎	
弱	𢐅	
弳	弪	
弴	㢯 𢐻	
張	张 弡	
弶	摾 𣚦	
強	强 彊 犟 勥 𧖑	
弹	彈 弾 𰐔	
强	強 彊 犟 勥	
弼	𢐈 𢐤 㢸 𠨒 𢐀 𢘍 𠡂 𢏇 㢶 𢻺 弻 𢐝 𢼥 𢐡 𮱸	
弾	彈 弹	
彀	夠 够 𠥚 𢐙	
彂	發 発 发	
彃	𪪼	
彄	𫸩	
彆	别 㢼 𥏟 𢏨 𡙼	
彇	𢑁	
彈	弾 弹 𢎝 𢎚 𢎲 𢎫	
彉	彍	
彊	强 強 疆 犟 勥	
彋	㢬	
彌	瀰 弥 𢏏 𢑀 㣆	
彍	𭚦	
彎	弯	
彐	彑	
彑	彐	
归	歸 帰 𱞨 𱤑 𲉐 𲉛	
当	噹 當	
彔	录 𢑗	
录	録 錄 𱚌	
彖	𧰲	
彗	篲 𥶙 𥱎	
彘	𥏉 𢑣 𠅰 𱝡	
彙	彚 汇 𦴗 𢑤 𣉰 𢑷 𢑭	
彚	彙 汇	
彛	彝 彜 彞	
彜	彛 彝 彞	
彝	彛 彜 彞 𦇚 𢇏 𢁔 𦆩 𢑱 𧤋 𱝘 𱹾 𱺋 𱺌 𱽆	
彞	彝 彛 彜	
彟	彠	
彠	彟 矱	
形	𠀦 𢒈	
彤	蚒	
彥	彦 𢒊	
彦	彥	
彧	𢒰 戫 𢒖	
彨	彲	
彩	𣁝	
彪	𢒜 𠿖	
彫	雕 㓮	
彬	斌 份	
彯	𢒵	
影	𢒬 景 𢒈	
彲	彨	
彴	仢	
彶	𠫳	
彷	仿 髣 徬 𲭱	
彸	伀	
役	伇 𠈧 𠈿	
彺	仼	
彻	徹	
彼	佊	
彿	髴	
往	徃 𨓹 迬 𧗧 𢓸 𨓒 徍 𢔎	
征	徵 徴 徰 𨒌 泟 𢌛 佂	
徂	𨒚 䢐 伹 𨖆 𡲡	
徃	往	
径	迳 徑 逕 𲅜	
待	𥩳	
徇	𢓈 迧 𢔐 伨 侚 狥	
很	𢓼	
徉	𦍕	
徊	佪	
律	侓	
後	后 𢔏 𨒥	
徐	俆 𨑦	
徑	逕 俓 径 迳 𢔉 𮱻 𲙁	
徒	𨑒 𧺔 𨑡 𢓂 𠫠 𣥲	
従	從 从	
徕	俫 徠	
得	䙷 㝵 𰆸 𢔶 㝶 𲜠 淂 𢔨 𧴫 𠭁 䙸 𬁟	
徘	俳	
徙	𨗬 𨖤 𳄻 𡕝 𡲴 𨔀 𢓊 𨑭 𱚳 𱥆 𱹇 𲅲 𲅹 𲆃	
徛	𢕗	
徜	𲮏	
從	従 从 𨒁 䢨 𠠴 𠚪 𢓅 𢔩 𨒀 苁 𨑢	
徠	倈 勑 徕 來 俫 逨	
御	馭 禦 𠨙 𡕺 𢕜 𧗪 䘘 𢓷 𧗨 𠉳 䘖 䢩 𱦐	
徤	健	
徧	遍	
徨	遑	
復	複 覆 复 𢕶 𢕒 𡕴 𢕛 𮰁	
循	偱 𲐱	
徬	彷 𢔚	
徭	傜	
微	㣲 𢕧 𣁋 𢼸 𲨀 𧗬	
徯	𢓽 𥪦 𠌜	
徲	𢔦 𢔭	
徳	德 惪 悳	
徴	徵 征	
徵	徴 征 𧗲 𢽡 𢾷 𢽠 𱖔 𲁫	
徶	𠍯	
德	徳 惪 悳 恴 㥁 𱝮 𲅯 𮷴 𲟪	
徹	澈 彻 𢖉 𢕹 𲟯 𦔞	
徺	僥 儌 侥	
徽	𥃘 幑	
徿	𪫌	
忁	𢖚	
心	忄 㣺 𲬍 𢗀 𢠝	
忄	心 㣺	
忆	憶	
忈	仁	
忉	𢖫	
忋	𱞁	
忌	坖 𱭴	
忍	㣼	
忏	懺 懴	
忒	𢘋	
忔	忾	
忕	忲 𢗗 㥭	
志	誌 𢖽 𢗍 𢗱	
忘	𲺸 㤀 𢚚 𭜘	
忙	恾	
応	應 应	
忝	㤁	
忞	暋 敃 忟	
忠	𢘑	
忡	𢥞 𢘷	
忣	㤂	
忤	迕 啎	
忥	𢖴	
忧	憂 㤑	
忩	匆 怱 悤	
忪	𢛒 𢪌	
快	𢘦	
忬	𱞀	
忭	昪	
忰	悴	
忱	𢗐 𢗑 愖 𱟴	
念	悥 𢗁	
忷	𢗮	
忸	𩈇 𩈄	
忺	𮱿	
忻	欣	
忼	慷	
忽	𢗘	
忾	愾	
怀	懷 懐	
态	態	
怂	慫	
怃	憮	
怄	慪	
怅	悵	
怆	愴	
怌	懷 懐	
怍	㤰	
怐	𢗕 𢛑	
怒	𢘂 㣽	
怓	𢜲 𢞙 𢘾	
怕	𢘣 𢗌 𢥻	
怖	悑	
怗	㤐	
怙	𢛅	
怚	𢚆 𪋙	
怛	𢘇 𢛁	
怜	憐	
思	𠃼 𢙍 𠂺 𡴓 恖 𢙦 𢍄 𱞍	
怞	㾄	
怡	𠙉	
怢	㥆	
怤	㤔 懯	
急	㤂	
怦	㤣	
性	𧢱 𳃿 𢘡 𤇣 𪫬	
怨	𢖭 㥐 𢘔 𢛪 𠨝 𠈢 𢘈 惌 㤪 𠨛	
怩	𢘒	
怪	恠 𠬭 𢘪 𱙍	
怫	𢘍	
怮	𱞇	
怯	㹤	
怰	𢜚	
怱	匆 悤 忩	
怳	恍 𱱎	
怴	㤜	
总	總 緫 縂 総 摠 揔 搃 捴	
怼	懟	
怽	𢗿	
怿	懌	
恀	忯	
恁	忹 㤛	
恂	悛 𢞧	
恆	恒 𢛢 𠄨 㔰 𢘆	
恇	𢝎	
恊	協 勰 旪 协	
恋	戀 𱟛	
恍	怳 𲁣	
恐	𢙢 𢟃 𢝭 𢖶 㤟 𢙷 𢘠	
恒	恆	
恔	㤊	
恕	㣽	
恚	㤬	
恝	𢗊	
恟	忷	
恠	怪	
恡	悋 吝	
恢	𢊝 𨒭 㷇 𲷮 烣 𱞒	
恣	𢙊	
恤	賉 卹 𧧓 恓 𱵋	
恥	耻 𦕖	
恧	𦗂 𢟄 聏 𠷼 𲟹	
恨	𢚉 𢙃 悢	
恩	摁 𢙍 㤙	
恪	愘 愙 㤩	
恫	恿	
恬	𢙖	
恭	㭟 𢚈 𢙄 𱽓 𱽞 𱽭	
息	𢙆 𧪩 𲘠	
恲	㤣 㥊	
恳	懇	
恵	惠	
恶	噁 惡 悪	
恸	慟 憅	
恹	懨	
恺	愷	
恻	惻 𲉘	
恼	惱 𱟈	
恽	惲	
恿	慂	
悀	愹 愑	
悁	懁 𢛋 㾓	
悂	𢟵	
悄	𢖹	
悅	悦 恱	
悈	𢜾	
悉	𢘻 𢙍 𢚊 𢝕 怸 𱜈 𲚯	
悊	哲	
悋	吝 恡	
悍	猂 𲐥	
悏	𫺂	
悐	惕 𢙹	
悒	𤶛	
悓	𮲁	
悔	𠧩 𢙽	
悖	怫 𡥏 𢨋 誖 愂 𡥐 𢠜 𢚦 哱 𲟾	
悚	𢥠 愯	
悛	恂	
悞	誤 悮	
悟	𠵥 𢛤 𢤓 忢 𲂡	
悠	滺 𢚐	
悢	惊 𢝋	
患	𢠶 𢡙 𢤒	
悤	匆 怱 忩	
悦	悅	
您	𠑓 𲠍	
悪	惡 恶 噁 𢙣	
悫	愨 慤 𢡱	
悬	懸 𱤛	
悭	慳	
悮	悞	
悯	憫	
悱	㥱 𱟋	
悲	𠾦 悱	
悳	德 徳 惪	
悴	忰 顇	
悵	怅 𤟔	
悶	懣 闷 㥃 𢛩	
悸	㑧 痵 𲟇	
悹	悺	
悺	悹	
悻	𢙼	
悼	𢛂 𦒺 𦓃 𡄒 𱘦 𱥏	
悽	凄 淒	
惀	𰑄	
惁	𢜣	
惃	𢟦	
惄	𩚮 𧗂 𢜷 𢞤	
情	𢚏	
惇	敦 𥫉 㥫 𢤈	
惉	𢛈	
惊	驚	
惌	𥧛	
惎	㥍 𢤵 𢗻	
惕	悐 𢡕 𢙹 惖 𢞫	
惘	罔	
惛	惽 怋	
惜	𢡽	
惝	𢠵 㒉	
惟	𢛧	
惠	恵 𦻇 𢞯 𢠞 𢥁 僡 𢞨 𦣽 𢡘	
惡	悪 恶 噁 𢙣 僫 𢛫 𢝏 䛩 䜑	
惧	懼 𱬺 𰑌	
惨	慘	
惩	懲	
惪	德 徳 悳 𢠀 㥁 𢤊 𢜖	
惫	憊 𱟉 𢢑	
惬	愜	
惭	慚 慙	
惮	憚	
惯	慣	
惰	憜 𢡢 𢢠 媠 𢞑 𢣖	
惱	恼 𤸢 悩 惚 㛴 𢚰 愡 𤺙 𢙉 𤶆 𤹻 𡡟	
惲	恽	
想	𱠢	
惵	𢛐 𢜨	
惷	蠢 憃 𢡳	
惸	憌 𡞦	
惹	𢜪	
惺	𢜫	
惻	恻 𢢥 𢝔 𲅨	
惽	惛	
愁	𢝲	
愆	𠎱 𢡊 𧗺 𨓲 𠐨 𧗭 諐 𲹄 𢝐 𠍴 㥶 䇂 𱗁 𱞖 𲁮 𨓲 𨔃 𲃌	
愇	𫹴	
愈	癒 愉 瘉 𠃄	
愉	愈 癒 𢖳	
愋	㦥	
愌	𢚾	
愍	憫 㥸 𢞰 慜	
意	悥 𰐺	
愐	𢗔	
愒	𡳅 𢢚	
愓	𢠽 𢡓 𰐿	
愕	㦍 𱞛 𱟊	
愛	爱 𢛭 𤔠 㤅 𲤍 𲟻 𢟪 𤔤 𢖻 𢙴 𢜤 𲈢	
愜	惬 㥦 悏	
感	𢦡 𱫢 𫹯	
愠	慍	
愣	楞	
愤	憤	
愦	憒	
愧	媿 謉	
愨	悫 慤 𢡱 𢢢 𧰕 𲠕	
愩	𫺌	
愬	訴	
愴	怆	
愵	𧖷 𢜷 𢞔	
愶	恊	
愷	恺	
愻	遜	
愼	慎 眘 昚	
愽	博	
愾	忾	
愿	願 𠪰 𫹵	
慁	㥵	
慂	恿 惥	
慄	栗 𢢙	
慆	惂 謟	
慇	𢟝	
慈	㤵 𩉋	
慉	槒	
態	态 㑷 𱞄	
慌	怳 㤺	
慍	愠	
慎	愼 眘 昚 㥲 𡴜 𦚉 𰑝	
慏	𢟫	
慐	𰑟	
慑	懾	
慒	𢥱 𢘄	
慓	𢥡	
慕	𢟽 𱾕	
慖	𮲇	
慘	惨 懆 㿊 𢠊 𢡖 憯	
慙	慚 惭 𰑧	
慚	慙 惭	
慝	𱑌	
慞	傽	
慟	憅 恸 𢣛	
慢	𢢔 𭜌	
慣	惯 遦 摜	
慤	愨 悫 𢡱	
慪	怄	
慫	怂	
慬	懄	
慭	憖	
慮	虑	
慯	𫹽 𤵼	
慰	𢟬	
慱	𰑁	
慲	𢟮 𰒆	
慳	悭	
慶	庆 𢝑 𢞢 𲟏 𢙎	
慷	忼	
慸	𰑵	
慹	𢟯 𰑔	
慺	㥪	
慼	慽 戚 𠎰	
慽	慼 戚	
慾	欲	
憀	𢟺	
憁	𢛌 愡	
憂	忧 𩕂 𢝊 𠪍 𢞘 𡺒 𠮕 㥑 𨗫 𢟜 𱘤	
憃	惷	
憅	慟 恸 𮲄	
憇	憩	
憊	惫 𤻚 𢟡 𤸶 𲱯 𢣍	
憋	𢠳	
憌	忳 𢗋 𱞲	
憍	𩿑 㤭 𱞽	
憐	怜 𢣶 㥕 𢠴	
憑	凴 凭 𠗦 慿 𡔟 𠌩 𱞎	
憒	愦 𢤳 𲠦	
憔	顦 癄	
憖	慭 憗 𲠝 愸	
憙	喜 憘	
憚	惮 譂 𢠸	
憛	㤾	
憝	譈 懟 憞 𢥦 𢥲	
憡	𢙀 悚	
憢	𢙒	
憣	𢟷	
憤	愤 𢤬 𢟠	
憥	憦	
憦	𫺘	
憧	𢤤 偅	
憨	𣢅 㦑 𠐣 𤸕 𤺍	
憩	憇 𦧰 𢠾 𦧗 𡳅	
憪	𰑥 𢡿	
憫	愍 悯 𢡥	
憮	怃 㒇	
憯	㦧 𢡄	
憰	譎	
憲	宪 𢝮 𢞩	
憳	𱞕	
憴	𰑪	
憶	忆	
憷	𤻇	
憸	𪫺 𢘼	
憹	𢙐 𢥯	
憽	𢤄	
憾	𢜩 𰑞	
憿	㦘	
懀	𢙓 𢘏	
懁	悁	
懂	𢤦	
懃	勤 懄	
懅	𢟶	
懆	𢠡 𢥼	
懇	恳 𢡆 𧩺 貇 𲁴	
懈	𢢣 𠢲	
應	応 应 𧭭 𡄖 𠩍 𢇭 譍 噟 𤻮	
懊	㤇 𱖎	
懋	𢘕 𢘅 愗	
懌	怿	
懍	懔 𢤭 𲡋	
懎	𢞮 𢠁	
懏	𮲋	
懐	懷 怀 怌	
懑	懣	
懒	懶 嬾 𰑐	
懓	𭞄	
懔	凛 懍 𱟗	
懕	𰑕 𱱭	
懖	𦘉 𢤌 𦗾	
懘	慸 𢤅 𰒒	
懙	𫹮	
懜	懵 𢟼 懞	
懝	𢣕	
懞	蒙 𰰡 矇 朦 𱞿	
懟	譈 憝 怼 譵 𢥓	
懠	𫺊 𢥎	
懡	𩉌 𩉚 䩋	
懢	嚂 𪬌	
懣	悶 懑 㥃 㦖	
懤	㦞 㤽	
懥	懫	
懦	愞 𢘧 懧 𢘎 㐡 䎠 𦓏	
懧	㤖	
懨	恹	
懩	𫺪	
懪	𢥑 𢥟	
懫	懥 𡒐 𰑬 𦥊 𦥋 𡏸	
懬	懭	
懭	𰐾	
懰	𰑙	
懲	惩	
懴	懺 忏	
懵	懜	
懶	嬾 懒 孏 孄 𰌙 𢛔 㦨 𲠫	
懷	懐 怀 怌 褱 𱨁	
懸	悬 𢝝	
懺	懴 忏	
懼	惧 𢡔 愳	
懽	歡 歓 欢	
懾	慑	
懿	㦉 㱅 㦤 𡕆 𱬨 𲂞 𲂟 𲂠	
戀	恋 𤕈	
戁	𫺷	
戃	𰑿	
戄	㦜	
戆	戇	
戇	戆 𢥨 戅 𢦅	
戉	鉞	
戋	戔	
戌	戉 戊 戍	
戎	𢦦 𢦛 𢍻	
戏	戲 戯 戱	
成	𢦩	
我	𢦓 𢦖 𢦐 𠨂 𩇶 𢦠 𨈟	
戒	𢌵 𢦶 𢦬	
戔	戋	
戕	牫	
或	𢦙 㦯 𢈿	
戗	戧	
战	戰 戦	
戙	㢥	
戚	慼 慽 𩒛 𡠽 𠋰 傶 縬 𢦫	
戛	戞	
戜	㦶 𢎆	
戝	賊 贼	
戞	戛	
戟	㦸 𢧢 𳇐	
戠	只	
戡	𢦟	
戢	𢨐	
戣	鍨	
戥	𲤾	
戦	戰 战	
戧	創 剙 戗	
戩	戬 𢦞	
截	𢧵 𠛍 𠃲 𢷿 擮	
戫	𢒰 㦽	
戬	戩	
戮	𦞋 勎 𦐱 𡠢 𠞨 𢑕 𡭁 𣩍 𠝧 𱻗 𱻝	
戯	戱 戲 戏	
戰	戦 战 𢧐 𣥎 𡃣 𣥭	
戱	戯 戲 戏	
戲	戯 戱 戏 𱮡	
戴	𢨚 侢 𢎑 𢨇 𱳓 𲓝	
戵	鑺	
戶	戸 户 𣥘	
户	戶 戸	
戸	戶 户	
戹	厄 阨	
戺	𢨪	
戻	戾	
戼	卯 夘	
戽	𣶉 𢨦	
戾	戻 𤟵 𢨾 𤡵 𱝲	
房	𠩝 𣃞 㝑 𢨲	
所	𠩄 𢨷 𢩇	
扁	碥 鶣 𡲜 萹 稨 藊 𳂅	
扂	𠂼	
扃	銄 𨴀 𢩁 𢇺	
扅	扊 𨳷 𢨹 㦾 𢨴	
扆	𱚸	
扇	煽 搧	
扈	𡴱 𡵆 𡴰 𫝳 𨝞 𬦺 𳃠 𫨓 𭟊	
扉	屝 𨵈 䨾 䤵	
扊	扅	
手	扌 𡴤 𠂿	
扌	手	
才	纔	
扎	紥 紮 𢮊	
扏	㧨	
扐	朸 㧅 艻	
扑	撲	
打	朾	
扔	𢫨	
払	拂	
托	拓 摭 𢸨 㧌 𢷌	
扛	摃 掆 𢱫 𢰌 𢭈 𢴦	
扜	扝	
扞	捍 𨸗	
扟	𢩫 𢩲 㧥	
扠	搋 叉 𢹓 𲢠 𢩩	
扦	𢳍	
执	執	
扩	擴 拡	
扪	捫	
扫	掃	
扬	揚	
扮	𢮈 𢪆	
扯	撦	
扰	擾 𱠖	
扱	插 揷	
扲	𲢟	
扳	攀	
扴	𢪅	
扵	於 于 亏	
扶	𢱿 㚘 𢻳	
批	𢱧	
扺	抵 㧗	
扼	搤 㧖 搹	
扽	扥 𢻴	
找	抓	
承	𢪐 𢌼 𢪻 氶	
技	𢪊	
抁	𢯻 挩	
抃	拚 㭓	
抄	摷	
抆	捪 𢪖	
抇	𢪏	
抉	刔 挗 𱟰	
把	𢮤 𢺞	
抌	舀	
抍	拯	
抑	𠨔 𢫽 𢮮 𢬃 枊 㧕	
抒	捈	
抓	找	
抔	抱 㧵 抙	
投	𣪌 𢫹	
折	𣂹 扸 摺 㪿 斨 𣂟 𣂫 𣂲	
抚	撫 𲢲 𱟳	
抛	拋 𱟶	
抜	拔	
抝	拗	
択	擇 择	
抟	摶	
抠	摳	
抡	掄	
抢	搶	
护	護	
报	報	
抦	㨀	
抩	𤙉	
抪	𢬾 㧫	
披	𤿎 𤿐	
抬	擡	
抭	㧒 抌 舀	
抮	𢷑	
抯	𢄄 𣕈	
抱	抔 怉 𱎬	
抲	揢 㧎	
抵	牴 觝 扺 𠥯 𢪔 掋 拞	
抶	𱭒	
抻	伸	
押	抻	
抽	𢭆 㩅 㨨 籕	
抾	𢬱	
抿	㨉	
拂	払 𣀪 𲢀	
担	擔	
拆	坼 𡍩 𢯪 𢫳	
拇	𧿹 胟	
拉	柆 㩉 拹 摺 𢰖	
拊	捬 撫 䵾	
拋	抛 𢱹	
拌	拚	
拍	𢫦	
拎	𢺰 㩕	
拏	挐 拿 𣭄 𢮝	
拐	枴	
拒	挋	
拓	摭 托 𢫳	
拔	抜 𢪺 扷	
拕	拖	
拖	拕 扡	
拗	抝 㑃	
拘	𢳉 枸 抅	
拙	𢼍 䂐 炪	
拚	抃 𢬵 㭓 𢪴 𢱰	
拜	拝 𢷎 𨀪 𢰛 𢴽 𢹄 𢳎 𢫶 𲯞 𣬓 𣬊 𢮠 𡴬 𱠹 𱶟	
拝	拜	
拟	擬 儗 𱭱	
拠	據 据	
拡	擴 扩	
拢	攏	
拣	揀	
拤	𱞊	
拥	擁 𱡍	
拦	攔	
拧	擰	
拨	撥	
择	擇 択	
括	栝 𢬸	
拭	𢂑 𢩮	
拮	𢮌	
拯	抍 𢮋 𡏈 撜 氶	
拱	拲	
拲	㭟 𢪒	
拳	搼 𢮙 㩲	
拴	揎	
拶	㭮 𥔨 𢹵 䆘	
拺	捒	
拼	摒 屛 屏 𱠐	
拽	𡲝 捙	
拿	挐 拏 㧱 𲢱	
挂	掛	
挃	𢰗 𥡫	
挅	挆	
挆	挅	
指	𢫾	
挈	𢭋	
挌	𢾏	
挐	拿 拏	
挑	㨄 𢬹	
挒	𢴴	
挙	举 舉 擧 𢸁	
挚	摯	
挛	攣	
挜	掗	
挝	撾	
挞	撻	
挟	挾	
挠	撓	
挡	擋	
挢	矫 撟	
挣	掙	
挤	擠	
挥	揮	
挦	撏	
挨	𢰇	
挩	捝 𲢅	
挪	𢰓	
挫	繲 𢚂 𢲖	
挬	𢰏 𲡽	
挭	鯁 骾 𢯬	
振	𤚿 𤚾	
挱	挲	
挲	挱 𢬰 𣴷 𢶌	
挷	搒	
挸	𢹕 𢺃 𲡞	
挹	𱣝	
挺	梃 𱭑	
挼	捼 𲡱	
挽	輓	
挾	挟 抸	
挿	插 揷	
捀	𢪋	
捂	𢫸	
捃	攈 㩈 𣟸 𢹲 攟 𱡑 𲢯	
捅	㪌	
捆	綑 祵 𢮖	
捇	𢷓 𲮀	
捊	㩠 𲣁 抙	
捋	寽 𱡋	
捌	八	
捍	扞 㪋 𤿧 仠 𱠄	
捏	揑 掜	
捓	揶	
捔	𧣀 矠	
捜	搜 蒐	
捝	挩 𲢅	
捞	撈	
损	損	
捡	撿	
换	換	
捣	搗 擣	
捥	𢺴 𢮘	
捦	擒	
捧	𢪋	
捨	舍 舎	
捩	挒	
捪	抿 㨉	
捫	扪 抆 㨺	
捬	拊 撫	
捭	𢬽 𢮆	
据	據 拠	
捲	巻 卷	
捴	总 總 緫 縂 総 摠 揔 搃	
捵	䥀	
捶	搥 箠 𢴹	
捷	㨗 𢱅 𢶝 㨩	
捻	㩶 捏 𱠑	
捼	挼 𲡱	
捽	𢪄 𢬪	
掀	搟	
掁	𰓄 㨃	
掂	敁	
掃	埽 扫 𢱥	
掄	抡	
掆	㧏 𢱫	
掇	敠	
授	𥠢 𱵝 𱶙	
掉	𢴿	
掌	𤓯	
掍	𣬑	
掏	搯	
掐	𠜼	
掑	𢮜	
排	棑	
掓	叔	
掔	孯 𢴡	
掕	𠡭	
掖	棭	
掗	挜	
掘	撅 𣔭 𢶵	
掙	挣	
掚	𪭵	
掛	挂 𱣧	
掝	㩇	
掞	𢴵 㨛	
掠	㨼 剠	
採	采 釆	
探	𢲘 撢	
掣	𢳅 𢮓 𢳐 𪘔	
掤	𢵁	
接	𪉚 𦁉 椄 擑	
推	𲉮	
掩	揜 𥦩	
措	𢵄 𲢈	
掬	匊 𥵱 𥸶 𥸭 揈	
掰	𢯌	
掲	揭	
掳	擄	
掴	摑	
掷	擲	
掸	撣	
掹	𲖃	
掺	摻	
掻	搔	
掼	摜	
掽	碰	
揀	拣 㨂	
揁	𱟸	
揃	𢸄 𢵏 㨵 𢶕	
揄	𤻍 𢶖	
揅	研 硎	
揆	𢲕	
揈	㧦	
揉	𦽩	
揊	𢾇	
揎	拴 㩊 𢱱 𱠨	
提	㮛	
揑	捏	
插	揷 扱 挿 𢰔	
揓	𢴨	
揔	总 總 緫 縂 総 摠 搃 捴	
揖	𢱼 撎	
揚	扬 𨱝 𢾙 敭 𠭲 𣈟	
換	换	
揜	掩	
揝	撍	
揞	𱠞	
揟	𢪵	
揠	𲢥	
揣	㪜 𢰚 𢭍 挅	
揦	攋 揧	
揧	𥻌	
揨	𢾊 𢿦	
揩	𢾆	
揪	揫	
揫	揪 𢱀	
揭	掲 担 拮 𢶆 𢷒	
揮	挥 𢰄 𢯷 𢱳 㫎 𨍂	
揯	搄 𢫮 𢳖 𢰨	
揲	𥰰 𢶅 𢮕	
援	楥 𱡟	
揶	捓	
揷	插 扱 挿	
揸	摣 楂	
揺	搖 摇	
揽	攬 𱡏 𱤬	
揾	搵	
揿	撳	
搀	攙	
搁	擱	
搂	摟	
搃	总 總 緫 縂 総 摠 揔 捴	
搄	揯	
搅	攪 撹	
搆	構 构 𢰎	
搇	撳	
搉	㩁	
搊	𫼝 𢫧 𢮢 𢬞 𢬆	
搋	扠 弌 𢲽 𢯯 扡 拸 𢮎	
損	损 扻	
搎	𢶛 𰓧	
搏	𢭍	
搒	挷 𢮔 㧍	
搓	𢷼	
搔	掻 𢭒 𢸪 𢮞 𢫼 𤔢 𲢴	
搖	揺 摇 㨱 摿 𢭊 𢳘 𢭌 𲢁	
搗	擣 捣 㨶 捯 𦦰 𢶈	
搙	掿	
搜	捜 蒐 𢯱 𢲷 𠮍 𢱻 𢅢 𲣂	
搞	攪 撹	
搡	𰓨	
搢	𢸰	
搣	𡟬 𢳒 𱟭	
搤	扼 㧖	
搥	捶 箠 𢱸 𢮒	
搦	𢾼 搻	
搧	煽 扇	
搨	搭 撘 㩉	
搪	傏	
搫	搬 㨇	
搬	搫	
搭	搨 撘	
搯	掏	
搰	𲢌	
搲	攨 𲬻	
搴	𢺦 𢷘 㩃 攓	
搵	揾	
搶	抢 摤 𢷇 𱝷	
搸	𢸩	
携	攜 𰓊	
摀	𰓆	
摁	恩	
摂	攝 摄	
摃	扛 𫼱	
摄	攝 摂	
摅	攄	
摆	擺 𲢋	
摇	搖 揺	
摈	擯	
摊	攤	
摋	𢫬	
摌	𫼪	
摍	𢳔 𢴀	
摎	𢷶 㧃	
摐	𪭢 𢰑 㧿	
摑	掴 爴 敋 𧤯 𤔩 𢹖 𢧷 𢮎	
摒	屛 屏 拼	
摕	梊 𰔇 𢰂	
摗	捒	
摘	𢸈 𢴨 擿	
摙	𫽁	
摚	𲣚	
摛	𲣆	
摜	掼	
摝	㩠 𢮑	
摞	𢴱	
摟	搂	
摠	总 總 緫 縂 総 揔 搃 捴 𢰾 𢵃 𢭇 𢷝 㧾	
摡	溉 漑 𢷽 𢪑	
摣	揸 𠭯 𢸉	
摥	𫼟	
摦	𢶎	
摨	搱	
摩	擵 𪎚 𥗘 𥗂 𢳀 攠 𢣾 𭙕 𲒞	
摪	𫽣	
摫	𢶄 𰓻 𳆨	
摭	拓 托 摕	
摮	𢳆 𢶗	
摯	挚 𢴷	
摰	𢴸	
摱	𢶔	
摲	㨻 𰓼	
摳	抠	
摴	摢	
摵	𢷾	
摶	抟 𦁆 𢰋 㩛 𢰁 𧽢 𢮨 𢮛	
摷	㩰	
摸	摹	
摹	摸 𢸆	
摺	折 𱟬	
摻	掺 撡	
摼	挳 𢴡 𰓱	
摽	𢿖 𠬪 𢶏 𢸂	
撂	㨼	
撃	擊 击	
撄	攖	
撅	掘 𢴺	
撆	撇	
撇	撆	
撈	捞	
撉	撴	
撊	𢵧 𪭾 𲡵	
撋	𰓷 㨎	
撌	𰔋	
撍	揝	
撏	挦	
撐	撑 樘 𣥺 𢴤 𲣈	
撑	撐	
撒	𢲳 𢴻 𰒼	
撓	挠 𢪼	
撕	𱠾	
撘	搭 搨	
撙	𰓢	
撚	𢲳	
撝	㧑	
撟	矯 挢 嬌 𢱪	
撢	𢺬 𢶁	
撣	掸	
撤	揊 𢪃	
撥	拨 𢯸	
撦	扯 偖	
撧	𪮖	
撫	拊 捬 抚 𨑑 𢸮 𢪑 𢻬 𢺌 𲅍 𲢲	
播	𨤏 譒 𢿥 𱫵 𱸸	
撮	𢲻 熶 𤑧	
撰	籑 𢰅	
撲	扑 擈 𢷏 𢪗	
撳	搇 揿	
撵	攆	
撶	𫼧	
撷	擷	
撸	擼	
撹	攪 搞 搅	
撺	攛	
撻	挞 𢽞 𢺂 𢹗 𩌉 𩋅 𢾴 𨘈 𲅮 𲊋	
撼	㨔 𰓭	
撽	擊 𢵿	
撾	挝	
撿	捡 𢺅	
擁	拥 㨣 𢺠 𢶜 𢹬 𢹭	
擂	攂 𢺢 𢹮	
擃	攮 搑 𫼮	
擄	虜 掳	
擅	𱡔 𱵴 𢩳	
擆	撯 𢷷	
擇	択 择 𢍰	
擈	𭠙	
擉	𧣫	
擊	撃 击 㨻 撽 𲄸	
擋	攩 挡 𫽮	
操	撡 𢿾 𢻥 𣚈	
擎	擏 𢍸 㢣 𮲒	
擐	𢸃	
擒	捦 扲 㩒	
擓	㧟 𢶘 㨤 𲢦	
擔	担 𧭃 𥣲	
擖	𢱴	
擗	劈	
擘	孹 擗 𢹐 𱑔	
據	拠 据 㨿 𢷛 㩀	
擜	㩵	
擞	擻	
擟	𪭧	
擠	挤 㨈 𡬚	
擡	抬	
擣	搗 捣 𢭏 㨶 捯 𦦰 𢶈	
擥	攬 㩜 㧛	
擦	𰓣	
擧	舉 举 挙 𢪓	
擩	㧫 㨎	
擪	𰓙 擫 㩎 擪 𢬍 掖	
擫	㩎 擪 𢬍	
擬	儗 拟 𱭖	
擯	摈 𢷤	
擰	拧 𱠶	
擱	搁	
擲	擿 掷	
擳	𰓜	
擴	拡 扩 㨯 挄	
擷	撷 㩪 𨘓	
擸	㧜 𢴫	
擺	摆 𢸇 𱠙 𲢋	
擻	擞	
擼	撸	
擽	㧰 攊 𱡌 𲡚 𢺇 𣀝	
擾	扰 𢺕	
擿	擲 𢱦	
攀	扳 㐴 𠔀 乑 𠬜 𢸅	
攄	摅 捈 𱡆	
攅	攢 攒	
攆	撵	
攇	搟	
攋	揦 𪮶	
攍	㨕	
攎	𢫘	
攏	拢	
攑	𫽥 𱠆	
攒	攢 攅	
攔	拦	
攕	㩥	
攖	撄	
攘	𢺖 𥀶 𣀮	
攙	搀	
攛	撺 𢺱	
攜	携 㩗 儶 擕 㩦 𢹂	
攝	摂 摄 挕	
攞	𫽋	
攢	攅 攒	
攣	挛 𠣈 𢍶 𲁱 𲁹	
攤	摊 𢺋 擹 𱠷	
攦	𰓬	
攧	𭣇	
攩	擋 𫽮	
攪	撹 搞 搅 㩭 捁	
攫	爴 𤔩 㸕 㩴 𤔗	
攬	擥 揽 㩜 𢱯 𢳢 𲢬	
攮	擃	
支	𠦙 𣏃 𢺶	
攲	欹 𢻪 敧	
攳	𰕁	
攴	攵 䇚 𢪊	
攵	攴	
收	収 㧃 敊 𠬧	
攷	考	
攸	𠈹 𣲏 𠆸 𢓘 㣠 𢻺 𠧴	
改	攺	
攺	𢻷	
敁	掂 𱴗	
敃	暋 忞 𢾞 𣇻	
敆	㪉	
敇	𢽟	
效	効 俲 傚	
敉	侎	
敋	𢼛 𢼽	
敌	敵	
敍	敘 叙	
敎	教	
敏	勄	
救	𣪋 𧘶 捄 㤹	
敓	敚 𭣳 𡜎 𢼠 𲣬	
敔	𢾵 𢻊	
敕	勅 勑 𢽟 㩽 𠡠 敇 𢽈	
敖	𢾍 𢾕	
敗	败 䢙 𣀕 贁 𤖐	
敘	敍 叙 𪠩 𣁏	
教	敎 𢼅 斅 𢻍 𤕝 𧧿 𲁯	
敚	敓	
敛	斂 歛	
敜	𣣈	
敠	敪	
敢	𠭖 𣆸 𢽤 𣪏 𢽿 𢼿	
散	㪚 𢻞 𢿨 𢻎 𢿷 𢻦 𱥙	
敦	惇 𠧈 𣀦 㪟 𢼪	
敧	𣀬 𢼨 𨜅	
敩	斅 斆 𲣮	
敪	敠	
敬	憼 𢾠 𣀖 𢿩	
敮	𢻗	
敯	𢾞	
数	數 𮲓	
敱	敳 𣪱	
敲	𣫁 毃 䯨 摮 㪣	
敳	敱 𮲔	
整	𠢦 𢿫 愸 𢿋 𢝗 𣦔 𰋞	
敵	敌 𢿪 𠢗 歒	
敶	𢽬	
敷	旉 尃 㩤 𢾾 𨊴 𢾭 𪯈	
數	数 𢿙 𣀭 𢿘	
敺	驅 駈 駆 𢿛 𰕅	
敻	夐 𡕷	
敽	敿 𰕈	
敿	敽 𰕈 𣪽	
斀	劅 𢻧	
斁	𤢕 殬 𭣧 歝	
斂	歛 敛 𲊩	
斃	毙	
斄	牦 氂 犛 髦 𠩬 𭤎	
斅	敩 斆 𢽾 𲣮	
斆	敩 斅 鏰 𲣮	
文	彣 攵	
斈	學	
斉	齊 亝 齐	
斋	齋 斎	
斌	彬 份 𮵨	
斍	覺 覚 覐 觉	
斎	齋 斋	
斐	奜	
斑	䃑 𤨘 辬 𳏥	
斒	𣁊	
斓	斕	
斔	螤	
斕	斓 𢒞 𣁣 𲣹	
斖	𣁫 亹	
斗	鬥 鬦 闘 𳈗 鬪 鬬 鬭 升 𣂑 㪷 𣁬 𤣫	
料	䉼 𥸾	
斚	斝	
斛	㪶 𧣈	
斜	衺 𲇅	
斝	斚 𠬂 䑝	
斞	庾 㔱 斔 𣂂 𲣾	
斟	㪸 𡈿 𨠇 㘰 酙 𣁱	
斡	𨋼 𠦷 𲄵	
斢	紏 𪏡	
斣	𣂌	
斤	觔 忻 釿	
斥	㡿 𠨺 𠩋 𤵍 𢇛 厈 𱚰 𱱏	
斧	𤕑	
斩	斬	
斪	𣃖	
斫	斱 𣛰 𣃑 𥖛 鐯	
斬	斩	
断	斷 𱡪 𱡮 𲅫	
斮	𣃀 𢧉 𢨈	
斯	𣂕	
新	𢀝 𨐏 𣂺	
斲	斵 㓸 𣃋 𣃂 𣃆 𣃃 𣂡 𣃏 𣂪 𨮕 𦘣	
斳	𣂼	
斵	斲	
斷	断 𣃔 𣂣 㫁 𣦙 𣂸 𣦕 𠜷 𣂢 𠸿 𣂱 𠝅	
斸	𣃁 劚	
方	𤙗 汸	
於	扵 于 亏 𤋬 𤕘 𣱏	
施	𩒂 𠇜 𢻩 𢼘 𢒃 𠆹 𣁒 𠤒	
斾	旆	
斿	𣽩	
旁	㝑 雱 𣃙 㫄 𣃪 𣃟	
旂	旗	
旃	旜 𣃼 㫋 𣃯 𱜻	
旄	𣭅 𣬵	
旅	挔 𣃨 𢰈 𣥐 𣥏	
旆	斾 𣃩 𲤆	
旈	旒	
旉	尃 敷	
旋	鏇 䄈 𢭀 𣒀 𱵑 𲀳 𭻾	
旌	袿 𣄀 𣃢 旍 𱡲 𱡶 𱵍 𱵞 𲀬 𮲙	
族	𥎩 𥎼 𥏁 𥎽 㞺 𱭻 𱵉 𱵌 𲀫	
旐	𣃿	
旒	旈 斿 𦀠 㐬	
旖	旑	
旗	旂 㫅	
旘	幟	
旚	𣄔 𣄦	
旛	幡	
旝	𰕭	
旞	𣄧 𣄚	
旟	𣄊 𭤰 𲤈	
无	無	
旡	㒫 𠘸 𨀶 𠑶	
既	旣	
旣	既	
日	𡆸 𡇗 𡈎 囸 𡇁 𡆠 𲘞	
旦	蛋 蜑 疍 且 𣅂 㫜	
旧	舊	
旨	𠩊 𤮻 㫑 𠮛 𣅌 𣅀 𡱔 𠤔	
早	𣅼 𢑖 𱢦	
旪	協 恊	
旬	𠣙 𠣡 𠣚	
旭	旯 旮 旴	
旮	旭	
旯	旭	
旰	𣆙 𣈨	
旱	晘	
旴	𤕐 晇	
时	旹 時	
旷	曠 昿 𱶾	
旸	暘	
旹	時 时	
旺	暀 𱡽 𮶑	
旻	旼 𣅐	
昂	昻 昴	
昃	昗 𣅳 𣅦 𣅛	
昆	𧲟 㒭 晜	
昇	升 陞 陹	
昈	𥄅	
昉	昞 昘	
昊	𣆧 昦	
昌	𣅊 𣆫	
明	朙 𣇱 眀	
昏	昬 𣉈 𣆾 𣄼 𣄾 𣋯 𱡾 𱢰 𱢲	
昒	㫚 𦙑 𣇤	
易	㑥 𡱿 昜 𠃓	
昔	𣊦 㫺	
昙	曇	
昚	眘 慎 愼	
昜	陽 氜 阳 𠃓 𣆄	
昝	偺 喒 𭨚	
星	㽮 𤾪 曐 𤽛 皨 垒 𤴇 𠻖 𤯢 𱗷 〇	
映	暎	
昢	𣅽	
昣	𣆋	
昤	㬡 𣌟	
春	萅 萶 𣆊 𣊨 旾 㫪 㫩 𦸬 𣈤 𱲧	
昦	昊	
昧	𣆜 昛 𱭏	
昪	忭 𣅹	
昬	昏	
昭	佋 炤 㫥	
是	昰 𣆞 𱲩	
昰	是	
昲	曊	
昴	㫹 𣇯 𣆻	
昵	暱 𣽚 眤 𣆓	
昶	暢 㫤	
昷	𥁕	
昺	昞	
昻	昂	
昼	晝 𱚹	
昽	曨	
显	顯 顕	
昿	曠 旷	
晁	朝 𪓲 𣆷 𪓨 鼂	
時	旹 𲝑 时 㫑 𣅱 𲤘	
晃	晄 熀 爌	
晄	晃	
晅	烜 暅 𣇥 𣈶 𣉖	
晉	晋 㬐 㬜 𡥨 𣌇	
晋	晉	
晏	曣	
晑	晌	
晒	曬 㬠 䵘	
晓	曉 暁	
晔	曄 曅	
晕	暈	
晖	暉	
晙	𣇚	
晚	晩 𣆛 𣆶	
晛	晲 𬀪	
晜	𣋥 罤 𥊽	
晝	昼 書 𦘘 𣅯	
晞	𥅹	
晟	晠	
晡	𣆵 𣇀	
晢	晰 晳 晣 㫼	
晤	𣅎 旿	
晥	皖 𣆿	
晧	皓 皝 顥	
晨	㫳 𠔹 曟	
晩	晚	
晬	𣅢	
普	暜	
景	暻 㬌	
晰	晢 晳 𣇮	
晲	𣅸	
晳	晰 晢	
晴	暒 夝 𰕺	
智	𥏼 𣉻 𤾞 𱳡 𱳤 𱷫 𲇘	
晻	暗 闇 隌	
暀	𣈧	
暁	曉 晓	
暂	暫	
暄	煊 𣇥	
暅	𣈶	
暆	𱿸	
暇	睱	
暈	晕	
暉	晖 睴	
暊	𮲟	
暋	忞 敃 㬆	
暍	㬞 㷎	
暎	映	
暐	𬀩 㬙	
暖	煖 燸 𤆱 𣆝 煗 㬉 𤏙	
暗	闇 晻 𣆛 𲤣	
暘	旸	
暟	𬀱	
暠	皜 𣉞	
暢	畅 昶 𤲘 畼 𲤼	
暣	𣅠	
暦	曆 厤 历	
暧	曖	
暨	曁 𠕨 𡍳 臮	
暫	暂 𣊙 蹔	
暬	𣊮	
暮	莫	
暱	昵	
暳	㬩	
暴	虣 𣋴 㬥 𣋳 㫧 曓 㿺 𣊴 㬧 𱹖 𣅃	
暸	瞭 了	
暻	晾	
暾	𣌘 旽	
曁	暨	
曃	𥊵 𣇨	
曄	晔 曅 𣋓 𣊚 𣋌 曗 𲥌 𲥍	
曅	曄 晔	
曆	暦 厤 历 歷 歴 𢍷	
曇	昙	
曈	晍	
曉	暁 晓 𣉊 𲤺	
曊	𪰶	
曏	向 𬁠	
曒	暞	
曖	瞹 暧	
曙	暏	
曚	𰰡	
曜	耀 燿 𪏌 𤒂 矅 𣇪	
曝	𣌈 㬍 𣋏 暴 𣅃	
曠	昿 旷 𣋷 𣊥 𱚈	
曡	疉 畳 疊 叠	
曣	𣋅 㬫	
曥	𣆐	
曦	爔 㬢 𣎮	
曨	昽	
曩	𱢒	
曬	晒	
曭	𭧋	
曮	𰖈	
曲	麯 麴 麹 𠚖 𡆪 𱍫	
曳	曵 𦥙	
更	㪅 𠭍	
曵	曳	
曶	𡆳 𡆷 𠯳 𡇆 㫚	
書	书 𦘠	
曹	曺 𣊛 𣍘 𣌼	
曺	曹	
曼	㬅 昘 𱻀	
曽	曾	
曾	曽	
替	暜 㬱 𤾕 𤽽 朁	
最	𣤜 𥦡 冣 𱷏 𱻂	
朁	㬱	
朂	勗 勖	
會	会 㞧 𠃐 㑹 𣥈 𣌭 㣛	
朄	𣍃 𣌾	
月	𡇹 𠥱	
有	𢇔 𠂇	
朌	頒 颁	
服	𣍞 𦨕 𦩟 𨈞 𦨋 𦨊 𦨈 𱼃 𲋻	
朏	𣍧 𣍺	
朐	胊 鴝 鸜	
朒	肭 𱼕	
朔	𣍧 𣍮 𲊝	
朕	𦩎 𦨶 𣍹 𢀹	
朖	朗 𱼋	
朗	朖 㫰 𣍷 𣊧 朤 誏	
朘	脧	
朙	明	
朚	𦟁	
望	朢 𥩿 𥪛 𦣠 盳 𣍢 𱮻 𱮼 𱯀 𱯁 𱷤 𲁣	
朝	晁 𦩻 𨊸 𣎍 𱼿 𱽀	
朞	期 稘	
期	朞 稘 𠔸 𣍣 𣍠 𣅆 𣇳 𡥝 㫷 𣍡 𱏪	
朡	𣍶	
朢	望 𦣠	
朣	𧬖	
朥	𦛨	
朦	蒙 懞 矇 䑃 𰰡	
朧	胧	
朩	等	
未	桒	
本	夲 㮺 𠦓 楍 𡴡 𡴩 𲘪	
札	剳 箚 劄 𤵦 𣧇	
朮	术 𦸇	
术	術	
朱	絑 硃	
朳	杷	
朴	樸 𣞞	
朵	朶 䒳 𣏻 𣎻 𣎿	
朶	朵	
朸	扐 朷	
机	機	
朻	𣎹 𱣯	
朽	㱙 𢩨 𣦿 𲥯	
朿	莿 𣐁	
杀	殺	
杂	雜 雑	
权	權 権	
杅	桙	
杆	桿	
杇	圬 𣑀 釫 𢫸	
杉	㰊 煔 檆 𱟫	
李	𣒶 䤚 𱙶	
材	扐	
村	邨 𨙲 𢩭	
杒	梕	
杓	𣏐	
杗	𱣣	
杘	𣒺 𣐉	
杚	𣏙	
杜	𥀁	
杝	柂	
束	𤙨 朿 捒	
杠	槓	
条	條 𱟁	
来	來 𱴄	
杧	芒	
杨	楊	
杩	榪	
杫	𣘩 㮐	
杬	㭇	
杯	盃 桮 㮎 柸 𠤯	
杰	傑	
東	东 柬	
杴	锨 㸝 𣞘	
杶	櫄 橁 杻 𣝙	
杷	朳 𣚒 欛 𱬷	
杸	殳	
杻	杽	
杼	𣏗 䇡	
杽	𨥋	
松	枩 枀 鬆 梥 庺 柗	
板	版 闆	
枀	枩 松	
极	極 㭲	
构	構 搆	
枅	𣓖 𱶁 𮲏	
枉	抂 𱛲	
枍	𣕆	
枎	𣞒	
枏	楠 柟	
析	扸 𣂔 㭊	
枑	𣏛 𣏳	
枓	𣏸	
枕	抌 𣏝 𲥳	
枖	𣓎	
枚	𣏽	
果	菓	
枝	𣏽 𱣀	
枞	樅	
枢	樞	
枣	棗	
枥	櫪	
枧	梘	
枨	棖	
枩	枀 松	
枪	槍	
枫	楓 𱣃	
枬	栴 楠	
枭	梟	
枯	𤖲	
枰	檘	
枱	儓 檯 耛 𨐠 鈶	
枲	葈 䢄 𦂅	
枴	拐 柺 𣐷 𣐶	
枵	𢪶	
架	榢	
枷	拁	
枸	𣕉	
枹	𣑿	
枻	栧	
枼	枽	
枾	柿 柹	
柁	舵	
柂	杝	
柃	㯪	
柄	棅 抦	
柅	𣐓	
柆	拉	
柇	𤖱	
柌	枱 鈶	
柍	楧	
柎	枎 𣏘 𣘧	
柏	栢	
某	厶	
柒	漆 七 桼	
染	𣑱	
柔	𱳛	
柘	𥦼 䂞	
柙	㘡 𣘭 𧆥	
柚	櫾	
柜	櫃	
柝	𤗙 𣔳 𣟄 𣝔 𣐼	
柟	枏	
柠	檸	
柢	㭽	
查	査 楂 槎	
柩	柾 𠥂 匶 𠥬 𣡛 匛	
柫	柭	
柬	𱯐 𫠣	
柮	𱿨	
柰	奈 㮏	
柲	㧙	
柳	桺 栁 桞 橮 檉 𣓠 枊	
柴	茈 𡍥 𱵕	
柵	栅 𥬰 𣑭	
柷	拀	
柹	枾 柿 𣐈	
柺	拐 枴 𣐷 𣐶	
査	查 楂 槎	
柽	檉	
柾	柩	
柿	枾 柹 𣐈	
栀	梔	
栁	柳 桺 桞 橮	
栄	榮 荣	
栅	柵	
标	檁 標	
栈	棧 桟	
栉	櫛	
栊	櫳	
栋	棟	
栌	櫨	
栎	櫟	
栏	欄 𱤚	
树	樹 𱣾	
栒	簨 𣕍	
栔	𣓇	
栖	棲	
栗	慄 𣡷 㮚 𡨓 𣗴 𣓨 𣡼	
栚	𣔷 㮳 𣒁	
栛	荔 茘	
栜	梀	
栝	檜 桧 桰 𣕊 㮇 𣐸	
栟	𱣫	
栠	栣	
校	挍 𤲽 𲇩	
栢	柏	
栭	𣚊	
栯	㮋 𲥸	
栰	筏	
栲	𣛖 𣐊 𣑥	
栴	枬 𣑪 㮵 𱣔	
栵	𣖊	
样	樣 様	
核	覈 𣝗	
根	𣒨 拫 𣏅	
格	㦴 𠲱 挌	
栽	𣔮 𦳦 𥯒 𣒭 㘽	
栾	欒 灤 𲆤	
桀	㘶 𱣎	
桁	航	
桃	𱣛	
桅	𥍨	
案	𱭛	
桊	棬 𣗷 𢍕	
桌	槕 棹	
桐	𣑸	
桑	桒 枽 𣕐 𦶫 𠭨 槡 𠭌 𮲱 𰗑	
桒	桑	
桓	亘 𣒯	
桔	𣚃	
桜	櫻 樱	
桞	柳 桺 栁 橮	
桟	棧 栈	
桠	椏	
桡	橈	
桢	楨	
档	檔	
桤	榿	
桥	橋 𱴦	
桦	樺	
桧	檜 栝	
桨	槳	
桩	樁	
桪	樳	
桫	𣘡 桬 𱤇	
桭	栕	
桮	盃 杯 𠥀 𠤯 𦈧 𦈶	
桯	𲧧	
桱	𣐕	
桵	㮃	
桹	樃	
桺	柳 栁 桞 橮	
桼	漆 柒 㯃 𢒡 𲼨	
桿	杆	
梁	樑 𣹷 𱥻 𱧂	
梃	挺	
梄	楢 槱	
梅	楳 𣒫 𣏁 槑 呆 坆	
梎	𲦊	
梐	㯇	
梓	杍 榟	
梔	栀	
梖	𪱷	
梗	𣖀	
梘	枧	
梜	𬂩	
條	条 糶 樤 𣒼	
梟	鴞 枭 鴵 𩾣 𩾓 䲷 𣝨 𩾒 𩿋 𱶉	
梡	㯘	
梢	䈰 䈾	
梣	橬 𣘕	
梦	夢 𱘬	
梨	棃 㰀 梸	
梫	𣖽	
梭	𥭟 𣜤	
械	㭜	
梱	閫 棞	
梲	棳 棁	
梳	𤴜 𣐌 㧧 𣙳 𣓜	
梵	𪎒	
梹	檳 槟	
梺	麓	
梼	檮	
梾	棶	
梿	槤	
检	檢 検	
棁	梲	
棂	欞	
棃	梨	
棄	弃 𢍞 𠬇 弆 𨓋 甭 𣓪 𠔚 𠆉	
棅	柄	
棆	𰗖	
棇	𣚜 楤 樬	
棉	㮌 檰 𣏜	
棊	棋 碁	
棋	棊 碁 㯦 檱 櫀	
棎	𣔻	
棐	榧 𩇹	
棑	篺 榧	
棒	㭋	
棓	𣘙 㯁	
棕	椶 㯶 𣞛	
棖	枨	
棗	枣 𣕿 𠂲 𠄬	
棘	艻 𣡍 𣘐 㯤	
棛	𣚥	
棟	栋 𤗗 㨂	
棠	㭻	
棡	㭎	
棥	樊	
棧	桟 栈 椾 碊 㮍	
棨	𢧊 𮵺	
棬	𥁸 𥁠 椦	
森	𱤏	
棯	菍	
棰	槌	
棱	稜 楞	
棲	栖 捿	
棳	梲	
棵	𤖇	
棶	梾 𫼲	
棹	櫂 桌 䑲 𱽄	
棺	𣑄 栕	
棻	㯣 𦯲 梤 𦯳	
椀	盌 碗	
椁	槨 𲦹	
椃	𣘫	
椅	𱤄 𣎷	
椊	㯜	
植	㯰 𲢪 𰗝	
椎	槌 㮅 桘	
椏	桠 亞	
椑	𣔬 𣝁	
椒	茭 𣓙 茮 𣒏 𣐹 𱶘 𲥷 𲼵	
椓	𨧧 㭬	
椘	楚	
椚	𭩛	
検	檢 检	
椝	槼	
椟	櫝	
椠	槧	
椢	槶	
椤	欏	
椫	樿	
椭	橢 楕	
椮	槮	
椯	𣖃	
椰	㭨	
椱	𣘅	
椲	㭏	
椴	椵	
椶	棕	
椷	㮭	
椸	㮛 箷 𤕮 𤕴 𤖌	
椹	葚 枮 碪 砧 鍖	
椽	㯌	
楂	槎 查 査 揸	
楇	𣒌	
楊	杨	
楎	𰗢 椲	
楓	枫	
楕	橢 椭	
楘	𨍎 𣖶 鞪 𨎸	
楙	茂 柕 棥	
楚	椘 䠂 𣕑 𤻇 𣗂	
楝	棟 𲥲	
楞	棱 稜	
楠	枏 𣔎 柟 枬 𲳭	
楡	榆	
楢	梄 槱	
楣	𮲉 𠃜	
楥	楦	
楦	楥	
楨	桢	
楪	牃	
楫	檝 艥	
楬	𥴭 𱤟	
業	业 𤑽 菐 𤗥 𢄁 㸣 𤎸 𱵬 𱾁	
楮	柠	
楳	梅	
極	极 𱣵 𱫰	
楶	㮞	
楷	揩 𣒉	
楸	揪	
楹	㨕 𣟅 桯	
楼	樓	
楽	樂 乐	
概	槪 槩 㮣 杚	
榄	欖	
榅	榲	
榆	楡	
榇	櫬	
榈	櫚	
榉	櫸	
榌	𱢿	
榍	𣕋	
榎	檟	
榐	𣒅	
榓	櫁 樒	
榕	枀	
榖	𣖫	
榘	矩	
榙	㯚 𣚞	
榛	亲 𦿒 樼 𦽥 蓁 㰉 𣝾 𣐽 𣓀 𱾹	
榜	㮄 搒 牓 𲂱	
榝	𬂮 樧	
榢	架	
榦	幹 干 乾 𣘒	
榧	棐	
榨	醡	
榪	杩	
榫	㔼	
榬	𥰟	
榭	𣛘	
榮	栄 荣 禜	
榯	𰗨	
榱	𲦪	
榲	榅	
榳	㨩	
榴	橊 𰗶	
榺	𣚗	
榻	㯓	
榼	𥃕 醘 𣖁	
榽	𣕆	
榿	桤	
槀	稿 稾	
槁	槀 藁	
槇	槙	
槊	鎙 𣓞 㮶 𣔒 矟	
構	搆 构	
槌	棰 椎 桘	
槍	枪 鎗 𥎄	
槎	楂 查 査 𣞚	
槑	梅	
槓	杠 篢 𱣚	
槔	𣓌 槹 橰	
槖	橐 𲁃	
様	樣 样	
槙	槇	
槚	檟	
槛	檻	
槜	檇	
槟	檳 梹	
槠	櫧	
槤	梿	
槥	櫘 檅 橞	
槧	椠 𲧓	
槨	椁 𥕖 𣠐 𲦹	
槩	概 槪 㮣	
槪	概 槩 㮣	
槫	𣏢	
槭	㰗	
槮	椮 𣟹 𣚈	
槱	梄 楢 𥙫 𤍕 禉 𣜃	
槲	𣘳	
槳	桨 𥷃 䒂 㯍 𱸮 𱽁	
槵	梙	
槶	椢	
槸	𣞕	
槹	𣓌	
槻	規 规 𡦑 𬃀	
槼	椝	
槽	𣡘 㯾	
樀	㰅 𣚌	
樁	桩	
樂	楽 乐 㦡 𨊊	
樅	枞	
樊	棥 𤕩 𮰶	
樌	𱣱	
樐	櫓 艪 艣 橹 㯭	
樑	梁	
樓	楼 𡳫 𩫰 𲌘	
樕	㯈	
樗	㯉 𣛲	
樘	橕	
標	标 𣠙 㯹 摽	
樚	轆	
樛	𣚉	
樜	𣙃	
樝	柤 𣙁 𣕈	
樞	枢 摳	
樟	𲥣	
樠	𣗊	
模	橅 摸 𡆶 𡘲 𤏠 𱳥	
樢	㭤	
樣	様 样	
樤	𱟁 𣔌	
樧	榝 𣛶	
権	權 权	
横	橫	
樫	㭴	
樯	檣	
樱	櫻 桜	
樲	𬃘	
樳	桪	
樴	𮶚	
樵	𧄡 爑 𣟶 𦿕 藮	
樷	叢	
樸	朴 檏 擈	
樹	树 𠊪 𢒳 𡬾 𣗳 𲦧 𣚤 𣕒	
樺	桦 檴 㯉 樗	
樻	櫃 𣟨 匱 𭫀	
樽	墫 罇 𤮐	
樾	𣜀 𣙾	
樿	椫	
橀	𣕆	
橁	槆	
橃	栰 𦪑 𭩰	
橅	𬂠	
橆	無 𣞤	
橇	鞒 鞽 䢪 𩌚	
橈	桡 𦪛	
橊	榴	
橋	桥 墧 槗	
橐	槖 𢅍 𢄿 𡇈	
橑	𣟆 𲑾	
橓	蕣 𲧎	
橗	𲢩	
橚	𰗹	
橛	橜 𦪘 𣖬 𣐍	
橜	橛	
橝	𣡣	
橞	櫘	
機	机	
橠	㰙	
橡	樣 様	
橢	楕 椭 㯐 㰐	
橤	𦁞 𣛚	
橥	櫫	
橦	幢	
橧	𧲅	
橨	𰗺 䒈	
橩	𣜧 焭 𢶇	
橪	㮒	
橫	横	
橭	𣖥	
橮	柳 桺 栁 桞	
橯	耮 𥢒 𣓿	
橱	櫥 櫉	
橹	櫓 樐	
橺	𱣤	
橼	櫞	
橿	𱤳	
檀	枟	
檁	标 檩	
檂	𬂰	
檃	𨽌 檼 櫽	
檄	𣜥	
檇	槜 㰎	
檈	𣞲	
檉	柽 柳	
檋	梮 𣔑 𣡴 𰘈	
檍	𣚍 𣟻	
檏	𱣇	
檐	簷 𣡞 𤖝 厃 櫩	
檒	𮨴 𱣨	
檓	𲧁	
檔	欓 档	
檖	𣔾	
檗	檘	
檘	蘗 蘖 櫱	
檛	簻 𥬲 𭪆	
檜	栝 桧	
檝	楫 艥	
檞	𣟲	
檟	榎 槚	
檠	𢐧 㯳 擏 𲦲	
檡	𰗛	
檢	検 检	
檣	艢 樯 𤕽 𣚛	
檤	𣜦	
檥	艤 𭩚 㩘	
檦	㯹	
檩	檁	
檬	𰰡	
檭	𣘴	
檮	梼 𣝷 𤘀 𣚑	
檯	枱 儓 台	
檰	𰘣 㰃	
檲	𣑝	
檳	梹 槟 㯽	
檴	穫	
檵	𪲛	
檷	鈮 𣐐 鑈 𪱾	
檸	柠	
檹	𣚂 𲦴	
檺	𱜸	
檻	槛	
檼	櫽	
檽	𣚐	
檾	䔛 𰘓 𤍔 𣘑 苘	
檿	𰗜	
櫂	棹 䑲	
櫃	樻 鐀 柜 饋 匱	
櫅	𪲎	
櫈	凳	
櫉	櫥 橱	
櫊	𲦖	
櫋	𣝼 𲧘	
櫌	耰	
櫍	𬃊	
櫎	𰗓	
櫏	𣘝 𰗬 杄	
櫑	鑘	
櫓	樐 艪 艣 橹 艫 舮 舻 㯭	
櫔	𮲬	
櫚	榈	
櫛	栉 楖 扻	
櫝	匵 椟 樚	
櫞	橼	
櫟	栎 㰛 檪	
櫠	𪲮	
櫡	𣃈 𨮿 鐯	
櫢	𰘸	
櫥	櫉 橱	
櫦	𮲲	
櫧	槠 䡤	
櫨	栌 籚 𱤞	
櫩	𰘠	
櫪	枥 𣙽	
櫫	橥 𲧇	
櫬	榇	
櫯	𰘶	
櫱	蘖 檘 蘗 𣠌 㮆 枿 𣎴 𣕀 𢮡 𣡌 𣖂 𣔏	
櫲	𣛿	
櫳	栊 㰍	
櫴	𰘳	
櫶	𬃫	
櫸	榉	
櫹	𰘩	
櫺	欞 㯪 𢸲	
櫻	桜 樱	
櫽	檼 𬄩	
櫾	柚 𣟾 𣠡	
欂	𦼭 榑 𣝍	
欃	𣝊 㸥 𣗸	
欄	栏 𣟬 𱤚	
欆	𢅻 𮲮	
欇	𣠞 𪳍	
欉	𱣉	
權	権 权 杈 㩲 𱵩	
欍	𣐤	
欏	椤	
欐	𪲔	
欑	𪴙 櫕	
欒	灤 栾 滦 𲆤	
欓	檔 𣗋 𥸈	
欖	榄 㰖	
欗	𱤂	
欘	𣚚 斸	
欙	樏	
欚	𦫈	
欜	𣡪	
欝	鬱 鬰 郁	
欞	櫺 棂	
欠	𣣓 㐸	
次	𠕞 𣬌 㳄	
欢	歡 歓 懽 𱿀	
欣	忻 俽 惞 訢 𱟀	
欤	歟	
欥	𲧫	
欧	歐	
欬	咳 𤸺	
欱	𣣹 喝	
欲	慾 𡟔	
欳	㕟	
欵	款	
欶	𠲿	
欷	唏 㰿 𣣐	
欸	唉 誒 𣤃	
欹	猗 㿲 𣀬 𥀴 𤿡	
欻	㗵 歘	
欼	歠 啜 㱀 𣣯	
欽	钦 𣣽 𱻑 𲇆 𲇉	
款	欵 𣢻 𣤂 㱁 𣣙 歀	
欿	𣣻 𣢌 𣤉	
歂	𣤀	
歃	㰱 𦦕 𣣨 𲻌	
歄	𬅥	
歈	𣤏	
歊	歒 𣤙	
歋	𣣢	
歌	謌 𣤒 𣤑 𡃭 𲁶	
歍	𰙋	
歎	嘆 𣥁 歏	
歐	欧 𣢨 嘔	
歑	𣣕 𣣍	
歓	歡 懽 欢	
歔	𣤼	
歕	呠 噴 𬅫	
歗	嘯 嘨 𰙑	
歙	㒆 噏	
歛	斂 敛 𰙎	
歜	𧃏 𣥀	
歞	𪴯	
歟	𲧭 欤	
歠	啜 欼 𠽶 哾 𣤌 吷	
歡	歓 懽 欢 𧆒 孉 𲉬 𲹂	
止	𱟞 𱭍	
正	𣥔 㱏 𠙺 疋 𧗪 𧾸 𤴓	
此	𣥖 𣥅 𡰯	
步	歩 𣥕 歨 𱛪	
武	𢎁	
歧	岐 𣥖 𢺵 𱥀	
歩	步	
歯	齒 齿	
歱	踵	
歲	岁 亗 歳 嵗 㒸 𢧍 𡻕 𢧁	
歳	岁 亗 歲 嵗	
歴	歷 厤 历 厯 曆	
歵	𧶷	
歷	歴 厤 历 厯 𡻤 𢊆 𡿌 曆	
歸	帰 皈 归 𢅦 𢅨 𡚖 𤾤 㱕 𣦨 䢜 𱜹 𱝺 𲉒 𲉕 𲉖 𲉙 𲉚 𲉡 𳇡	
歹	歺 𡰮 𡰤 䚟 𠧔 𣦶	
歺	餐 湌 歹	
死	𠑾 𦭀 𤯽 𣧇 𣥴 𦫺 𣦸 𣦹 𠒁 𱎠	
歼	殲 殱	
歾	歿 殁 圽	
歿	殁 𣧒 𣨨 圽 歾 𣨏 𪠲	
殀	夭 𣧕 𣨘	
殁	歿	
殂	𣨖 𠹨 𣨐 𡲂 𣩋 𣧫 𱥒	
殃	䄃 𥙏	
殄	𣧢 𣧠 𠂈 𣦺 𱥃	
殇	殤	
殉	侚 狥 𣧬	
殊	𡥛	
残	殘	
殍	𣨈 𦖀 𦭼 𦹡 𣧶 𲧺	
殒	陨 殞 隕	
殓	殮	
殖	𰙽	
殗	𣩯	
殘	残 𠡹 𠡡 𣧌	
殙	𩔉 㱪 𣧟 𣨯 𣧾	
殚	殫	
殜	𣩫 𣩣 𣨚 𣩨	
殞	隕 殒 䆬	
殠	𣧁	
殡	殯	
殢	𣧂 𣨼	
殣	𣩲	
殤	殇	
殨	㱮	
殪	𣩉 𣨑	
殫	殚	
殬	𣧃	
殮	殓 㱨 𲁈	
殯	殡 𡒨	
殰	𦢌 㱩	
殱	殲 歼	
殲	殱 歼 𣨦	
殳	杸 𢎦	
殴	毆	
段	叚 𠩻 𠖊	
殷	𱜾	
殹	𥏏	
殺	杀 𢼢 𢽆 𣏂 𢾈 𢿔 煞 𠮁 𢼯 𣀎 𣪆 𢁛 𧤿 𢽺 𢿹 𢽮 𣪖 𢽯 𢼡 閷 𢽘 𢽅 𣪩 𤔮 𱬆	
殻	殼 壳 㱿	
殼	殻 壳 㱿 𣪗 𥀎 𣪎	
殽	淆 𲨂	
殿	𣪍 𡱒	
毀	毁 𢾌 䃣 𣪷 䛼 𡒂	
毁	毀	
毂	轂	
毄	軗 𠿉 𣪠 𬆦	
毅	𣪣 䝘 𣫚 𣫖 𱭽	
毆	殴 𣪅 𢿛 敺	
毇	𥼹 𥸋 𥵓 𥸃 𥶵	
毈	㱭	
毊	𪵑	
毎	每	
每	毎 𡴋 𣫭 𡴕	
毑	𣫰	
毒	𦸕 𧉉 𠟽 𡴛 𥲮 𡹆	
毓	育 𲬩 艈 𣼿 𭯉 𮌫	
比	𣬅 芘 夶	
毕	畢 𱰰	
毗	毘 𣬖 𤰨 𣬉 𣬈 𱰧 𱰬	
毘	毗	
毙	斃	
毞	𣭁	
毠	𣮫 𣭠 𣮱	
毡	氈	
毣	𣭜	
毦	𣭞	
毧	㲓 𣮪 㲨	
毨	𣭟 𨾷 𣭡	
毫	乚 𡨉	
毬	球 皳 𣭳	
毯	㲜 㲭	
毰	𣯱	
毱	𣮓 𣮴 𣮕 𣯲 毩 𲭠	
毳	𣯝 𲁄	
毵	毿 𱻣	
毶	𣯶	
毸	𣯯 𣯧	
毹	𣰎 𣭴 𣰟 毺	
毻	毤 𣮲 𲨓	
毼	𣭸 𣯇	
毾	𣯈 𣯾 𧝅	
毿	毵 𣯺	
氀	㲎 𣰢 𣯫 𰚦	
氂	牦 犛 斄 髦 𣯛 𣮋 𣭭 𣯕 𣯷 㲠 𱤉	
氄	𣯍 𧝢 𣭲 𥎜 𣰲 㲝	
氅	鷩 𪅶 𳐒 𣰉	
氆	𣯽	
氇	氌	
氈	毡 氊 𣰔 𣭣 𩎄 𩯤	
氊	氈	
氌	氇 𣱀	
氍	𣯑 㲘 𣰻 𣯸 𣯒 𣭂 𣰋 𣰠 𱰔	
氏	𨸝 𠂩 𱬵	
氐	互 𢎶	
民	𠘽 艮 𡻾 𱥨	
氓	甿 𦫋 𣱅 䇇 𤱕 𱥩 𱽈	
气	氣 気	
氖	𲨙 𲨮	
気	氣 炁 气	
氙	氥 𲨛	
氛	𣱦 𱲕 𱲗	
氜	陽 昜 阳	
氟	𲨣 𲪧 𳀦	
氡	氭 𲨧	
氢	氫	
氣	気 炁 气 𣅠 㫓 𤽍 𣱖 𣱛 𱵊 𱸳 𱸿 𱹂 𱹈	
氤	絪 𩂥 𣱜 𣱙	
氥	氙	
氦	𲨜	
氧	𲨝 𲨭 𳀧	
氨	𲺶	
氩	氬	
氪	𲨨 𲨫	
氫	氢 𣱮 𲨘 𳀙	
氬	氩 𲨕 𲨖 𲨢 𲨤	
氭	氡 𣱝	
氮	㲷 𲨡 𳀥	
氯	綠 㲶 𲨬 𳀤	
氲	氳 𱲖	
氳	氲 𱲙 𱲝	
水	氵 𣸕 𡿭	
氵	水	
氷	冰 冫	
永	𣱵 𠘷 𱍐	
氹	𱎄	
氼	溺	
氾	泛 𣲆 㲹 汜	
氿	㲹 𣲄	
汀	𠀩 𢆊	
求	𡨃 𱥮	
汇	彙 彚 滙 匯 𲅴 𲆆	
汉	漢	
汊	㲼 𮳃	
汍	汎	
汎	泛 㲹	
汏	𡊌 𣴒	
汐	𣴁 𣲠 𲒋	
汒	𣴭	
汔	𣲁	
汗	𡊺	
汙	污 汚 洿 𣴰 䵦	
汚	污 汙 洿	
汜	𣲆	
汞	澒 銾 𲐳 𲳞	
江	𱥿	
池	𲋷	
污	汚 汙 洿 𣽏 𣱴	
汤	湯	
汦	𣹡	
汨	淿 㵋 漞	
汪	𣳫	
汯	浤	
汰	𡊀 𡊌 汱 汏 溙 𱦌	
汱	𣴒	
汳	汴	
汶	渂 𣶌	
汷	㳊 泈	
汹	洶	
決	决 𣲺	
汽	汔	
汾	𥦋	
汿	沀	
沃	𦮮 㓇 𱦗	
沇	兖 渷	
沈	沉 瀋 𣲽	
沉	沈 𣲽	
沌	𣲃	
沍	冱 𣲑 𣲐	
沒	没 𣳚 𣇶 𦐲 𣴬 𱦠	
沓	㳫	
沔	汅 𣱴 𲨹	
沖	冲	
沙	砂 𣲡 𡋷 𣲓	
沛	㳈 𨙶 𱝭	
沜	溿	
沟	溝	
没	沒 𱦍 𱦞	
沢	澤 泽	
沣	灃	
沤	漚	
沥	瀝 𱦉	
沦	淪	
沧	滄 𱖏	
沨	渢 𱥹	
沩	溈 潙	
沪	滬 冱	
沫	沬	
沬	𩔁 靧 頮 𩒌 𩉖 𧗏	
沭	𣻚	
沰	𣶦	
沱	沲 𣵺 𣵻 𣴾 𱦬	
沲	沱	
河	𢀎	
沴	𣳅 沵	
沵	濔	
沶	沵	
沸	㵒 𣲴	
治	𣳮 冶 𡭒	
沼	𣳮	
沿	㳂	
況	湟 况	
泂	𠖷	
泃	沟	
泄	洩 渫 𣲟 𣳘	
泅	湭 汓	
泆	浂	
泉	洤 𣹻 𡺙 湶 灥 㟫 𱦸	
泊	泺 濼 𣶊 淿 洦 湐	
泐	氻 𣲒 𳈝 𪵶	
泒	沠	
泓	𣴦	
泔	粓	
法	㳒 灋 𢌇 𳐱 𣳴 佱 𢌇 𣳬 𱝎 𱝐 𱩬 𱩮 𱪄 𱪉	
泖	茅	
泙	洴	
泚	𣸆	
泛	汎 氾 𣳋 滼	
泝	溯 遡 𣳙 𣹫 𣴔	
泞	濘	
泡	𣶐 𱧖 𱧷	
波	𣴫 𲓚 𲩉	
泣	𣲔	
泥	坭 埿 𡌰 𥩥 𡊴 𢇀 𱧩 𱺙	
泦	淗	
泧	㳚	
注	註	
泪	淚 涙 𱦾	
泭	𣻜	
泮	冸 𣳝	
泯	冺 汦	
泰	冭 𡙌 夳	
泲	泍	
泶	澩	
泷	瀧	
泸	瀘	
泺	泊 濼	
泻	瀉	
泼	潑 溌	
泽	澤 沢 𱨑 𱨲 𱩎	
泾	涇	
洁	潔 𱩇	
洄	𭰁 𲩶 𭱫	
洇	潱	
洋	𡊺 𣴱 𱻉	
洌	冽 𣶄 𣸟 𲒕	
洍	泤 𱗧	
洒	灑 𣳳 𣹍	
洓	𣽤	
洔	𣻞	
洕	𣷩	
洗	𣳳 冼 洒 𮲫	
洚	洪	
洛	𠗂 洜	
洞	峒 㓊 峝	
洟	涕 䶏 𪖦 𦳂	
洤	泉	
津	𦩦 𦨱 𦪉 𦩨 𦩏 𣸁 𱧃 𱩀	
洩	渫 泄	
洪	洚 潂 㓋 𤀆 𱦻 𱧙	
洫	𠗅	
洭	𣶕 㳝	
洮	𣴧	
洳	𣹤	
洴	泙	
洵	汮	
洶	汹 𣶑	
洸	𣴕	
洹	𣵨 𣷻	
活	𣽅 𣿛 㓉 𣸅 𣴠 𤾾	
洼	窪 𣵾 𲙯	
洽	䨐 冾	
派	沠 𣳛 𠂢 𠨹 𱝯 𱦩	
洿	污 汚 汙	
流	𡵰 𣴑 𣻤 𣹳 𣳛 𣹭 汖	
浃	浹	
浄	净 淨 凈	
浅	淺	
浆	漿	
浇	澆	
浈	湞	
浉	溮	
浊	濁	
测	測	
浍	澮	
济	濟 済 𱦚 𱨥 𱪏	
浏	瀏 嚠	
浐	滻	
浑	渾	
浒	滸	
浓	濃	
浔	潯 𱳾	
浕	濜	
浙	淛	
浚	濬 𱦘	
浛	澏 𠥴 𣻦	
浛	𲒑	
浜	濱 濵 滨	
浞	𲒐	
浣	澣 𤃬 𣴟	
浧	𣹽	
浩	澔 㬶 𤅆	
浮	酻 泘 𱦒 𱦓	
浴	𣴲 𱦣	
浵	𣹊	
浸	𣽧 濅 寖 㴆 𣹦 𣷽 𥧲 𣼡 𡩻 𣺎 𱦯 𱧪 𪫆 𳐘	
浹	浃	
浼	潣 凂	
浽	滖 涹 𩃃	
浾	𣵩 泟	
浿	𬇙 𱦵 𲪢	
涂	塗 凃	
涅	湼 㘿	
涆	𣆙 𣵼	
涇	泾 洷	
消	㴅	
涉	渉 㴇 𣥿 𣥩 𣶵 𣻣	
涊	㲽	
涌	湧	
涎	㳄 𠿢 𣶙 𣶚 𣶜 𣶛 𣳧 𣵤 𣹺 㵪 㳭 𣵿 𱧆 𱨀	
涓	㳙	
涔	汵	
涕	洟 䶏	
涖	莅 蒞	
涗	涚	
涘	洠	
涙	淚 泪	
涚	涗	
涛	濤	
涜	瀆 渎	
涝	澇	
涞	淶	
涟	漣	
涠	潿	
涡	渦	
涢	溳	
涣	渙 𱨖	
涤	滌	
润	潤	
涧	澗	
涨	漲	
涩	澀 澁 渋 濇 瀒 𱧨 𱧬	
涪	𣷧	
涫	㴦	
涬	𣸖 𣷟	
涯	厓 漄	
液	洂 𱦪	
涴	𣹠	
涵	𣹢 𱑋 𱨊 𱨢	
涶	唾	
涷	𰛒	
涸	凅 𤃯 沍	
涺	𣲻 𣶅	
涻	𲒒	
涼	凉 鿌 𠒨	
涿	𣽗 𣄻	
淀	澱 𣵦	
淄	甾 湽 𣻲 𱧹 𱩑	
淅	𥺚 𣶁	
淆	殽 𲨂	
淇	𱥳	
淈	𣿲 𣽶	
淋	𩱬	
淌	𱨬	
淑	㳤 𣻪 𱦹 𱧸	
淒	凄 𱨌	
淓	汸	
淚	涙 泪 㴃	
淛	𣹨	
淜	漰 𣳷	
淠	𣴪	
淡	澹	
淢	㳼 𣴤	
淤	𡌧	
淥	渌 𲼮	
淦	汵 𠥴	
淨	凈 净 浄 𩓞 瀞 㵾 汬	
淪	沦	
淫	婬 𣽮 滛	
淬	㳃	
淮	准	
淰	𣻧	
深	㴱 𱦴 𱧐 𱧑 𱧡 𲪑 罙 冞	
淳	湻 𤂸 𠩭 𣹾 𱨛 𱩚	
淵	渕 𲒓 渊 渆 𣾬 渁 𣴺 㴊 灁 𡇋 𡆼 𤀵 囦 㶜 𠝃 𲒴 𣴸 𣶒 𱦎 𱦤 𱦺 𱧗 𱩐	
淶	涞	
混	𣽙	
淸	清	
淹	渰 𱨜	
淺	浅 𣻝 𤄻	
添	沗 㬲	
淼	𣳭	
清	淸 㵙 𨓽 𠗜 凊 𰛓	
渇	渴	
済	濟 济	
渉	涉	
渊	淵 渕 𱦟 𱦥 𱩞 𱭘	
渋	澀 澁 濇 瀒 涩	
渌	淥	
渍	漬 𱨄 𲆲	
渎	瀆 涜	
渐	漸	
渑	澠	
渓	溪 谿 嵠	
渔	漁	
渕	淵 渊 𲒓	
渖	瀋	
渗	滲	
渙	涣	
渚	陼 𱚩	
減	减	
渜	湪	
渠	𲓥 𣑞	
渡	𣳥 𱧣 𱨝	
渢	沨	
渤	郣 㴾 𱦿 𱧉	
渦	涡 涹	
渨	隈	
温	溫	
渫	洩 泄 㻡 㳿	
測	测 𤂄	
渭	𱨒 𱩒	
渮	菏	
港	𣿑 𣽣 𱧏 𱧺	
渰	淹 𩃗	
渴	渇 㵣 𣊆	
游	遊 逰 𠾈 𨒰 㳺 𨓎 𱦂 𱨈	
渹	訇 𢕐 𥔀	
渺	𣺌 𡙎	
渻	𨜜 𣹴	
渽	溨 𣴮	
渾	浑 𣹫	
湀	𣺍	
湄	𤃰 𣾨 𤃱 𣽪 㵟 𠃜	
湅	涷	
湇	湆	
湈	𣨴	
湊	凑 𣽵 𱨹	
湋	𣲗	
湌	餐 歺	
湎	𨟺 𩈳 䤄 𱩸	
湏	須	
湑	𣷢	
湔	𣾅 𱨃 𱩹	
湛	㴴 𱧄	
湜	㵓	
湞	浈	
湟	況 况	
湣	㬆	
湧	涌	
湩	𡦢 𠄉	
湫	𣹌 湬	
湭	𱨴	
湮	洇 𣽔	
湯	汤 漡	
湰	漋	
湴	𱺲	
湻	淳	
湼	涅	
湽	淄	
湾	灣	
湿	濕 溼	
満	滿 满	
溁	濚	
溃	潰	
溅	濺	
溆	漵	
溇	漊	
溈	潙 沩	
溉	漑 摡 𱨣 𣲪	
溌	潑 泼	
源	厵 𠫒 厡 𠫐 𱧊 𱧱 𱨆 𳈥	
準	凖 准 𦎧	
溗	𣽘	
溘	𣹆 𣩄	
溚	𣽛	
溛	㴏	
溜	澑 𤄐 𱨗 𰜈	
溝	沟 𱧋	
溠	𤁺	
溡	𪶄	
溢	㳑 𱧤 𱨞 𲋱	
溤	𰛊	
溥	𱧈	
溧	𣿚	
溪	谿 渓 嵠	
溫	温 昷	
溮	浉	
溯	遡 泝 㴑 𲩪 溸 𣹫 𱨉	
溰	𰛥	
溲	𦦼 𣸈 𢅢 洃	
溳	涢	
溴	𲨦 𲪕 𳀢	
溶	𣵞	
溷	𢒤	
溸	𣹫	
溺	氼 尿 𣲙 𡲳 㲻 𱪑 𲪋	
溻	褟	
溼	濕 湿 𤃁 𣺯 𱩥	
溽	縟 𧗈	
滂	䨦 雱 霶 沗 汸 𣹿 𱨟	
滄	沧 𣳁 𤀅 𣶟 𱦇 𱧅	
滅	烕 灭 𢛣 𢦹 𣹹 㓕 𡟬 𱨍 𲩗	
滆	𣽐	
滇	𰛬	
滈	𤀰 瀥	
滋	𣳯 𤀮 𤂇 𲀑	
滌	涤 𣼝 𤂂 𱨕 𱨶	
滎	荥	
滑	磆	
滔	㴞 𱥾 𱦦	
滕	𣎌 𣹸 𣽨 𤂵 榺 𣳾	
滗	潷	
滙	匯 汇	
滚	滾 𲔔	
滜	𣽎	
滞	滯	
滟	灧 灔 灩 灎	
滠	灄	
满	滿 満 𱿼	
滢	瀅	
滤	濾	
滥	濫	
滦	灤 欒	
滨	浜 濱 濵 𱨺	
滩	灘	
滪	澦	
滬	沪	
滭	𤅳 𰛡	
滮	淲 𤂆 𤆀	
滯	滞 𨘛	
滲	渗 㵕 涁 𱨤	
滴	滳 渧 𤁷 𣾪 𱧥	
滶	𣿗	
滷	瀂 𰛮 塷 卤	
滸	浒 汻	
滹	𣼻 𤀶 𣿋 泘	
滺	悠	
滻	浐	
滾	滚 𣽙 𲔔	
滿	満 满 𠐎 𡈪 𣼛 𱧒 𱧼 𱧽	
漁	渔 䱷 𣿡 𤀯 䰻 𩼪 𩵎	
漂	𣿖 𣻔 㵱 𠷻 𤄚 𱨋 𱨫	
漆	柒 桼 七 㯃 𢒐 溙 𣴶 𢒡 𣷦 𱦙 𱦫 𱦱 𱧌 𱧰 𱩣	
漇	𢳜	
漉	𣼟 𲪳	
漊	溇	
漍	𬇹	
漎	潨 潀 𰛏	
漏	𢉀 𣼣 屚	
漐	𰛣	
漑	溉 摡	
漓	灕	
演	𤀋 𱨎 𱨨 𱨽 𰛑	
漕	𤅍	
漘	浱 滣	
漙	𣶣 𬇘 𣷼	
漚	沤 䌔	
漜	𡌯	
漠	𥕓	
漢	汉 𣶔 㵄 𤁉 𱦰 𱧻 𱨓 𱩩 𱩭	
漣	涟	
漤	灠	
漥	洼 窊 窐 溛	
漦	𣸗	
漨	浲	
漩	㳬	
漫	澷 澫 𣸞 𱨮 𱨾	
漬	渍 洓 𣿙 𱩰	
漭	𣶈	
漮	𣾩 𨻷	
漯	濕 𱨂 𲒘	
漰	淜	
漱	潄 涑	
漲	涨 涱	
漵	溆 潊 㵰	
漷	𤅻 𤅝	
漸	渐	
漻	𤁸 𣽓 𣼢 㵳	
漼	㵏	
漾	瀁 𣻌	
漿	浆 𤕯 糨 𩝴 𩝫 𤖅 𩞟	
潀	潨 漎 灇 𣽇	
潁	颍 𣻯 澃	
潄	漱	
潅	灌	
潆	瀠	
潇	瀟	
潋	瀲	
潍	濰	
潎	𣽠 𣺲	
潑	溌 泼 𣸍	
潒	𣻍	
潔	洁 洯 𣳱 㓗 𱧍 𱩈 𱩛	
潕	𤅅 㵲 𣲘	
潗	湒 㴕 淁	
潘	𤄜 𱪌 𱪓	
潙	溈 沩	
潚	㴋	
潛	濳 潜	
潜	潛 濳	
潝	㴔	
潟	澙	
潠	𠹀 噀 𤂿 𣹎	
潣	浼 𫞗 𤀳	
潤	润 𱨷	
潦	𣿳 𱩃 𣱾	
潨	潀 漎 𱦏	
潬	灘 𬈁	
潭	𤅦 𱨯	
潮	𡼼 𣶃 𲩖	
潯	浔 潭 𤃂	
潰	溃 𤀭 𤃘	
潴	瀦	
潷	滗 𣴡 𣺱 𮵷	
潸	𣽽 澘 𱨏 𱩄 𲊐	
潺	潹	
潿	涠	
澀	澁 渋 濇 瀒 涩 𣹣 歮 𣿠 歰 𣾫 𠽼 𤁍 𣴻 𣥒	
澁	澀 渋 濇 瀒 涩	
澂	澄 瀓	
澄	澂 瀓 𱧾 𱩁	
澅	𣶩	
澆	浇 𣻏 𣷝 𤀴 𣴹	
澇	涝 潦	
澈	徹 𤁲 𱩠	
澉	饏 䭛	
澌	𣩠	
澍	㴻 𲩸 霔	
澑	溜	
澒	𭱊	
澓	洑	
澔	浩 㵆 𣽋	
澕	𮳆	
澖	𰛵	
澗	磵 涧 㵎 𧯎 礀 𡼥	
澙	潟	
澛	瀂	
澜	瀾	
澠	渑	
澡	𱧘 𱩍	
澢	𭰎	
澣	𤃬 𲪠 浣 𣴟 𣴼	
澤	沢 泽 𤀎 𣽎 㚖 𱧓 𱨔 𱨰	
澦	滪 𤂻	
澩	泶 㶅	
澫	𬇕	
澬	𫞚	
澮	浍 𣴯 巜 𣲸	
澰	𰛲	
澱	淀 𣾮	
澳	𥜌 襖 𤀈 𤁌	
澴	㶎	
澷	漫	
澹	淡 𣽃 𱨵 𱩷 𱪂 𱪃 𱪒	
澺	𣽢	
澻	㴚	
澽	𤁴	
澾	㳠 𣸉 𤀱 𣽑 𣿔 𣾣	
澿	凚	
激	𱨱	
濁	浊 𲆼	
濂	濓	
濃	浓 𩅽 𤅁 𤅌 𤅛	
濄	㳡 𲁺	
濅	浸	
濆	𣸣	
濇	澀 澁 渋 瀒 涩 𬈧	
濈	湒	
濊	𰛦	
濎	㴿	
濑	瀨 瀬	
濒	瀕	
濔	沵 𤅤 𤁶	
濕	溼 湿 𦒣 𤂽 𣺯	
濘	泞	
濙	㶈 𣸨	
濚	溁	
濛	靀 霥 𣹞 蒙 溕 𱨘 𱩟	
濜	浕	
濟	済 济 𣸓 𣳵 𣺴 㴉 𤀮 𱦛 𱧫 𱨇 𱨠 𱩙 𱩜 𱩝	
濡	渪 𣽉 𣽈	
濤	涛 𣵬 𤃕 𤁟 涭 𣾭 𱩅	
濥	𤃚	
濦	㶏 溵	
濧	㳔	
濫	滥 𣽦 𱨩	
濬	浚 𣽊 䜭 𤀹 𱩕 𱩦 𱩳 𳈳	
濭	𱨚 𲪎	
濮	𤃙 𤃊 𤀾 𣱶 𱏠 𱥸	
濰	潍	
濱	濵 浜 滨 瀕 𣴩 𨽗	
濳	潛 潜	
濴	濚 𬈜	
濵	濱 浜 滨 瀕	
濶	闊 阔	
濺	溅 𣽖	
濼	泊 泺 𤄶	
濾	滤 𤄦 㴓 𱨪	
濿	砅 𪵱	
瀁	漾 𤂡 𰜝	
瀂	澛	
瀃	𣽷	
瀄	𰛤	
瀅	滢 濙	
瀆	涜 渎 凟 𤄴	
瀇	㲿	
瀈	𰝍	
瀉	泻 𣿱 𱧿	
瀋	沈 沉 渖	
瀍	湹	
瀏	嚠 浏 𤄉	
瀑	𤃵 𤄗 𱩏 𱩧 𱩾 𱪀	
瀒	澀 澁 渋 濇 涩	
瀓	澂	
瀕	濒 濱 𤄹 䧬 濵	
瀗	𮳏	
瀘	泸	
瀙	澵 𰜜	
瀚	𱩡 𱪖 𱪗	
瀛	𱨡 𱩱 𱪅 𱪊 𱪋 𱪙 𱪛 𱪜 𱪞 𱪟 𱪠	
瀝	沥 𤃹	
瀟	潇 𤂣 𤄙	
瀠	潆	
瀡	𣿂 㵦 𡄽 𲢷 𬩑 𠿬	
瀢	濻 𬉋	
瀦	潴 𤃣	
瀧	泷 滝 𲪃	
瀨	瀬 濑	
瀩	𬉏	
瀫	𣹬	
瀬	瀨 濑	
瀭	𮳗	
瀯	㶈 𰝅 濚	
瀰	彌 弥 㳽 𣶿 𣴱	
瀱	𣽄 𤄨	
瀲	潋 澰 㶑	
瀳	𣿕 𰜨	
瀴	𰜳	
瀵	𬉂 𤀬 𤄪	
瀶	𣻙	
瀸	瀐	
瀹	𤅢 𤅰 㵸	
瀺	𤀧	
瀼	𤅑 𩆶 㶞	
瀾	澜 漣	
灀	𩅪	
灂	𤅨 𤅪 泎	
灃	沣	
灄	滠	
灅	㵽	
灆	𱩪	
灉	澭 㴩	
灊	𤅬 𨽨 𤄵	
灌	潅 𤂦 𱨻 𱨼 𱩴	
灍	𫞝	
灎	灧 灔 灩 滟	
灏	灝	
灑	洒 𤂢 𣶇 𱩲 𱪔	
灒	濽 𪷽	
灓	𤅇 𰛪	
灔	灧 灩 灎 滟	
灕	漓	
灘	潬 滩 𤁤 𤅩 𤅼 𩘾	
灙	𣺼	
灝	灏	
灞	㶚	
灟	𭲫	
灠	漤 𤂺 𰜐	
灡	㳕 𬉠	
灣	湾 𱪆	
灤	欒 滦 栾 𱪍	
灦	𰝤	
灧	灔 灩 灎 滟	
灨	𣹟 贑 𱪝	
灩	灧 灔 灎 滟 𤄝 𤅿	
火	灬 㶡 𤆄	
灬	火	
灭	滅	
灮	光	
灯	燈	
灰	𤆆 𦭹 𳑌	
灱	灲	
灴	烘	
灵	靈 霊	
灶	竃 竈 𥨫 𥩋	
灷	𤆽	
灸	𤆐 㡱	
灺	炨 炧	
灼	烵	
災	灾 菑 甾 𡿧 𤆎 𤉣 𢎇 𤈮 烖 𲫦 𤆄 𤆋 𤆲 𱪺	
灾	災 烖 菑 甾	
灿	燦	
炀	煬	
炁	氣 気	
炃	燌	
炄	𣅴	
炅	炔 耿 昋	
炉	爐	
炎	𡗩 炏	
炐	𱪨	
炒	䊏 𤌉 㷅 𤌽 𤊛 𩱦 㶤 焣 煼 𤌝 𤌖 𱪰 𱪸 𱫕 𱫾 𱬐 𲆬	
炔	炅 耿 𤆿 焆 炴	
炕	𤇛 𤌁	
炖	𤆚 燉	
炙	䏑 𦜡 𤐬 熫	
炜	煒	
炝	熗	
炟	𤉊	
炤	照	
炥	𤇝	
炭	𡵼 𱛠	
炮	炰 砲 礮 𲬟 缹 𱴿	
炯	烱	
炰	炮 𤈖	
炱	𤒞 炲 𤆃 𤊜 㸀 𱬖	
炳	昺 昞 㶮	
炸	煠	
点	奌 點	
為	爲 为 𤓸 𨤒 𢏽 𦥮 𲾉	
炼	煉 鍊 錬	
炽	熾 𱬄 𱬛	
烁	爍	
烂	爛 燗 𱬅	
烃	烴	
烄	𤐳 𤉧 𤎦	
烈	煭 烮 𤉩 𤎾 𱪼 𱫝 𲀰	
烉	煥 焕	
烊	煬	
烋	𠹎 𤈢	
烏	乌 𥾪 𠂶 𤚶 𡗃 𡖗 𱫇	
烓	𧟼 𤌒	
烔	燑 爞	
烕	滅	
烖	災 灾 菑 甾	
烗	炏 𤉫 炌 𤈪	
烘	灴 𤉻 䆪 𧇲	
烛	燭	
烜	晅 𤉑 𤌓	
烝	蒸 㷥 𤇶 𩟘	
烟	煙 菸 𮳦	
烦	煩	
烧	燒 焼	
烨	燁	
烩	燴	
烫	燙	
烬	燼 𱫮	
热	熱	
烱	炯	
烴	烃	
烹	亨 𨢶 亯 𠅖 𠅠	
烼	炢 𤊺	
烽	熢 㷭 㶻 炐 𤑊 𱫏 𱫦 𱬢	
焃	𤊴	
焆	焨	
焉	𩾏 𤇟 𱙁 𱪷 𱪽 𱫃 𲋵	
焊	熯	
焎	𤈱 烲 𲫨	
焔	焰 燄	
焕	煥 烉 𱬇 𱬋 𱬌	
焖	燜	
焘	燾	
焙	𤉮 焷 𤊷	
焚	燓 㷊 炃 燔 燌 𱬗 𱬤	
焛	𨴙 𬮟 𤌎	
焞	𤑴	
焟	𤎳 𤓔 𣈏	
無	无 橆 𣑨 𡙻 𣠮 𣟒 𣚨 𤀢 𣞤 𠘩 𣞣 㷻 𤍍	
焢	焪	
焦	焳 㸈 𤓬 爑 𤊙 𩵰 𤓪 𱬳 𲬨	
焪	熍	
焭	煢 茕 𦬮	
焮	炘	
焯	𱫉	
焰	焔 燄 㷔 焱 爓 𤒦 𦥿 𱬬	
焲	焱 焬	
焳	焦	
然	嘫 𤟙 戁 𤓉 䕼 㸐 𱪬 𱪻 𱫙 𱫧	
焼	燒 簫 簘 烧	
煅	鍛	
煆	鍜	
煇	輝 𤑱 𪸩	
煈	𮳠	
煉	鍊 錬 炼 𥒯 𧹯 𮳣	
煌	𪏥 𤌼 䪄	
煎	㷙 𤌺 𤎵 𲬆 𤎴 𲮞	
煑	煮	
煒	炜	
煔	熌 𤊼 𦧡 炶 㶺	
煕	熙 熈	
煖	暖 𤏙 煊 暄 煗 㬉	
煙	菸 烟 㷑 𠖣 𡇽 𠖜 𤎟 𤊗 𡨾 𤏯 𱫣	
煚	煛	
煜	焴	
煠	炸 𤉬 𲫣	
煢	焭 茕 𠎽 㷀 𠌻 㒌	
煤	𭳿	
煥	烉 焕 奐 𱫶 𱬈 𱬚 𱯷	
煦	喣 昫	
照	炤 曌 𣉬 㷖 𥊐 𣊕 𥋫 𣊧 燳 瞾 𱫥 𱫿 𱬔 𱳌	
煨	燰	
煩	烦	
煪	𤋃	
煬	烊 炀	
煮	煑 𩱰 𤑜 𤆯 䰞 𤑨 𤋯	
煱	㶽	
煲	𲬪	
煳	㷻	
煴	熅	
煼	𬊂	
煽	扇 搧 傓	
熂	𪸕	
熅	煴 煾	
熆	㥺	
熇	燺 燆 灱 焅 𤐟	
熈	熙 煕	
熉	𤈶	
熊	𪏛 𧰯 𤠗 𳍰 𱬯	
熌	𤇄	
熏	燻 爋 𤑕 𤋱 𡴦 𡽽	
熐	𤑺	
熑	燫	
熒	荧 爃	
熓	𤆡	
熔	鎔	
熕	𬊎	
熗	炝	
熘	𰜈	
熙	熈 煕 焈 㷂 𱫆	
熚	𤇹	
熛	𤌑 𤐫 䙳 𤒾 㶾	
熜	𤊘 𤑢 燪 㷓 焧 𮳳	
熞	𰞤	
熟	𡒒 𤒆 𦏧 𤋩 𱫹 𰀅 𲫎	
熠	𮳜	
熡	𤋏	
熨	㷉 𤓮 㷫 𣂊 叞 尉 𤈫 𱫞 𭴈	
熬	𪌠 𤏺 𪌑 𪍾 𪍮 䵅 𲎓	
熭	𣊄 𤑒	
熯	𤑆 㸁	
熰	𬉼 𣉾	
熱	热 𤍠 𤉟 𪌌 𤎮 𤋩 𱫚 𱫡	
熲	颎 𩓺	
熷	𤎯 𤎰	
熸	𤓎 𤍖	
熹	熺 暿 𤏴 𤎿 𱫱	
熺	熹	
熾	炽 𤎷 𢧾 𢨙 𧹹 𤐦	
燀	𬊤	
燁	𤍞 烨 爗 𤑼 𤒫 㒯 熀 㷸	
燂	𤓠 燖	
燃	𤓉 𧆋 然 㸐 𤆂	
燄	焰 焔	
燅	𤍙 𤎢 𤏝	
燆	𮳧	
燈	灯 𧺄	
燉	炖	
燉	𦎫	
燋	𩵰	
燌	𰞻	
燎	𤊽 𤎚 尞 爒 𤈹 𤐗 㶫 𥛰 𤋯 𱫲 𱫽	
燐	粦 㷠 𤐪 𦺸 𧃮 𱬭	
燒	焼 簫 簘 烧 𤌸 𧄣 㶮	
燕	鷰 宴 讌 醼 䴏 㷼 𱍥 𳏷	
燖	𬊈 燂 燅 𱫎 𱬁	
燗	爛 烂	
燘	𬊖	
燙	烫	
燛	㷗	
燜	焖	
營	営 营 𢄋 𲕹	
燠	𣋉 𤈯 灹 𱪭	
燡	曎 𤏵 𠓋 𰞇	
燣	燷 𤒢	
燥	煰 𤍜 𤏟	
燦	灿	
燧	𤎩 㸂 𲬎 𤑾 𤒮 𤓫 煫 𨽵 𱔛 𱬰	
燬	𤈦 㷐 𤌋	
燭	烛 曯 爥 𱫴	
燮	𤏻 㸉 𤎬 𤍛 爕 𱑺 𮯳	
燰	𬊺	
燴	烩	
燵	𬊉	
燶	㶶	
燷	燣	
燹	𤐨 𧱾	
燺	熇	
燻	熏	
燼	烬 灷 煡	
燽	𬊍 𤐭	
燾	焘 燽	
燿	耀 曜	
爁	𬊶	
爃	𫞡	
爄	𤇃	
爅	㷵	
爆	𤒺 煿 𤒁 𤓊 𤋪 𤆊	
爇	𤑔 焫 𦳼 𣁞 𦶟	
爉	𤎞	
爋	熏 𤑕	
爌	兤 奛 黋 𤆓	
爍	烁 𤓈	
爏	𱪪	
爐	炉 𨈝 𱪵	
爒	𤒧 𤑗	
爓	𤐞 𰟘	
爔	燨	
爖	𤇭	
爗	𤑻 𮳴	
爚	𤓈 𤓀 𤐯 𤓝	
爛	燗 烂 爤 㱫	
爝	爑 𤓄 焳 𤓡 熦	
爞	烛	
爟	㮡 烜 𤌓	
爢	𤓒 㸏	
爣	𬊵	
爥	𪹳	
爧	𫞠 燯	
爨	𤑖 𤏷 𤍾 熶 𤓥 𤓟 𲬹 𱤶 𱬩 𱬱 𱬲	
爩	𤓭	
爪	爫 㕚 𱬴	
爫	爪 㕚	
爭	争 𠄙 𣌦 𪜃 𠫩	
爯	𤔹	
爰	𱬼	
爱	愛 𱭃	
爲	𤔡 為 为 𲾉 𤓸 𨤒 𢏽 𦥮	
爵	𡭌 𠕢 𩰥 𠙘 𩰣 𩰧 𩰨 𥥼 𩰦 𡬠 𠋓 𱤈 𱬾 𱭂 𱭆 𱭇 𲊁 𲌤 𲌥 𲌦	
爷	爺	
爸	𤕕	
爺	爷 𨈺 耶 𤕓	
爻	㕛	
爼	俎	
爽	𤕤 𠙠 𠎛 𡙁 𰋜	
爾	尔 尓 尒 𣝧 𤕨 𠑂 𱭋	
爿	丬 𤕪	
牀	床	
牁	牱 𲭳	
牂	䍭 䍧 𤖁 𦎆 𦍕	
牄	蹌 𩿄	
牆	墻 𲙳 廧 墙 𤖣 𤖧 𤖠 𢉈 𡫆 𱭔 𱭕 𱱙	
版	板	
牋	箋 椾 𰠛 㮍	
牌	𤗋	
牍	牘	
牎	牕	
牐	𤗮 𤗠	
牒	𤗣 𤗊	
牔	𤗳	
牕	窗 窻 窓 牎	
牖	𤗱 牗	
牘	牍 𤘄	
牙	𤘉 𨈑 𨈏 㸦 𤘈 𤘍	
牛	牜	
牜	牛	
牝	𤘥 𪊯 𲋳 𲭅	
牟	麰 𢃷 𠫚	
牠	它 他	
牡	𤚴 壮	
牢	𥥑 𢚄 𡕘 窂 𡘠	
牣	㸾	
牦	氂 犛 斄 髦	
牧	𤘴 𱭩	
物	㘬 𲥱	
牬	𤙂 𤙍 𤘬 㸬 㸽	
牭	㹑	
牴	觝 𳁝 抵 羝 𤘳 𤚃 𤙊	
牵	牽	
牸	㹀	
特	𤙫 犆	
牺	犧 犠	
牼	𰠲	
牽	牵 䊹 𢴡 𢫀 𲡰 撁	
牾	𤕻 𲭛	
牿	𱭲	
犀	𤚌 屖	
犁	犂 𤛿 𤙟 䵓 𤛺 𥝫 𲋾	
犂	犁	
犅	牨 𰠫 𤚞	
犆	𢃜 𤙫	
犇	奔	
犉	𤜀 𤜃 𤚮	
犊	犢	
犋	𰠱	
犍	㹇 㸫 𤚳	
犎	㸼	
犐	㸯 㸰 𢱃	
犓	𤚂 𬌝 𤚄 𲭥	
犕	𤙳 𤛟	
犖	荦 𥕚	
犗	𲭉	
犙	𤛤 𤚔 𲭢	
犚	𤛌	
犛	牦 氂 斄 髦 𤚐	
犝	𤙓	
犞	𪺭	
犟	勥 強 强 彊	
犠	犧 牺	
犡	𤛶 𤜏 𤜒 𮳻	
犢	犊 𤛯	
犤	𤜑 𰠹	
犥	𲭦	
犦	𤜈 𤜌	
犧	犠 牺 𣚘	
犨	犫 𠧐	
犩	𤛲 𤛂	
犪	𤛽	
犬	犭 犮	
犭	犬	
犮	𤝜 叐	
犯	𢒿 𤜛 𤝑	
犲	豺	
犴	豻 𤟉 𤞿	
状	狀	
犷	獷 𱮝	
犸	獁	
犹	猶	
犺	𤞀 𱮂	
犻	𢂤 𤜲 𤝂	
犿	𤝏	
狀	状	
狂	𢚇 忹 㹥 𢙌 𤝶 狅 呈	
狃	𢔟	
狄	犾 𲭶 𲭼	
狆	𲭾	
狈	狽	
狉	𲭮 𤞜 𧳏 豾	
狊	𲭵	
狎	𧆥	
狏	𲂥	
狐	𤜶 𧲲 𤝬	
狑	𤣤 𤣍 𤣋	
狒	𥝇 𥜿 𦦻 𥝈 𥝋 𥝃 𤝟	
狔	𤝺 𲮅	
狖	𤜴 𤝨 貁 𤟊 𤣛 𲀋	
狗	㺃 𢑪	
狚	𤞾	
狛	𤝡	
狜	𲮘	
狝	獮	
狞	獰	
狟	𤞸	
狡	𤟋	
狢	貉	
狣	𤞯	
狥	殉 侚	
狦	𧲾 𤞹	
狧	𤝓 𦧭 𤝰 㹺	
狩	𩊦	
狪	𧱁	
狫	𲮉	
独	獨	
狭	狹	
狮	獅	
狯	獪	
狰	猙	
狱	獄 𱮙	
狲	猻	
狳	㺄	
狵	尨	
狶	㹷	
狷	獧 𧳷 㹡 𢙂 𲟽 𱞜	
狸	貍 𱭼	
狹	陜 陝 狭 𠩘	
狺	㹞	
狻	䝜 𪊴	
狽	狈	
狾	𤝼 𤠥 𥺈 𤠹 猘 𤢻	
狿	𤜺	
猁	𲭺	
猃	獫	
猇	虓 唬 𤟝 𲮥	
猊	貎	
猋	飇 颮	
猌	𪺽	
猍	𰡎	
猎	獵 猟 𤡡	
猒	𤡜 𤞣 𤟶	
猔	𤡆	
猕	獼	
猗	欹 䝝	
猘	𤠹 𤝼 狾 𤟐	
猙	狰	
猛	𠩜 勐 𱮎 𱮖 𱮞 𱮟 𲂦	
猜	㥒 𰡂	
猝	𧳚	
猟	獵 猎	
猡	玀	
猤	𤢑	
猧	𰡏 㹻 𲭭	
猨	猿 蝯	
猩	狌 𱮋	
猪	豬	
猫	貓	
猬	蝟	
猭	𧽪	
献	獻 𱮪 𱮫	
猰	𤟻 䝟	
猱	㺀 𲎟	
猲	𤢔	
猴	㺅	
猵	獱	
猶	犹 𧳫 𱮓 𲭿	
猷	𱮁	
猻	狲	
猼	𧳵 𲮺	
猾	獪 𱮈 𱮚	
猿	猨 蝯 𤝌 𤠔 𧳭 𤟗 𧳷 𱮇	
獀	𤟫 𤡗 𱮍	
獁	犸	
獂	䝠	
獃	呆 騃 𤶗	
獄	狱 𡈭	
獅	狮 𤜳	
獊	𪺷	
獌	𧴝 䝡 𤢞 䝢 𤡁	
獎	奬 奨 奖 𤟒 㢡 𤟌	
獐	麞	
獑	𪖎 𰡔 𧴃	
獒	𤢝	
獖	𧴍 𰡞	
獗	𱮥	
獚	𤟡	
獜	𤢯 𤡩 鏻	
獝	𢨌	
獟	𬌮 𲮗	
獠	䝤 𤢸 𤢙 𲯏	
獡	𤢧 𤢴	
獢	𰡊 𤢃 𤠬	
獣	獸 兽	
獦	𤢠	
獧	狷 𢕼 𨆈	
獨	独 𤟩 𤝠 𤢜 𨊒 𱮦	
獩	𤞃	
獪	狯 猾 㹟	
獫	玁 猃	
獬	𦎈 𦏘 𤛳	
獭	獺	
獮	狝 𥙮 𤣗 𤣝 𤣐 𲯕	
獯	𲮛	
獯	𱜑	
獰	狞	
獱	㺍	
獲	获 擭 𱮧 𱮨 𱮭 𲮦 𱾅 𲉭	
獳	𤟦 𤡤	
獵	猟 猎 𤢪 獦	
獷	犷 𥜟	
獸	兽 獣 𲯋 𤢚 𱮤 𱮩	
獹	𰡄	
獺	獭 㺚 𧴡	
獻	献 𤡎 𤟜 𤣉 𱿖 𲮿	
獼	猕 狝 𲧡	
獽	𤢢	
獾	貛 犿 䝔	
獿	𠑍	
玀	猡	
玁	獫 𤞤	
玂	𰡩	
玃	𤣓	
玄	伭 𢆯 𠵓 𤇡 𤣥	
玅	妙 𡭹	
玆	兹 茲 𢆶	
率	卛 𧗵 䢦 𧗿 𱑎 𲓞 𲀜 𲀞	
玈	㢳 𤣧 𪑄 𢐸	
玉	𥝍 王 𤣪	
玊	璛	
王	𠙻 𡈼 𥝍 壬 𠰶 𢏝	
玑	璣	
玒	珙 玜	
玕	玵 𤥚	
玖	九 㺵 𤣵	
玗	㺮	
玙	璵	
玚	瑒	
玛	瑪	
玟	珉 玫 砇 碈 琝 琘 𤤍 䃉 䂥 瑉 珳	
玠	𤦠 琾	
玤	𤤵 䂜 𤤓	
玦	璚 𤤏	
玨	珏 瑴 㲄	
玩	貦 𮴀	
玫	玟 珉 㺳 珻	
玭	㻂 琕 璸	
玮	瑋	
环	環	
现	現	
玱	瑲	
玲	𤫩 𲰐	
玳	瑇	
玺	璽 𱯭 𮷯	
玼	皉	
珀	砶	
珉	玟 砇 玫 䃉 䂥	
珊	𤤪 𤩀	
珌	𩋇	
珍	珎 鉁 𧟪 錱 𱮹	
珎	珍	
珐	琺	
珑	瓏	
珒	𤦯	
珓	𥲯 筊	
珕	蛠	
珗	𥑻	
珙	㺬 𤣲	
珟	𤥔	
珢	𤥛 𮴜	
珦	𤩬	
珧	䖴	
珪	圭	
珬	㺷	
班	𤤻 𤦦 𤼬 𣪂	
珰	璫	
珲	琿	
珶	瑅	
珷	碔	
珼	𫞥	
現	现	
琁	𤥕 璇	
球	毬	
琄	鞙	
琅	瑯 𤨜 𤦴 𱯓	
理	𱝝	
琇	璓	
琉	瑠 璢	
琊	瑘	
琎	璡	
琏	璉	
琐	瑣	
琖	𦈻 𬍙 𧣴	
琚	𤪬 𤩵	
琛	𤨺 𤧪	
琜	𱮾	
琢	𱯉	
琤	鏳	
琥	𱯊	
琨	瑻	
琪	𤦢	
琫	琣 鞛	
琯	璭	
琰	𤥎	
琱	雕	
琳	玪	
琴	䦦 𩰔 𤫍 珡 𤦡 𤩟 䥅 䥆 𨪖 𨫹 琹 𲈣	
琵	𤧰	
琶	𤧲	
琺	珐	
琼	瓊 𱯶 𱰃	
琿	珲 𤦳	
瑁	㺺 蝐 珼 𤲰	
瑂	𤩣	
瑄	𤧺	
瑅	珶	
瑇	玳	
瑈	𤫕	
瑊	玪	
瑋	玮	
瑍	𤩆 𤥺	
瑎	䃈	
瑑	𤪪	
瑒	玚 𮴯	
瑕	𱯣	
瑙	碯 𥓱 𤤼 𥒤 𰡻 𥖋 𱴊	
瑚	𤤈	
瑟	𡚉 𤨝 𡘼 㻎 𢊎 𩇰	
瑠	琉 璢	
瑣	琐 𤨏 璅 𱯛	
瑤	瑶 𤪅 𱯃 𱯈 𱯖 𱯗	
瑩	莹 𤫎	
瑪	玛 碼	
瑫	𤨐	
瑬	𤦰	
瑮	𤨗 𤩰 𤪇	
瑯	琅	
瑰	㻁 𤪿 瓌 𤩫 𤤨 璝 𱯯	
瑱	𦗁 琠 𤩴 𦔿	
瑲	玱	
瑳	𤨛 𤪩	
瑵	𤨚 𤣺	
瑶	瑤 𱯌	
瑷	璦	
瑸	璸	
瑻	𪻲	
瑽	𪻐	
瑾	𤪣	
瑿	𤧧 䃜	
璁	𤧚 𤦏 𤥼 𮴨	
璃	瓈 𱯅	
璇	璿	
璉	琏	
璊	𤨸 𫞩 玧 㻊	
璍	𮴔	
璎	瓔	
璏	㻰	
璕	𬍤	
璗	𬍡	
璘	𤥸 𤪏 𤧢 𱴢	
璙	𤪃	
璚	𤦱	
璛	𰢄	
璝	𪻺	
璞	㺪	
璟	璄	
璡	琎 瑨	
璢	琉 瑠	
璣	玑 𤪫 㼄 𱯘 𱯠 𱯡	
璦	瑷	
璧	𱯢 𱯳 𱯻 𱰄 𲅇	
璨	㻮 𮴸	
璩	𤩁 𤥾 璖 𤦲	
璪	𤩨	
璫	珰	
璯	㻅	
環	环 𤧖 𤪹 𤨔 𱯔	
璱	𤪴 琗 㻭	
璵	玙 㼂 𤪐 𤫌	
璸	瑸	
璹	𰡽 𤩇 𠩱 𤩉 𤩈	
璺	𤪭	
璼	𫞨	
璽	壐 玺 鈢 𤫆 鉨 鉩	
璾	𫞦	
璿	璇 㻽 𤫀 𤩅 琁 䥧 𤩋	
瓀	瑌	
瓃	𤫤 𤫥	
瓄	𪻨	
瓅	瓑 𤪾 𬍛	
瓈	璃	
瓊	琼 瓗 璚 𱯫 𱯬 𱯰 𱯱 𱯸 𱯺 𱯾 𱯿 𱰀 𱰂	
瓏	珑 𪚝	
瓐	𰡵	
瓒	瓚	
瓓	𬎑	
瓔	璎	
瓕	𤦀	
瓗	㼇	
瓚	瓒 瓉	
瓛	𤩽	
瓜	爪	
瓝	瓟 㼎	
瓞	𤬎 𤫰 𤫼 𤫴	
瓟	匏	
瓠	𤬗 𱰅	
瓢	𤬡 㼼 𤬢 𤬣 𤕉 𱰇	
瓦	𠩅 𤬦 𡧗 𭀝 𭂬 𭺛 𭺜	
瓨	𤬪	
瓬	旊	
瓮	罋 甕 𤮲	
瓯	甌	
瓴	𤮹 𤬻 𤮮	
瓵	㼠	
瓶	甁 缾 𲸶 𪋋 𤬮	
瓷	甆 磁 𤮀 珁 𦈱	
瓻	𤭏 𱰉	
瓽	𦈹	
瓿	䍌	
甀	𦈼 𦉈 䍋 𦉖	
甁	瓶 缾 𲸶	
甃	𤭰 㼙	
甄	𤭾 𲁉 𲁊 𲁋	
甆	瓷 磁	
甈	𤮅 𤭝	
甊	𰢦	
甌	瓯	
甍	𣞑 𤭐 𠪹	
甎	磚	
甏	㼞	
甑	䰝 𩱭	
甒	𤭎 𤮢 𰢢	
甓	𲰣	
甔	瓭 𱰒	
甕	罋 瓮 𤮲 𦉥	
甖	罃 罌 𧶹 𰢤	
甗	𤮝 𱰕 𮴼	
甘	㤌 𠙸 𠙿 𤮺 𠮚	
甚	𠯕 什 𠥄 𥱅	
甛	甜	
甜	甛 𩚣 䑚	
甞	嘗 尝	
生	龶 𤯓 𠤵 𠥱 𲰭	
產	産 产 𨹞	
産	產 产	
甤	蕤	
甥	娚 㽒 𱰘	
甦	苏 稣 穌	
用	𠛁 𤰆 𠂵 𤰃 𡶤 𱖆	
甪	角	
甬	埇 桶	
甭	甮	
甯	寗	
由	䢟 𲛁	
甲	鉀 𠇚 𡴌 𱿔	
申	𢑚 𤰶 𦥔 𠭙 𦦀 𠭜 𱱆 𱺉	
电	電	
男	㽖 侽	
町	圢 𲰿	
画	划 畫 劃 畵	
甽	畎 𤰕 𤰝	
甾	災 灾 烖 菑 淄 𠚋 𠙾 𠚀 𠙹 畠	
甿	氓 𤰡	
畀	畁 𢌿 𢮧 𢍁 𱡜	
畄	留 畱	
畅	暢	
畆	畝 畒 畮 亩	
畇	㽦 𤱬	
畈	𲰷	
畊	耕	
畋	𢿊 𤝗 𤱞	
界	堺 畍 𠷟 𢌯 𨺬	
畍	堺 界	
畎	甽 𣸋 𤱶 𤰝 𡿨 𤰕	
畏	𤱖 𤱫 𤰵 𤰣 𤰴 𠂽 𤰲 𤰰 𲌧	
畐	偪 畗	
畒	畝 畆 畮 亩	
留	畱 畄 𤰛 𲰸 㽞 㽖 𱰯 𱰴 𱰵	
畚	奙 𣓩 𤲛 𠫻 𤲙 𡙲	
畛	𤱏 𤱼 𤱥	
畜	𠬀 𤲸 𤠕	
畝	畒 畆 畮 亩 𤲧 𠭇 畞 畂 㽗	
畟	𤰯 𠞅 𦔎	
畢	毕 𤲃 鏎 𧰆 魓 𤲜 𮵁	
略	畧	
畦	㽯 𤳬	
畧	略	
番	蹯 畨 𤳖 𥻫 𥸨 𢇪 𲍭	
畫	劃 畵 画 𤲿 𨽶 𠚇 𤲯 𤰱 𠞷 晝 𤱪 𦘕 𡇍	
畬	畲 畭 𤰩 𡌆	
畭	畬	
畮	畝 畒 畆 亩	
畯	㽙 𤲋	
異	异 𢄖 𠔱 𱰶 𮲡	
畱	留 畄	
畲	畬	
畳	曡 疉 疊 叠	
畴	疇	
畵	畫 画	
當	当 𤱭 𡭠 𢑐 𱰲	
畷	𤲹	
畹	㽜	
畺	疆 𱰥	
畼	塲 𤳈 𤲘	
畽	疃 䵯 𤴎 𤲫 𤳿 𤴋 墥	
畾	𤳏	
畿	㙨	
疀	𤳲	
疃	畽	
疆	彊 畺 壃 畕 疅	
疇	畴 𢏚 𢑜 𢑔 𠾉 𠷎 𤲮 𠝽 嚋 𱰿	
疉	曡 畳 疊 叠	
疊	曡 疉 畳 叠 𲔇 迭 𣆹 𣈍 㬪 𤴁	
疋	匹 𤴓 𲒉	
疌	𤴗 帇	
疍	蛋 旦	
疎	疏 踈 䟽	
疏	疎 踈 䟽 𥿇 𤕟 𤕠	
疐	㚄 𨂬 𢷐 𧁏 𤴡 𨇈 𨆫 𤴝	
疑	𦬦 𠤘 𡷪 𥎲	
疒	𤴳 𤴫 𤕫 疔	
疖	癤	
疗	療 𱝊	
疙	𢖴 𤴸	
疚	𤶔 𤶫	
疛	㿒 𤶡 𤵥	
疟	瘧	
疠	癘	
疡	瘍	
疢	𤻞 𤵜 疹 𤶝 㽴	
疣	肬 𤴨 𤴦 𪐤 𤷊 𱲔	
疤	㿬	
疥	𤸋 𤵇	
疧	疷 㽻 𤵑	
疫	𤶣	
疬	癧	
疭	瘲	
疮	瘡 𱚚	
疯	瘋	
疱	皰 𲲅 𲊬	
疴	痾	
疷	疧	
疸	癉	
疹	胗 𤵜 𤺋 𲱢	
疼	𤻴 𦙭 痋	
疾	𤶥 𥏴 𥏂 𠥻 𤕺 𤶅 𤕼 𥐃 𤖏 𤻣 𢇻	
疿	𤺕	
痀	𤹪	
痂	𦙲	
痄	𤶙	
病	𤖉 𤵣 𱱉 𲱒	
痆	𤷈	
症	癥	
痈	癰	
痉	痙	
痋	𤼖	
痌	𤺄	
痎	㾬	
痏	𤴨	
痐	蚘	
痒	癢 𤶪 𦍲	
痔	𤵁 𤸟	
痕	𤶨 𲱖	
痖	瘂	
痗	𤵝	
痙	痉 𤷁	
痛	𱝉	
痞	脴 𤹦 𤵛	
痟	𢈭 𡯩	
痠	𤷥 𲱷 酸	
痣	䏯	
痨	癆	
痩	瘦	
痪	瘓	
痫	癇	
痬	𤻂 𲭈	
痮	脹 𪽪	
痯	𤼐 𤻥 𱱛	
痱	疿 𤷂	
痲	痳	
痳	痲	
痴	癡 𠈴 𤶢	
痹	痺 疪 𤻖	
痺	痹	
痻	𤸅 𤵤	
痼	㽽 𲟄	
痾	疴 㢌 𱱖	
痿	𤸆	
瘀	瘷 𤷠	
瘁	疩	
瘂	啞 唖 痖	
瘃	𤸁 𤷚	
瘅	癉	
瘆	瘮	
瘉	癒 愈	
瘋	疯	
瘌	𱱐	
瘍	疡 𤺹 痒 𤻈 痬	
瘎	㽸 𤴺 𤴴 𤵔	
瘏	𤺈 𤸭	
瘑	𬏮 㽿	
瘒	𬏫	
瘓	痪 𤻨 𤹹	
瘕	疨 𤹱	
瘗	瘞 𱱜	
瘘	瘺 瘻	
瘙	㿋	
瘚	欮 𱱱	
瘛	𤺚	
瘝	𤸄 癏	
瘞	瘗 𨻊 𡈾 圠 𢊃 𡎶 𨻏 𤺦	
瘟	𤵒	
瘠	𤹠 𤻣 胔 𲟋 𰣰 𢊌 㾊 𲺍 脨	
瘡	疮 𤺨 𤶷	
瘤	癅 𥏵 𦞧	
瘥	𤻸 𣩈	
瘦	痩 𤵨 𤸃 𤹶 𤺁 𦢝 𤻯 膄 𤶌 𤸂 𤻺 𤶟	
瘧	疟 𤺝	
瘨	癲 𤸘	
瘩	𲺢 㾑 疸	
瘪	癟	
瘫	癱	
瘭	𤼄	
瘮	瘆	
瘰	𢋧 𤼠 𤻗 𤻳 𱱯	
瘱	𪽷 嫕 𲟊 𡣇 㥷 𤸽	
瘲	疭	
瘳	𤵃	
瘴	㢓	
瘵	𤸍	
瘶	嗽	
瘸	𠌳	
瘺	瘘 瘻 𤵿	
瘻	瘺 瘘	
瘾	癮	
瘿	癭	
癀	㾮	
療	疗 𤻲	
癃	𤵸 𤸇 𤶞	
癅	瘤	
癆	痨	
癇	痫 𣩞 𣩝 癎 𤺛	
癈	𬏦	
癉	疸 瘅 𤺺	
癊	𤶊 𤸌 𤷜 𦝴 𲱟	
癎	𰣯	
癐	𤶊	
癑	𤼝 𲟑	
癒	愈 瘉 愉	
癔	𤴥	
癖	䑀	
癘	疠 𤻹 𣨸 㾐 𤼚	
癛	癝	
癝	癛	
癞	癩 𱙯	
癟	瘪 㿜	
癠	𪗅 𤸾 𰣬	
癡	痴	
癢	痒 𤶪 𲱹 𤻰 𧓲 礢 𡂺	
癣	癬	
癤	疖 𤻵 𤻛 𲱪	
癥	症 㿂 𱱗	
癧	疬	
癨	霍	
癩	癞 㾢	
癪	𰣼	
癫	癲 𱂪	
癬	癣 㿅 㾌	
癭	瘿 𦡺 𩖍	
癮	瘾	
癯	臞	
癰	痈 𤻕 癕 㿈 𦡈	
癱	瘫	
癲	瘨 癫	
癴	𰣽	
癵	𤹏 癴 𤼙 𤼣 𦣏	
癶	𣥖 𠇿 𣥠	
癸	𤼩 𱫼	
癹	𤼧 𨂩 𤼯 𢯸 𦳠	
発	發 彂 发	
登	豋 𧰍 𤼪 𤼼 𤼷 𱱵 𱵫 𲱾	
發	彂 発 发 𤼬 𧬋 𤼲 𱱶 𱱷 𱱸 𲂲	
白	㿟 𦣺 𤼽	
百	佰 𦣻	
癿	𤼾	
皀	㿝	
皁	皂 𣅖	
皂	皁 𣅖	
皃	貌 貎	
的	旳 㢩 𤾠	
皆	𣅜	
皇	𤽚 𦤍 𦤃 𤽙 𦤐 𤽧 䍿	
皈	歸 帰	
皊	𤾻 𤾨 𤿅	
皋	皐 臯 睾	
皌	𤽜	
皎	皦 㿟 賋 𡙎 𣎣 𥅟 晈 㬵	
皐	皋 臯 睾	
皑	皚	
皓	晧 皝 顥 皜	
皕	𲐃	
皖	晥	
皙	晳 𲤪	
皚	皑 凒 暟 𩄟	
皜	暠 𤾘	
皝	皓 晧 顥 皩	
皞	皡 皥 暭 曍 暤	
皟	𤾀	
皡	皥 皞	
皣	𤾾 𤾼 𤾧 𤾴	
皤	𩕏 𤽻	
皥	皡 皞	
皦	皎 㿟 敫 曒	
皪	𰤕 㿨 𤽥	
皭	𤿃 㬭	
皮	𠰎 𥬖	
皯	𤿊 䵟 𩈅	
皰	疱 𦫥 䶌 𦫗 𦝐 靤 𨣙 𦫱	
皱	皺	
皲	皸 𲄺	
皴	𦫝	
皵	𥀟 𣛵	
皷	鼓 鼔 皼	
皸	皲 𤿟 皹	
皺	縐 皱 𢑫 𤿮 𩈟 𩋓 𤿿 𤿥 𩊥	
皻	𦟰 皶	
皼	鼓 鼔 皷	
皽	𤿝 𤿘	
皾	𰤬 𥀲	
皿	𠀜	
盂	䍂 𥁄	
盃	桮 杯 㮎	
盄	𥁛 𥁜 𥁏	
盅	蛊	
盆	瓫 㿽	
盇	盍 𥁋	
盈	𡺡 盁 𱲐 𱲑	
盌	椀 碗	
盍	盇 𥁋 𥂊	
盎	𤭹 𤬺 㼜	
盏	盞	
盐	鹽 塩	
监	監	
盓	𥁡	
盖	蓋 𲲑 葢	
盗	盜	
盘	盤 𱲋	
盙	簠	
盛	𡡛 𮲎	
盜	盗 𠩼 𤑂 𠉭 𨹇 𤋆	
盝	𣿍 𥂖	
盞	盏 𤐒	
盟	𧖸 𥁰 𢄾 𧖽 𥂗 𱵗	
盠	𥂼	
盡	尽 𥁞 䀆	
監	监 譼 𧗄 𧩾 𧨭 𱲚	
盤	盘 鎜	
盥	泴 𣹉 𤃗 𥁉 𱲛	
盦	盫	
盧	卢 𥃈 𱿎	
盨	𪾔 𥂾 𱲟	
盩	盭 𥂲 𥂱 𥂕 𧗑	
盪	蕩 蘯 荡 𥂳 𣻭 𱲒	
盬	𪉶 𥃉	
盭	盩 𥃎 𥃊 𢿐 𥃁	
目	𠫕 𡇡 𥆤 𡆲 𥃦	
盱	𥃳 𥅚	
盲	𤷐 朚 盳 𥇋	
直	値 𣖇 𥄂 𣖴 𡇛 𣓟 𰅰	
相	𢪷	
盼	䀎 盻 𲤕 𱲭	
盾	𠩮 𥍿	
盿	䁕 𥄐	
省	𡨽 𥅱 𡮀 䁞 𥄾 𱲣	
眂	眡	
眄	䀎 𲤐	
眅	𥉟 𥈼	
眇	緲 𥋐 𢡾 𢡸	
眈	躭 耽 𧡪	
眉	睂 屓 𥅮 𣮮 𥇮 𱲯 𠃜	
眊	𥉗	
看	𡰶 𡈟 𥉏 𱳁 𲑽	
眍	瞘	
眎	視	
眒	𥋀 𥆓	
眓	𧵝 𥅩 𧶂	
眕	𥇐	
眗	𥈈	
眘	昚 慎 愼	
眙	瞪 瞠	
眚	𤯝	
眞	真	
真	眞 𠤛 𡙊 𰅴	
眠	瞑 𥉦	
眡	眂	
眣	眰 𥄺 𥈖	
眥	眦 𥈐 㫮 𳂖	
眦	眥	
眨	䀹	
眪	𥅙	
眬	矓	
眭	睳	
眯	眫 𥅼	
眱	𥅣 眤 𥄿	
眴	䀏 𲲣	
眵	𥉍 𥄏	
眶	𩒑	
眷	𠝂 𨤗 𨤓 睠	
眹	𥆵	
眺	𱲴	
眻	䁑	
眼	𥆢 𥃩	
眽	𥄄 眿 𥄼	
眾	衆 众 㐺 𥅫 𠍸 𡿻 乑 𠱧 𠱦 𠂝 𲏀 𱲨 𲀘	
着	著	
睁	睜	
睆	𥆒	
睇	眱	
睉	𥉢	
睌	𥇅	
睍	𪾢	
睎	𥅹	
睏	困	
睐	睞	
睑	瞼	
睒	晱	
睔	𥇊 𬑆 䎾	
睚	厓 𥊅 𧡋	
睛	𰥕	
睜	睁	
睞	睐	
睟	𥄌 𱲵	
睠	𲁏	
睡	𥉚 𥋍	
睢	濉	
督	𥆳 𱲸	
睥	睤 𡦟 䁹	
睦	𥄈 𡻲 𡐑 𡍬 𱳉 𥅅	
睧	𥄇	
睨	𧡎	
睩	𥉶	
睪	睾 𠬤 𥇝 𥇡 𦎝	
睫	䀹 𣮑 𣭶 𣮍 𣯰 𣮒 𣮣 𣯮 𣰞 𣮌 𳂶 𥇒 𥊆 𣰍 𣯥 𲄷	
睬	倸	
睴	𬑕	
睵	𥅰 𦞁	
睹	覩	
睺	𥈑	
睽	𱱄	
睾	皋 皐	
睿	𧮲 𣥸 𱲲 𱾙 𮶺 壡 𣦲 㲊 𲲻 叡 𠮉 㪫	
瞀	𣊃 暓 𥎉	
瞁	䂓 𤋀 𥇏 㷦	
瞂	𢧕 𠪫	
瞅	矁 𬑡	
瞆	瞶	
瞉	𥊧	
瞋	𥅜	
瞍	𥈟 𥈃 𮲦	
瞎	𥈎 𰥌	
瞏	睘	
瞐	𦋹	
瞒	瞞	
瞓	𰥛	
瞘	眍	
瞚	𥋰	
瞛	𰥒	
瞜	䁖 𧢃	
瞝	𣉽	
瞞	瞒 𲹶	
瞟	𥍌 𥌝 𧢄 𥋄 𥋠	
瞠	瞪 眙 𥊲 憆 𥊰 𥊼	
瞡	𰥪	
瞢	𥉞 𦱛 𥊄 𥌋 矒	
瞤	𥆧 𥋃 𥌎	
瞥	苤 𧢍	
瞩	矚 𰥩	
瞪	眙 瞠 覴	
瞫	𦗡 䚓 𥍗	
瞬	䀢 瞤 瞚	
瞭	了 暸	
瞯	瞷 𰥨	
瞰	矙 𥍓	
瞱	𬑓	
瞲	𥄴 𥅛 𥄵	
瞴	𥌇 𱲦	
瞵	𥌌	
瞶	瞆 𥌶	
瞷	瞯 𥊺 覵 𬑗 𦠥	
瞹	曖	
瞻	㫥 𱳎 𱳏 𱳐 𱳑 𱳖 𱳙	
瞼	睑 𥇥	
瞽	𥌕 𱳊	
瞿	䀠 眗	
矀	𲥄	
矁	瞅 𬑡	
矆	䂄	
矇	蒙 𰰡 懞 朦 𥉕	
矈	矏	
矉	𪾸	
矊	𥌣 𬑧	
矋	矖	
矋	𲲟	
矏	矈 𥋬 𥌂 𥌗	
矐	𥉑	
矑	𪾦	
矓	眬	
矕	𰥠	
矖	矋 𰥢	
矗	𰅹	
矘	𰥹	
矙	瞰	
矚	瞩 𥋛 𱳔	
矛	𥍥 𢧟 𥍤 𨥨 鉾 𢦧	
矜	矝 𥎅 㥤 𥎚 𥍵 㮗 𥎊	
矞	𥎕	
矠	𥍡 𥎏	
矢	笶 𥬟 𠂕 𠓡 𥎨 𠤕	
矣	𢦕 𠤘 𡗞	
知	𥎵 𥎿 𢇻	
矧	訠 矤 𥎪 弞 𥎧	
矨	𥏎	
矩	榘	
矪	𥎻	
矫	挢 矯	
矬	𥲽	
短	𢭃 䄈 𥎶 𣠭	
矮	躷 𨱥 𰿖 矨 㾨	
矯	撟 矫	
矰	𢨉 𢎒	
矲	𰦜	
石	𥐘 䂖 𥐖	
矶	磯	
矺	䂝	
矾	礬	
矿	礦 砿 鑛 鉱	
砀	碭	
码	碼	
砅	濿 沯	
砆	玞	
砇	珉 玟	
砉	硅	
砌	纖 磜 矵 𱳫 𲳉	
砎	𥔅 𥐤	
砑	𠚾 㧎	
砒	磇	
研	硎 揅 硏 䂴 𥓋 硑 䊙 𮵋	
砕	碎	
砖	磚	
砗	硨	
砘	𲴍	
砚	硯	
砜	碸	
砝	䂲	
砞	𥑘	
砠	岨 𥕑 𥕅	
砢	𥗴	
砣	鉈 𥓿 砤 碢	
砥	厎 䂡 𥐺 𱳷 𱳿	
砦	寨 𥓽 𡎵	
砧	碪	
砨	砈	
砩	𲴊 𲳶	
砫	宔	
砬	磖	
砭	𥐗 𥑁	
砮	𢊨 𠪓 𥑌 𠩨	
砯	𥒜 砅	
砰	硑 𨺀 𥕱	
砱	𥖟 𥘃	
砲	礮 炮 礟 𳇏 𥔰	
破	𡲠	
砺	礪	
砻	礱	
砾	礫	
砿	礦 鑛 鉱 卝 矿	
础	礎	
硁	硜	
硃	朱	
硅	𳀠	
硇	𠬦 𥑩 䃩 𥓁 𥐼 𥑚 𥗸 𮵑	
硈	矻 䂲 𥑄	
硉	𡸒	
硍	𥓀	
硎	研 揅	
硏	研	
硐	硧	
硑	𱴓	
硕	碩	
硖	硤	
硗	磽	
硙	磑	
硚	礄	
硜	踁 硁 䃘 硻	
硟	𥒔 𥕈	
硤	唊 硖	
硨	砗 𨋓	
硩	𥓊	
硫	磂 𱴖	
硬	峺 鞕 𲳮	
硭	𥐞 𥒴	
确	確 埆 𥔳	
硯	砚 硏 䂩	
硵	磠	
硷	险 鹼 鹻 鹸 堿 碱 礆	
硻	𥑒	
硼	𥕱	
硾	𥖌 礈 𥖴	
碁	棋 棊	
碆	𥮯	
碇	磸 椗 矴	
碈	𱗃	
碍	礙 㝵	
碎	砕 𱳶 𱳸 𱳽	
碑	𥓓	
碔	珷 𥕻	
碕	埼 崎 嵜 陭 𥔎 﨑 㟢	
碖	𱳯	
碗	椀 盌 㼝 鋺 埦 𱴣	
碘	𲨩 𲬰 𳀨	
碙	𥐻	
碛	磧	
碜	磣	
碟	楪 𲲐	
碡	𥖿 𥖠	
碢	𰦿	
碣	𡂶 礍 嵑 𣍔	
碥	扁	
碦	礊	
碧	𦃧 𤫅	
碨	𥓔 𥔃	
碩	硕	
碪	砧	
碭	砀	
碯	瑙 𮵑	
碰	掽 踫	
碱	鹻 鹼 鹸 堿 礆 硷	
碲	𳀜	
碳	𳀟 𳆑	
碸	砜	
確	确 碻 硈	
碼	码	
碽	䂵	
碾	𥑊 𰦪	
磁	瓷 甆 𥔵 礠	
磃	𥓚	
磅	磞 𱱼	
磆	滑	
磇	砒	
磈	䃬	
磊	磥 𡾷 礌 𥑶 𥗉 𥗬 𮵎 𲞐 𰦫	
磌	𧰊	
磏	𥖝	
磐	𥑍 䃲 𣍵 𱴝 𱴫	
磑	硙	
磒	隕 𬒍	
磓	𥑵	
磔	𨃥 𢵍 矺 𨃮 厇	
磕	礚 𥔐 𱡐	
磚	甎 砖 㼷 𥶸 𲸸	
磛	嶃 𥕌 𱴻 𲳦	
磠	硵	
磡	墈 𥓒	
磢	摤	
磣	碜 硶 𥕃 𥓗	
磥	磊 𲴋	
磧	碛 𲳉	
磨	䃺 𲧿 𱐦 𳇝	
磪	崔	
磬	声 𥓕 硜 𡔝 殸 𱴧 𱴲	
磯	矶	
磱	𮀤	
磲	𥓼	
磴	嶝 隥	
磵	澗 𰧃	
磶	𥖽	
磻	碆	
磽	墝 硗 礉 𤴀 磝 墽 䂪	
磾	䃅	
磿	礰	
礄	硚	
礆	鹻 鹼 鹸 堿 碱 険 險 硷	
礉	䃝	
礊	𥖳 𢪎 𲡧 𭡚	
礋	𰦰	
礎	础	
礏	𬒆	
礐	𬒈 砳 嶨 㙾 𥗙	
礑	𱳹	
礒	𥐟	
礔	𥗲 礕	
礘	硆	
礙	碍 㝵 硋 𥃷 㕌 𱵂	
礚	𥕤	
礛	𰧔 礷	
礜	𪿝	
礝	𥕷 碝	
礟	礮 𲬟 𳇏 砲	
礡	礴	
礢	𱴠	
礥	𰧇	
礦	砿 鑛 鉱 卝 矿 𥒩 鋛 丱 𨥥 𨧾 𥐫	
礧	㠥 礌 礨 𥗬 𡻭 𥑶	
礨	𥑶	
礩	𰧉	
礪	砺 𲴜	
礫	砾 𥕴 𱴺	
礬	矾	
礮	砲 礟 𲬟 𳇏 炮 𪿫	
礰	𥕆 𰦦 𱵃 𲅉	
礱	砻 𤮨 礲	
礲	𰦭	
礴	礡	
礶	罐 鑵 缶	
礹	𰦾 𲴢	
示	礻 𡭕 𧵋 眎 𥘅	
礻	示	
礼	禮	
社	𥙭 𣴳 𥙲 䄕 𱵠	
礿	禴 𤓝	
祀	𥘰 𥙉 禩 𥛴 𱵲	
祃	禡	
祅	䄏	
祆	祅	
祇	祗 衹 只	
祈	𣄨	
祊	𥛱 閍 𥛻 𥚧	
祋	𣪌	
祎	禕	
祐	佑 𨳾	
祓	𥘬	
祕	秘 袐	
祖	𥛜 袓	
祗	祇 衹 只 𣱊 祬 袛 𥙂 𱵛	
祘	算 筭	
祙	𥘯	
祚	秨 𱵇	
祝	𩚶 拀 𥘱	
神	𫋵 𥙍 柛 𥛃 𥞁 𥜩 䰠 𥛠 𱬸 𱵏 𱵐 𱵚	
祟	𣦅 𥜱 𱵳	
祡	𥚨	
祢	禰	
祣	𥜠 𥙎	
祤	𲀮	
祥	𢒑 羏	
祧	𥜔	
票	𤐫 㶾 䙳 𱫔 𱬧	
祭	𥙊 𨢵	
祯	禎	
祰	禞 祮	
祲	𥛆 𥛀	
祷	禱 𱵧	
祸	禍 𱵔 𱵣 𱵤	
祺	禥 𥘕	
祼	淉 𥚌	
祿	禄 𥜅	
禀	稟 𱹌 𱹓 𱹙 𱹝 𱹠	
禂	禱 䮻 𩤫 𩦑	
禄	祿	
禅	禪	
禋	䄄 𠖦 𥛿 𡫻 𡫚 㮒 𥛡 𥛛	
禍	祸 䄀 旤 𥙯 𣨱 𣨷 𥛔 𧙹	
禎	祯	
福	畗 稫 𤔜 𱭅 𱵦	
禓	𥛙 𰧰	
禔	䃽 禵	
禕	祎	
禘	祶	
禜	𰱈	
禡	祃 𢒴	
禥	祺	
禦	御 𧗻 䢩 𲀡	
禨	𥘌	
禪	禅 䄠	
禫	𥜯 𧝓 𥜸	
禬	𰧻	
禮	礼 𥘍 𤔑 𥝓 豊 𠃞 𥘆 𱵱 𱵷	
禯	𰧾	
禰	祢 𥙄 𥜦 𥜬	
禱	禂 祷 𥙸 𥛇 𥛈 𥚜 𥙤 𥜹 𥜣 𱵪 𱵵 𱵸	
禳	𱵒	
禴	礿 𧆆	
禵	𰨖	
禷	𥜛 𱵟	
禸	𠘯 𠫗	
禹	𥜼 𢁰 𱵹	
禺	𣕃	
离	離 𧴁 𡴥	
禽	𢄕 𠎘 𱮠 𱵺	
禿	秃 秂 𣬜 痜	
私	厶 𱵆 𱵽	
秃	禿	
秄	耔	
秅	秺	
秆	稈	
秇	藝 兿 蓺 芸 埶 執	
秈	籼 𦱑 䄽	
秉	𣏲 𥝐 𦱮	
秊	年	
秋	穐 龝 秌 䆋 𪔁 𪛁 鞦 𪚼 𥣨 𤇫 𥤚 𱶩 𱶪 𱶮	
秌	秋 穐	
种	種	
秏	耗	
秐	耘	
秒	䅺	
秔	稉 粳	
秕	粃 𥝓	
秘	祕	
秚	拌	
秝	𥤀	
秠	𥝣 𥞶	
秣	𦾒 𧀅 䬴	
秦	𥢮 𥣠 𥠼 𣜈 𱶇	
秩	𢊭 豑 𧰅	
秫	术 𲵒	
秬	𩰤	
积	積	
称	稱	
秳	𥞸	
秷	𥡫	
秸	稭 䕸 鞂 𱾰 𲵋	
移	迻 𡖰 𥞀 䄬 𧚕 𱵈 𱶃	
秽	穢 𱶧	
秾	穠	
秿	𥡨 𥠵	
稀	餙	
稂	蓈	
稃	粰 𥹃 𥞂	
稅	税	
稆	穭 穞	
稇	稛 𦓾	
稈	秆 芉	
稉	粳 秔	
稊	䄺 𥝼 䅠	
程	𱶏	
稌	䅷	
税	稅	
稏	䅉	
稐	耣 𦓾	
稑	穋	
稒	㧽	
稔	䄒	
稕	𦽑 𥤁	
稗	𦓸	
稘	朞 期 𣍠 𥟞 𣇳 𣅆 𣔔 𣍡	
稚	穉 稺 䕌 𥣦 䄺 䆈	
稛	稇 𡈳 𡈷 𦄐	
稜	棱 楞	
稞	𥠁	
稟	禀 𱶣 𱶫 𱹅 𱹟 𱹡 𱹨	
稠	禂 𱶄 𳋛 𥡀	
稡	𥞯	
稢	稶	
稣	苏 甦 穌	
稦	𥟏 𮵠	
稨	𥣰	
稬	糯 粫	
稭	秸	
種	种 𥢖 𦔉 𥡰	
稯	𥞝 𥠡 𥟛	
稱	偁 穪 称 秤 𱶈 𱶍 𱶛	
稲	稻	
稳	穩 𮂹	
稴	𥻧 𥠆 䆂	
稵	𥠃	
稷	𥠈 禝 𥞷 𥟛 𥠎 𱶖	
稺	稚	
稻	稲 𱶑 𰨛	
稽	𥠻 𥡞 𥡳 䭫 䭬 𩠥 𩠜 𩠦 𥡴 𱶋 𱶓 𱶔 𬓠	
稾	稿 槀	
稿	稾 槀 藳 稁 藁	
穀	糓 谷 榖 𥝻 䅽 㯏 𣖫 𥡛 𱶢 𱹣	
穂	穗	
穅	糠 𲵝	
穆	𥠇 𢿉 𥡆 𢿬 𥟙 𢾓 𱵘	
穇	䅟 𥤇	
穈	𥡹	
穉	稚	
穊	𥝪	
穋	稑 𥢩	
穌	甦 稣 鯂 𳑊	
積	积 𥡯 𥢼 𱶌 𱶕 𱶤	
穎	頴 颖 𱩤 𱵜 𱶥	
穐	秋 龝 秌	
穑	穡	
穖	𬓠	
穗	穂 𦼯 𥝩 𬜨	
穘	𲵅	
穙	𥣜	
穛	𥼚	
穞	穭 稆	
穟	𥢁 𦼯 𥠂	
穠	秾	
穡	穑 𥢺 穯 𥣱 𱵢 𱻶	
穢	秽 𤻀 𢧹	
穣	穰	
穤	糯 粫	
穧	𰨦 𲵏	
穨	𬓼 𥤒 𩘺	
穩	稳 㒚 𡨠 穏 㝧 䦟 𤯗 𡘫	
穪	偁 稱	
穫	获 檴 劐 耯	
穬	䊯 𰨜 𨤡 𱹧	
穭	穞 稆	
穮	𦔩 𦔗	
穰	穣	
穳	𥣪 𥝺 𥣚	
穴	𥤢 宂	
穵	窫	
究	𥨶 䆒 𥦵 𡫄 𥨓 宄 𲝕 𥧖	
穷	窮	
穸	夕	
穹	宆 𠫙 𡸕 𱶲	
空	𢦉 𲃮 𲓲	
穽	阱	
穾	𥤹	
穿	𥥢 䆤 䆥 𱶿	
窀	𥤭	
突	宊 𥥛 𥤮 穾 𡦾	
窃	竊	
窄	𮶜 𲮨	
窅	𥃺 𥄀	
窆	㝎	
窈	𡢵 𱶴 𱷉	
窉	寎	
窊	窳 溛 𱷎	
窌	窖 𥥤 𥥺 𥥹	
窍	竅	
窎	窵	
窑	窯 窰	
窓	窗 窻 牕 䆫	
窔	穾 𡧮 㝔 𥤹	
窕	𡣡 𥧽 宨	
窖	窌 𡇪 𡑛	
窗	窻 𲜗 窓 𲜔 𲵟 䆫 𠂨 囱 𥦾 𲜏 囪 牕 牎 𤗉 𤗄 𡆧	
窜	竄	
窝	窩	
窞	𥧹 𥦇	
窟	𢷈 𥧊 堀 窋 𡻋 𡑣 𱐑	
窠	𲉼	
窡	𡨤	
窣	𥤿 𥦑	
窥	窺	
窦	竇	
窩	窝 𡑟 䆧	
窪	洼 漥 窊 䨟 𥦠	
窬	𥦹 𥦧	
窭	窶	
窮	竆 穷 𥧺 䠻 𨉺	
窯	窰 窑 𥧟 𥧳 䆙	
窰	窯 窑	
窱	𡩢 𰩏 𲊅	
窳	𥦠	
窴	塡 填 𥧅	
窵	窎 𥧓	
窶	寠 窭	
窹	𥧝 𥧸 𩄭	
窺	窥 𥨖 闚 𡪽	
窻	窗 窓 牕	
窾	𡪡 窽	
竀	𧡧 𰩓 靗	
竁	𡪣	
竃	灶 竈	
竄	窜 𥨒 𥨗 𥦻 𥨬 䞼 𱚔 𱷌	
竅	窍 䆻 𥦂 𥤾	
竆	窮	
竇	窦 𥥨 𥥷 𥩐	
竈	灶 竃	
竉	𥥅 䆔 𰩅	
竊	窃 𥨱 𥨷 𥩓 𥧼 𥨵 𢿑 𱡡 𱷛 𱷝 𱷞 𱷟 𱷠 𱷡 𱷢	
竑	竤 𨌆	
竒	奇	
竖	竪 豎	
站	𥩠	
竚	佇 𥩟	
竜	龍 龒 尨 龙	
竝	並 并 幷	
竞	競 竸	
竢	俟	
竣	𱷦	
童	𥪿 𥫍 𥪽	
竦	𢱠 𢷜 𢖗 捒 𱟍	
竪	豎 竖	
竭	𱷧 𳊱	
竮	𥩵	
端	𥪄 𱷩 𱷪	
竱	𫁟	
競	竸 誩 竞 𥪰 𨐼 兢 𧫙 𧫘	
竷	扻 𣫡	
竸	競 誩 竞	
竹	廾 艸	
竺	笁 𥫰	
竻	簕 𥵚	
竽	𥫡	
竾	篪 箎	
竿	𣔼 𥫞	
笃	篤	
笄	筓 䈂 𠚙	
笆	巴	
笋	筍	
笏	𡇉	
笐	𥫺	
笑	咲 𥬇 关 㗛	
笓	篦 𦊁	
笔	筆	
笕	筧	
笙	𤯛 𣢡	
笛	篴	
笝	笚 䇱	
笞	𢲹 𣘜 抬	
笥	𥯱	
符	苻 𱸌	
笨	㤒 㤓 体	
笪	𥭧 担 𱷳	
笫	𱷹	
第	苐	
笭	䉖 𥵝	
笮	𥯧 𥬚 𥬛 䇥 𲢜	
笯	𥲘	
笱	𦊒	
笲	匥	
笳	䈔	
笴	𥯽 𣘠 簳	
笶	矢	
笸	箥	
笺	箋	
笻	筇	
笼	籠 篭 𱸉 𱸢	
笾	籩	
筀	𥯫	
筄	𥬻	
筅	𥬗 箲	
筆	笔 𡭩 茟	
筇	笻	
等	朩 䒭 𡬝 𢌭 䓁 𱽍	
筊	笅	
筋	觔 䈥 竻 荕 𲼂	
筍	笋 𥰿 𥰴 箰 𥳦	
筏	栰 𲦜 𱼻	
筐	筺 匡	
筑	築 𣽆 𥬑 𥬶 𥬾	
筓	笄	
答	荅 畣 譗 𣌭 畗	
策	筞 𥮫 萗 𠞁 𥮮 𥳯 筴 箣 𠷽 䇲 𠞦 𢄆	
筚	篳	
筛	篩	
筜	簹	
筝	箏	
筞	策	
筠	𥭀	
筡	𥱻	
筢	𲶉	
筣	䉫	
筥	𥴧	
筦	管 𥭨	
筧	笕 梘	
筨	𥲌 笒 䈄	
筪	笚	
筭	算 祘 𢌺 𥳪	
筮	𥰫 𥷣 莁 𥷂 𥰰 簭	
筯	箸	
筰	𦁎 𥯭	
筱	篠 筿	
筲	䈰 䈾	
筴	䇲	
筹	籌	
筺	筐	
筼	篔	
签	籤 籖 簽	
筿	筱 篠	
简	簡 𫈉	
箂	𮵱	
箄	𠥉	
箇	個 个	
箈	䈚 𥭜	
箋	牋 笺 椾 㮍	
箌	𥵤 𥵢 𠟅 䈇	
箍	箛 笟	
箎	篪 竾	
箏	筝 𩗲	
箑	𥵳 䈉 𥯦	
箒	帚 菷 𱷼	
箓	籙	
箕	𠔛 𠴩 𠔋 𠥩 𠀮 𠥊 𦋊 𠀠 䇧 𥫚 𠔝 𡿸 𠷛 𥫶 𠔐 萁	
箖	籃	
算	祘 筭 𥬷 𥮅 𥳪 𱚜 𮵬	
箘	箟 䇹 𥱽	
箙	𥵩 𩋟	
箚	剳 札 劄	
箛	箍	
箜	𢷙 𣝃	
箝	鉗 钳 䈤 𥮠	
箠	捶 搥 𥴓	
管	筦 菅 𥭨 𱷺	
箦	簀	
箧	篋 𱷶	
箨	籜	
箩	籮	
箪	簞	
箫	簫 簘	
箬	篛	
箭	𥰸 翦 𥲫 𥳭 𲶙 𥮙 𲶡	
箯	𥲼	
箱	葙	
箳	簈	
箴	針 鍼	
箶	𥬏 䩴	
箸	筯 著 𱷲	
箹	𥬓 𰩺	
箽	𥳘	
箾	簫 簘	
節	节 兯 𢎟	
篃	䉋 𥴔	
範	范	
篅	𥳙 𥬵	
篆	𡩀 蒃	
篇	𳄺	
築	筑 𥭰 𥯹 𥴀 𥰺 𥵭 𥲒 𥴁 簗	
篋	匧 箧 𲦍	
篌	𥰉	
篍	𥰂	
篎	𥰚	
篑	簣	
篓	簍	
篔	筼 䉙	
篘	𥬠 醔 𥰞 𨡲 𥭛 𲆶	
篙	㰏 籇 𥮑	
篛	箬	
篝	𥱏 𥲙 𥯿 𥵡 簼	
篞	𥭧	
篠	筱 筿 𥴽 𥭸 𥭪	
篡	簒	
篢	槓 𬕂	
篤	笃 䔍 笁 竺	
篦	笓 箆	
篧	籱 籗 𥷮	
篩	簁 簛 筛	
篪	竾 箎 𥬌 筂 𥳠 𪛍 𪛔 𥰽 䶵	
篫	𲶁	
篭	籠 笼	
篮	籃	
篯	籛	
篰	𥰵	
篰	𲶂	
篱	籬	
篲	彗 𥶙	
篳	筚 𥴂 蓽	
篴	笛 𥴦 𥳤	
篵	𥬈	
篷	竼 𥴣 𦪪 𨎳 𥭗	
篸	𥳋 𥱄 𥸢 撍 𥶟 𥮾	
篹	𥶊 𥲻	
篺	棑 𦴝 𥱼	
篽	𥷉 𦼼 𠏣 𩵎 蓹 籞 𥷲	
篾	𥴸 𥯣 䈼 𰰬	
篿	𥮔 𰩮	
簀	箦 𤖓 𥴹 𲶩	
簁	篩 簛 𥳧 籭	
簂	䈐 槶 𫂆	
簈	箳	
簉	䔏 𲶊	
簊	𥫠 𥫶	
簋	𥁬 匭 㔲 𣪕 𣌽 㔳	
簌	雝	
簍	篓	
簎	𥶪	
簏	箓 𳊩	
簑	蓑 簔	
簒	篡	
簔	蓑 簑	
簕	竻 𱾐	
簖	籪	
簘	簫 燒 焼 箾 箫	
簙	𥴮 𥴾 𱸪	
簛	篩 簁	
簜	𰩹 𥯕	
簝	𥵐 𮵫	
簞	箪	
簟	𥸖	
簠	盙 𦻌 𧁔 𠤳 𠤱	
簡	耕 简 𥳑 蕑	
簢	𫂃 𥵴 𥴲	
簣	蕢 籄 篑	
簥	𰩸	
簨	栒 𥬷 𥬹 𥯗	
簩	𱸇	
簪	𬖂 𥸢 簮 𠒀 𥯓 兂	
簫	簘 燒 焼 箾 箫 𪛕 𪛖	
簬	簵 𥸐	
簳	筸 𱸫	
簵	𰪏	
簶	𩌫 䩮	
簷	檐 𤖝	
簸	𲧮 𲲌	
簹	筜	
簻	檛 𥴪 𰩻	
簽	签 籤 籖	
簾	帘 𢅏 𢅖	
簿	薄	
籀	籒	
籁	籟	
籃	箖 篮 𢉧	
籄	簣 蕢	
籅	𥰩 𥷔	
籆	篗 𧤯 䈅 籰	
籉	𥱆	
籋	𥬞	
籌	筹 𥵽	
籍	𥷸	
籐	籘 藤	
籑	饌 䉵	
籓	䉒 𥶋	
籔	藪 薮 䉤 𥯴 𥰞 䈹	
籖	籤 签 簽	
籗	𲵵	
籘	籐 藤 𱸱	
籙	箓	
籚	𰩲	
籛	篯	
籜	箨 𥷘	
籟	籁	
籠	篭 笼 𪚖 𦌼	
籢	𲶓	
籣	𮆏 韊 䪍 𲊡	
籤	签 籖 簽 𥷪 揃 𥵞 䉔	
籥	龠 𱰓	
籦	𰪊	
籩	笾 𠥣 𠥫 𥸅 𨘚	
籪	簖	
籫	𬖃	
籬	篱	
籭	𬕄	
籮	箩	
籯	𥯰 籝 𰪣	
籰	篗	
籲	吁 龥 𥸤	
米	𡭝	
籴	糴	
籸	籶 𤽰 䊁 𲋔	
籹	𥹡	
籺	𥝖 𥸽	
类	類	
籼	秈	
粃	秕	
粄	䬳 𥹎 䉽 𥽴	
粈	𩚖	
粊	𥺘 𥽑 𥼠 䉾 𥺟	
粋	粹	
粒	𩚷	
粕	𨠘	
粖	𩱵 𩱸 𥽘 𩱷	
粗	觕 麤 麁 麄 麆	
粘	黏	
粛	肅 肃	
粜	糶	
粝	糲	
粞	𥻏 𱹊	
粟	䅇 𥻆 𠧼 𥹟 𥾄 𥸫	
粢	𪗉 𥻓 𥸷 秶	
粣	𥹤	
粤	粵	
粥	鬻 𩱟 𥺞 𱧝	
粦	燐 㷠	
粧	妝	
粪	糞	
粫	糯 稬 穤	
粮	糧	
粯	𬖑	
粱	𥹭 𥞹	
粲	𥹏 𡛹 𥺤 𲥿	
粳	稉 秔	
粵	粤 𡩭 𦉿	
粶	𥼙	
粸	𪍀	
粹	粋	
粺	𥽚 𥺛	
粻	餦 𰪭	
粼	𣃌 斴 𤏞 𱴢	
粽	糉 糭	
精	䊒	
糁	糝	
糅	粈	
糇	餱	
糈	𩰠 𥺸 𥚩 𥺳	
糉	粽 糭	
糊	𪏹 䊀 𪍒 𩰯 𪏻 𪐉	
糌	𳋚	
糏	𪍛 𲷙	
糒	𥼉 𩜗 𪍞 𪌾 𥼓 𥺢	
糓	穀	
糕	餻 𱹘	
糖	餹 𥼽 饄 糛 餳 𥽻 𰪩	
糗	𥽃 𥽙 𩝠	
糙	㿷 𥽹	
糜	𩞇 𩞁 𢌑 𪎖 䊳 𱹍	
糝	糁 䊏 𥻕 𥼾 𩞼 䊉 𥹠 糣 𩞀 糂	
糞	粪 𥻰 𥼈 𥻎 𨤚 𤲲 𥻔 𥼇 𱹛 𲦵	
糟	醩 𥽾 𨤇 𨠷 𦵩 𨤈 𨣹 𮇘	
糠	穅 粇 𥹺 𢊪 𱹧 𲵝	
糡	糨	
糤	馓 饊	
糧	粮 𥣷	
糨	糡	
糩	𱸾	
糪	𥽷	
糭	糉 粽	
糮	𥽏 𥼿 𬖮	
糯	粫 稬 穤 𥻟 𥼥 糥 𲷗	
糰	䊜 𰪶 𥻁	
糱	糵 𪎃 𪌊	
糲	粝 䊪 𥻃	
糴	籴 䨀 𥣞	
糵	糱	
糶	條 粜 𥽀 𥺋 𲒢	
糷	𥽼 𥽭 𥻂 𰫖	
糸	糹 絲 纟 幺 𢆯	
糹	糸 絲 纟	
糺	糾 𫄙	
系	繫 繋 係 𣫦 𦃟 𢁴 𦂞	
糽	𰫼	
糾	糺 纠 𥾆 𢎥 紏 𤓱	
紀	纪 𥿓	
紁	𮵿	
紂	纣 𩋰	
紃	𥾡 𥾖 𬘓	
約	约 𠣩	
紅	红	
紆	纡 䊸	
紇	纥 𥾨	
紈	纨 䊵	
紉	纫 𥾠	
紊	𱹭	
紋	纹	
紌	𬘕	
納	纳	
紐	纽 靵	
紑	𰫽	
紒	𰬀	
紓	纾 䋒 䋡 忬 悆	
純	纯 㝄 𠄤 䊷 𥾑 𥾒	
紕	纰 㩺	
紖	纼 𦄘 靷 䊶 絼	
紗	纱 𦀟 𦀛 㠺	
紘	纮 紭 綋	
紙	帋 纸 𦀦 𥾬	
級	级 𨸚	
紛	纷 𱽰	
紜	纭 𧶊	
紝	纴 絍 𲷺 䋕 𲷻 䋻	
紞	𥾚 𬘘	
紟	衿 𦁌 䋮 𫄛	
素	𦃃 𦁘 㕖 𩝥	
紡	纺	
索	𡩡 𥿟 䌇	
紤	𱺓	
紥	紮 扎	
紧	緊 𮵾	
紨	𰬅 𦇁	
紩	鉄 𮉢	
紬	綢 䌷 䌧	
紭	𰬋	
紮	紥 扎	
累	纍 𤳻 𤴈 絫 厽 叅	
細	细 𥿳	
紱	绂 𥾧 𥿈	
紲	絏 緤 绁 𦁛 𥾰	
紳	绅 𣃵 𦁴 𩉼	
紵	纻 𦇃 𦂂 𦅷	
紶	𬘛	
紸	𰬇	
紹	佋 绍 𥿨 𢇊 綤 𦀧	
紺	绀	
紼	绋 𦂓 𩎛 𥿏 綍	
紽	𰬉	
紾	𥿜 𬘝	
紿	绐 緿	
絀	绌 黜	
絁	䌤 𫄟 䌳 𦇲 𦇼 𦂛	
終	终 𤯚 𢍐 𠔾 𠂂 𤽬 𤽘 㣠 𣊂 𦄖 𡦿 夂 𣈩 𣧩 𦤒	
絃	弦 𲸃 𰬈 𲹪	
組	组 䋎	
絅	褧 䌹 𢄗 蘏 綗	
絆	绊 靽	
絇	𡱺 𡳍 䋧 𰬆	
絋	纊 絖 纩	
経	經 经	
絍	𫟃	
絎	绗	
絏	紲 緤 绁	
結	结 紒 𥾫 𡚌	
絑	𰬏	
絓	𮉤	
絕	絶 绝 𢴭 𢇍 𢇑 𢱺 𠤉 絁 撧 㔃	
絖	絋 纊 纩 𬘢	
絘	𥿩 𰬒 䊻	
絙	𫄠 𦀞 絚	
絚	緪 縆 𰬌 絙	
絛	縚 绦 𠍞 縧 幍	
絝	褲 绔 綯 袴 裤 绹	
絞	绞 䋂	
絟	𬘥	
絠	𬘠	
絡	络 𦃅 𦃆	
絢	绚 𥾡 𦃜	
絣	𢆸 𰬔 𱹹	
絤	𬘟	
絥	鞴 𩎧 𩊙 𫄢 𩎓	
給	给	
絧	𫄡	
絨	绒	
絪	氤 𬘡 緸	
絭	𨤙 𡈢	
絯	𰬓	
絰	绖 𦥅	
統	綂 统 𦀠	
絲	糸 糹 丝 纟 𢇁	
絳	绛 𥿸	
絵	繪 繢 绘 缋	
絶	絕 绝	
絷	縶 𱹽	
絸	𬘖	
絹	绢 𦁆	
絺	𫄨	
絻	𰬜 𦂔 㡈	
絼	𰬛	
絽	𬘤	
絾	𰬖	
絿	䊵 𰬗	
綀	𦈌	
綁	绑 𦆫	
綂	統	
綃	绡 𦂚 䌃	
綄	𬘫 𦆼	
綅	𰬞 𦃌	
綆	绠 𥾚 䌄 𥿒 䋁	
綇	𦈋	
綈	绨	
綉	繡 繍 绣	
綊	𰬍	
綋	𫟄	
綌	绤 𥿭 𦃁 𢂲 𦃛	
綍	𰬘	
綎	𬘩 𦂃 䩠	
綏	绥 𦁉	
綐	䌼	
綑	捆 裍	
經	経 经 𦀇 坕 𤔕 𤔊 𲣄	
綔	𦁝	
綕	𬘨	
綖	𫄧	
綘	𮶂	
継	繼 继	
続	續 续	
綜	综	
綝	𬘭	
綞	缍	
綟	𫄫	
綠	緑 绿 氯 𢅞	
綡	𫟅 𦂠	
綢	紬 绸	
綣	绻	
綥	帺 𦁰	
綦	璂 𥾎 𥾻 𥾦 綨	
綧	𬘯	
綩	𥿎	
綪	𬘬	
綫	線 缐 线	
綬	绶	
維	维	
綮	䋯 䋜 𦄊	
綯	褲 絝 绔 袴 绹 裤 𦃥 𥿐	
綰	绾	
綱	纲 𦂴 㭃 䌉 𣓡	
網	网 𲒄 罖 𦁒 䋞 罔 䋄 𦋟	
綳	繃 绷	
綴	缀 𧚰	
綵	䌽	
綶	𦆪	
綷	𮉬	
綸	纶 𥿑	
綹	绺	
綺	绮	
綻	绽 䘺 袒 䋎	
綼	𰬤	
綽	绰 𦅕 繛 𦈀	
綾	绫	
綿	緜 绵 𤾜	
緀	𰬢 紪	
緁	𦆍 𰬡 䌌	
緂	𰬧	
緄	绲	
緅	𮉪	
緆	𪎧 𰬣 𪎥	
緇	缁 繢 𥾒 𦄛 𦁃 䊷 𦃠	
緈	𦂜 𦃉 𦃱	
緉	𮉧 䩫	
緊	紧 𦂳 𲷾	
緋	绯	
緌	𮉫	
緍	𦈏	
緎	𪑝 𩎹 𦎘 𰬟 𩋉	
総	总 總 緫 縂 摠 揔 搃 捴 𰬥	
緐	繁	
緑	綠 绿	
緒	緖 绪	
緓	绬	
緔	绱 鞝	
緖	緒 绪	
緗	缃	
緘	缄	
緙	缂 𢃲	
線	綫 缐 线 𦂷 絤 𦇫	
緛	䙇 𬘰	
緜	綿	
緝	缉 𦂝	
緞	缎 縀	
緟	𦅅 褈 𫟆 𱺉	
締	缔	
緡	缗 䋋 緍 罠 𲇧	
緢	𰬬	
緣	縁 缘 𦄘	
緤	紲 絏 𫄬 𲸛	
緥	褓	
緦	缌 𦃞 𢆿 𢇆	
緧	䋺 鞧 𬘶 𦂏 𦃈	
編	编	
緩	缓 𦅻 𦇻	
緪	絚 縆 𬘵 絙	
緫	总 總 縂 総 摠 揔 搃 捴 𰬰	
緬	缅 𥿶 𥾝	
緮	𲞲 𫄭	
緯	纬	
緰	𦈕	
緱	缑 𦂐	
緲	眇 缈 𳆐	
練	练 𱺧	
緵	𦆛 𰬯 䍟	
緶	缏 𦄱 𦄒	
緷	𦈉 𧞢	
緸	𦈑	
緹	缇	
緺	𮉨	
緻	致 𦤶 𰬫	
緼	縕 缊	
緾	𱺦	
縁	緣 缘	
縂	总 總 緫 総 摠 揔 搃 捴	
縄	繩 绳	
縆	絚 緪 𬘵	
縈	萦 𢄋	
縉	缙 𦇢	
縊	缢	
縋	缒 䋘	
縌	𰬳 𥿬	
縍	𫄰	
縎	𦈔	
縐	皺 绉 䋓 𥿷 𦆜 𥿲	
縑	缣	
縒	𦆧 𦇈 𦄙 𬘷	
縓	𰬲 𲎖	
縕	緼 缊	
縖	𬘻	
縗	缞 䙑	
縚	絛 𬘺	
縛	缚	
縜	𰬚	
縝	缜 𦁄	
縞	缟	
縟	溽 缛 𣯋	
縡	𰬴	
縢	𦅌 𦂙	
縣	𲸋 县 𲈩 𡈴 𮚄 𮚇	
縦	縱 纵	
縧	绦 𮶃	
縩	𮉯	
縪	𰬎	
縫	缝 綘	
縬	𦈚 𦇰 𦂎 𦄉	
縭	褵 缡	
縮	缩 𣩐 𦄲 𲸗	
縯	䌥 𬙂	
縰	𦁡 𫄳	
縱	縦 纵 𦆬 𦄚 𥾺 𥾞 𦂵	
縲	缧 纝 絫 𦅍	
縳	䌸 𦁆	
縴	纤 𰬮	
縵	缦 𦆅	
縶	絷 𦅬	
縷	缕	
縸	𫄲	
縹	缥 𦆝 𦇳	
縺	𦈐	
縻	𥿫 䌕 𦄐	
縼	𦀢 𢳄 𰬵	
總	总 緫 縂 総 摠 揔 搃 捴 𢰾 揌 𦀙 𩮀 惣 㹅 𥾜 㧾 𠂳 𦁕 𤙹	
績	绩 𦄗	
縿	襂 𰬪 𧛡 𱡸	
繀	𮉮	
繁	緐 䌓 𥿋 𦃍 䋣 𦅳	
繂	𫄴 𦆽 𦆾	
繃	綳 绷 𦇜 䙀 䙖 𧚸	
繅	繰 缫 縿 𦅒 𦃐 𦃨	
繆	缪	
繇	𦅸 𧪬 𦅹 䌊 䌛	
繈	繦 襁 鏹 𫄶	
繊	纖 纎 纤	
繋	繫 系	
繍	繡 綉 绣	
繎	𬙇	
繏	𦈝	
繐	𦄑 𰬸 𬜨	
繑	𰬐 𦃣	
繒	缯 𦀓 縡 𲻩	
繓	𦈛 𦄎	
織	织 𦁓 𦁋 綕 𦃎 𥿮 𦀗	
繕	缮 𦆶 𦆏	
繖	傘 𦇕 𰬷	
繗	𬙈	
繘	𦈇 𰬻 𦇹	
繙	翻 飜 𬙆	
繚	缭 𦄗 𦆖	
繛	𦅕 𦈀 綽	
繜	𰬺	
繞	遶 绕	
繟	𦈎	
繡	繍 綉 绣 𰬩	
繢	繪 絵 缋 𦇣 𦇅 𦆠	
繣	𰬠 𲸣	
繦	繈 襁 𫄶	
繨	𫄤	
繩	縄 绳 䋲 𦃰 𨭘	
繪	絵 繢 绘	
繫	繋 系 縘 𲛻	
繬	𫄱	
繭	茧 𦇂 絸 蠒 𧀇	
繮	韁 缰	
繯	缳 𦇏	
繰	繅 缲	
繲	挫 𰬽	
繳	缴 𦅾	
繴	𦂟 𦌠	
繵	𬙉	
繶	𫄷	
繷	𫄣	
繸	䍁 𩍚 𦂁	
繹	绎 𦆎	
繻	𦈡 𦅎 𦅏 𢄼 緰	
繼	継 继 𦇓 㡭 𦁚	
繽	缤 𦆯	
繾	缱 𦇶	
繿	襤 褴 䍀	
纀	𰬿 𦄾	
纁	𫄸 䙧 䌲	
纂	𦆈	
纃	𬘧	
纅	𦇬	
纆	𦅔 𬙊 𦄿	
纇	颣	
纈	缬	
纉	纘 缵	
纊	絋 絖 纩	
纋	𰭀	
續	続 续 賡 𲟌	
纍	累 𦇄 絫	
纎	纖 繊 纤	
纏	纒 缠 緾	
纑	𮉡	
纒	纏 缠	
纓	缨	
纔	才	
纕	𬙋	
纖	纎 繊 纤 砌	
纗	𦆈 𫄹	
纘	纉 缵	
纙	𲸱	
纚	𫄥 縰	
纛	𦑢 𢃶 𦇨 𱜕	
纜	缆 䌫	
纝	縲	
纟	丝 糹 糸 絲	
纠	糾	
纡	紆	
红	紅	
纣	紂	
纤	縴 纖 纎 繊	
纥	紇	
约	約	
级	級	
纨	紈	
纩	纊 絋 絖	
纪	紀	
纫	紉	
纬	緯	
纭	紜	
纮	紘	
纯	純 𲍭	
纰	紕	
纱	紗	
纲	綱	
纳	納	
纴	紝	
纵	縱 縦	
纶	綸	
纷	紛	
纸	紙	
纹	紋	
纺	紡	
纻	紵	
纼	紖	
纽	紐	
纾	紓	
线	綫 線 缐	
绀	紺	
绁	紲 絏	
绂	紱	
练	練	
组	組	
绅	紳	
细	細	
织	織	
终	終	
绉	縐 𮶆	
绊	絆	
绋	紼 綍	
绌	絀	
绍	紹	
绎	繹	
经	經 経	
绐	紿	
绑	綁	
绒	絨	
结	結	
绔	褲 絝 袴 綯 裤 绹	
绕	繞	
绖	絰	
绗	絎	
绘	繪 絵	
给	給	
绚	絢 𱺆	
绛	絳	
络	絡	
绝	絕 絶	
绞	絞	
统	統	
绠	綆	
绡	綃	
绢	絹	
绣	繡 繍 綉	
绤	綌	
绥	綏	
绦	絛 縧	
继	繼 継	
绨	綈	
绩	績 𱺊	
绪	緒 緖	
绫	綾	
绬	緓	
续	續 続	
绮	綺	
绯	緋	
绰	綽	
绱	緔 鞝	
绲	緄	
绳	繩 縄	
维	維	
绵	綿 𱜪	
绶	綬	
绷	繃 綳	
绸	綢	
绹	綯 褲 絝 绔 袴	
绺	綹	
绻	綣	
综	綜	
绽	綻	
绾	綰	
绿	綠 緑	
缀	綴	
缁	緇 𱹼	
缂	緙	
缃	緗	
缄	緘	
缅	緬 𰬄	
缆	纜 𰬊	
缇	緹	
缈	緲	
缉	緝 𲁀	
缊	縕 緼	
缋	繢 繪 絵	
缌	緦	
缍	綞	
缎	緞	
缏	緶	
缐	線 綫 线	
缑	緱	
缒	縋	
缓	緩	
缔	締	
缕	縷	
编	編	
缗	緡	
缘	緣 縁 𰫾	
缙	縉	
缚	縛	
缛	縟	
缜	縝	
缝	縫	
缞	縗	
缟	縞	
缠	纏 纒	
缡	縭 𱜴	
缢	縊	
缣	縑	
缤	繽	
缥	縹	
缦	縵	
缧	縲	
缨	纓 𰬕	
缩	縮 𲄉	
缪	繆	
缫	繅	
缬	纈	
缭	繚 𱺑	
缮	繕	
缯	繒	
缰	韁 繮	
缱	繾	
缲	繰	
缳	繯	
缴	繳 𲉣	
缵	纘 纉	
缶	罐 鑵 礶 缻 𦈢	
缷	卸	
缸	罁 堈 𤭛 𤭺 㼚	
缹	炰 𤈣 𤈒	
缺	𡚆 𦈫 𧖫 𡙇 𱖶 𱛑 𮰓 𲸲	
缻	缶	
缽	鉢 钵 𥁅 盋	
缾	瓶 甁 𦉇 䍈 𲸶	
罁	堈 缸	
罂	罌	
罃	罌 甖 鎣	
罄	𥥻	
罅	𨻲 㙈 𤗭 𧇍 𤗑 𥕕 㙤 𦉏 𳃥 鏬 𱗫 𱴭	
罆	𰭄	
罇	墫 樽	
罈	墰 壜 坛 埮 罎 墵 𤮦	
罋	甕 瓮 𦉥	
罌	罃 甖 罂 𦉦 甇 𲧶	
罍	鑘 𦉩	
罎	𱺱 𲇬	
罏	𧇄 𧆣 𤴅 𧆨 𬙎 𧈕 𤮧	
罐	鑵 礶 缶 罆 𲣩	
网	罒 罔 網 㓁 𦉯 𦉪 𦉸 𦉳 𠕃 𦉮 冈 𠕈 𦉫 𦌅 𱻆	
罒	网	
罔	惘 网 𡔞 冈 㒺 𦉸 𡦽 𡧏	
罕	𦉻 䍑 䍐	
罗	啰 羅 囉	
罘	罦 𦊾 䍒	
罚	罰 罸 𱺹	
罛	𦊶 𦋆 𦊡	
罜	𦉷 𦊝 𦌷	
罝	𦋽 𦊕 𦊩 𦋾 𦊨 𱻅	
罟	䇢 𦊖 𦊟	
罠	𦊞 䋋	
罢	罷	
罥	羂 䍗 𦌾 𲺡 𲸾	
罦	罘 𦋵 𦊠 𦋄 䍖	
罧	𦋗 𦌀	
罨	𦋙	
罨	𲢹	
罩	䈇 箌 䍜 𦋇 𥵤 籱 𩷹 𠟅 𦋚	
罪	辠 𡈚 𦋛	
罫	𦁊 𥦛	
罬	𦋖	
罭	䍞	
置	寘 𦌃 𦋲 𦌤 𦋽 𢍧 𣇣 𦌖 𦋘 𰭋	
罯	𦋫	
罰	罸 罚 𠟑 𠟟 𦋬 𲹀	
署	𦋧	
罳	𦋾 𦋮	
罴	羆	
罵	駡 傌 骂 𠺎 𦋻 𩡿 嗎	
罶	羀 𦊗 𦊿 𦌁 𦌑 𦊑	
罷	罢 𦋼 𧟽 𮊒 𮊓 𱺸 𲅖	
罸	罰 罚	
罹	𦌐	
罺	𥷮	
罻	𦌨 𦌍	
罼	𬙝 𦌂 𦌎	
罽	𦌓 𦌞 𦌗 𣯅 𦋴 𦋋	
罾	𦌝	
罿	𦌜	
羀	罶	
羁	羈 羇 覊 覉 𱻈	
羂	罥 𰭔	
羃	冪 鼏 冖 𥵵	
羅	囉 罗 罖 𦋝 𦌴	
羆	罴 𥀡 𥀍 𦌲 𥀦	
羇	羈 覊 覉 羁	
羈	羇 覊 覉 羁 𦍈 𧠄 𦌭 䩭 𦍊 𩆺 𦋱 𦌱 𳊠	
羊	𦍌 芉 𢆉 𦍋	
羋	芈 芉 吀 哶 𦍋 嘪 咩 咪	
羌	羗 猐 𦍎 𡸓 𠒌 𡹽	
羍	𦍒 𦍐	
美	羙 嬍 𳁵	
羑	羐 羗	
羓	豝	
羔	𦎴 𦏠 𦍚 羙	
羕	𦍛 𱻌	
羖	𦍩	
羗	羌 𱻎	
羙	美	
羚	麢 䴫 𦏰 𪋪 𦏪 𳐼 𳑄	
羜	𬙯	
羝	牴 𦍿 𦍞 𦍝	
羞	𦍟	
羟	羥	
羡	羨	
羣	群	
群	羣 𠹩 䭽 𡲻	
羥	羟 𦎺 𦎥 𲹅	
羨	羡 𠿢	
義	义 羛 乂 𱽺	
羫	𤟄	
羬	麙 𦏣	
羮	羹	
羯	𦍨	
羱	𦍘 𦍼	
羲	𢐯 𦏡 𦏁	
羴	羶	
羵	𫅗	
羶	羴 𦏭 𦏫 䍹 膻	
羸	𦣉 𦏝	
羹	羮 𩱋 𢑌 𩱧 𩱁	
羺	𦎀 𩍄 𦏌	
羼	𱛃	
羽	𦏲	
羾	𦏼 𦏺 𱻡	
羿	𢏖 𦐧 𢏗 𢏘	
翀	𮶋 𮶍	
翂	𣸜 𦐈	
翃	𦐌 翝	
翄	翅	
翅	翄 㲍 翨 𦑧 𦐊 翤 𱻘 𲥘	
翆	翠	
翇	𦐗 𦐓	
翋	𦒆	
翍	𦐢 𣬼	
翎	𱢸 𮋔 𳊻	
翐	𣺐	
翑	𦐛	
習	习	
翔	鴹	
翕	𦐬 翖	
翘	翹 𮶌	
翙	翽	
翚	翬	
翛	𦐻	
翜	𰭢	
翠	翆 𦐜	
翣	菨 𮱀	
翥	䬡 𦑥 䎝	
翦	剪 𦑦 𦑳 𦒕	
翨	𦑧	
翩	鶣	
翪	𦑨 𪃊	
翫	𠐢	
翬	翚 𦑩	
翭	𦑤 𦑚 翵	
翮	𦒏	
翯	𩫉	
翰	𩙶 𠣍 𩙴 𳏯 鶾 𳐑 𪂂 𳐍	
翱	翺 翶 𦒢	
翳	𦒭	
翵	𪄊	
翶	翱 翺	
翷	𦒪	
翸	𱻞	
翹	翘 𦒒	
翺	翱 翶	
翻	繙 飜 𢑵 拚	
翼	𦒖 𩙺 𦏵 𦐂 䋚 𮊾	
翽	翙	
翾	𦒬 𩙽 𦐽 𦑉 𦑰	
翿	𦒯 𦐩 𦒇 𦒛 𣫟 𰭣	
耀	曜 燿 㿢	
老	耂 𠄰 𦒳	
耂	老	
考	攷 𦒱 丂	
耄	𦿗 𦽡 𣮳 𦒷 𦹾 𦓄 𧂕 㿞 𣭢 𩲘	
耆	𨚻 𥄥 𦓀 𱻪 𱻭	
耇	耈 耉	
耈	耇 耉 𱻭	
耉	耇 耈	
耊	耋	
耋	耊 𨊆 臷 𨊁	
耎	䎡	
耏	耐 𦓘	
耐	耏 𡬪 𦓎 𩈃 𱚠	
耑	專 専 𱻱	
耒	𣐇	
耔	秄 𱙻	
耕	簡 畊 𦓮 𣚣	
耗	秏 㘪	
耘	秐 𦓷 𦶮 𦔐	
耙	鈀 䎱 𲶉	
耚	𤱍	
耜	𦓵 㭒 䎣 𦓨 𮲯	
耠	𦔏	
耡	鋤 鉏 锄 耝	
耢	耮	
耤	藉 𦔢 𦔡	
耧	耬	
耨	鎒 䅶 𦔘 槈	
耩	𥠾	
耫	𱻴	
耬	耧 䅹 𦔪	
耮	耢	
耰	櫌	
耴	䎲 𦕿	
耸	聳	
耻	恥	
耼	聃	
耽	躭 𳃳 眈 𤯉 𧴸 𦕍	
耾	𦕹	
耿	炅 炔 炛 𤓐	
聂	聶	
聃	耼 𨈭 𨈜 𣅧 𦕐	
聄	𦕑 𦕇 𦕗	
聆	䠲	
聊	𦗖 𦕼 𦕵 𦖂	
聋	聾	
职	職	
聍	聹	
聎	𦖅	
聏	𥅡	
聒	𦘉 𠅪 咶 𦗦 𨈸 𦕾	
联	聯 聨 聫 聮	
聖	垩 堊 圣 𡑺 𡉄 𨲚 琞 𠄵 𦕡 𥅶 𤦨 䎴 𨲢 𮴡	
聘	𡞐 𨊀 𨉂 𨉯 𦕊	
聚	𨞮 𨛿 𳅅 鄹 𧅞	
聝	馘 𢦛	
聞	闻 䎽 𦕁 𦔵 𦖫 𦕌 𥹢 䎹 𱚘	
聟	婿 壻	
聡	聰 聦 聪	
聦	聰 聡	
聨	聫 聯 聮 联	
聩	聵	
聪	聰 聡 𱻾	
聫	聨 聯 聮 联	
聮	聨 聫 聯 联	
聯	聨 聫 聮 联 𦕱 䏈 𦘈 𦖹	
聰	聡 聦 聪 𦕻 𲺀	
聱	𦗷	
聲	声 殸 𠴢	
聳	耸 𢕈	
聴	聽 聼 听	
聵	聩 䠿 𳂐 𦗥 𦘄 𦖥 𦘋 𦘃	
聶	聂	
職	軄 职 聀	
聸	𦗯	
聹	聍 𨊎 𨊓	
聻	魙 𫆏 𦗚	
聼	聽 聴 听	
聽	聴 聼 听 𪢧 𦕘 𦔽 𦕢	
聾	聋 𦗤 䏊	
聿	肀	
肀	聿	
肂	𱥓	
肃	肅 粛	
肄	𨽹 𧲁 𢄥 𦘞 𥏚 𢑩	
肅	粛 肃 𦘝 𦘛 𢙻 䏋	
肆	四 銉 𢑨 𩬶 𦘨 𨽸	
肇	肈 𢾹 𦘟 肁 𱻿	
肈	肇	
肉	宍 𡧢 𠕎 𱼀	
肋	𦟯	
肌	𩨒	
肐	胳 𩨘 𦘸 𦙊	
肒	𤴯 𤼐 𦘾	
肓	𦘻	
肕	韌 靭 靱 韧 𦨔	
肗	𦘽 𱙊	
肘	䏔	
肙	䏍	
肚	䐗	
肛	𤵻 㠮	
肝	𲺅 𭨩	
肠	腸 膓	
股	脵 𦙶 𦚂	
肢	胑 𨈛 𩨵 𨈪	
肣	𦛜	
肤	膚	
肥	𦘺	
肧	胚	
肨	胮	
肩	𦚑 𡱎 𦙪 𲂩	
肪	𩨣	
肫	𦙛	
肬	疣	
肭	𦜬	
肮	骯	
肯	肻 𦙡 𦘫 𠕔 𣍟 肎	
肰	𥇃 𦛦 𦝸 𦛡	
肱	厷 𠃋 𠫔 𡿨 𠬟 𦙶 𲄦	
育	𣫺 袬 毓	
肳	吻	
肴	餚 𦙩 𦜂 𦜚 𦘬 𲌹	
肸	肹 𲤐 𮶕	
肺	𦛎	
肻	肯	
肾	腎	
肿	腫	
胀	脹	
胁	脅 脇 𱼊	
胃	𦛂 𦞅 𦝩 𲐸	
胄	冑 伷 冐	
胅	𦝯 𩨰 䏲	
胆	膽	
胇	𦕚 䏟	
胈	𤕳 𥥛	
胊	朐 鴝 鸜 𠣪	
胋	䏦	
背	𧶙 𱏇	
胎	囼 孡	
胏	𦙰 𦛎 𡋜 𦚙 𦚘 𦚮	
胐	朏	
胑	肢	
胓	𦚓	
胔	骴 𦚚 𦙼	
胕	𦝗	
胖	𦚓 眫	
胗	疹 𦜌 𦙳 𤷌	
胘	𦘷	
胙	𦙐	
胚	肧 衃 𦙂 妚 㚰	
胜	勝	
胝	郅 疷 𤵋 𦙘 𦙁 𦙠	
胞	脬 𦚽	
胠	𦚒 𦛕 𦚁	
胡	衚 𳀚 鬍 𩑶 𡋞	
胣	肔	
胤	𦛬 𠉥 𤗅 𦞩 𦙍	
胥	𦙃	
胧	朧	
胨	腖	
胪	臚 髗	
胫	脛	
胭	臙	
胮	肨 𤵸 膖	
胯	骻 趶 𡱼 𦚬	
胳	肐 骼 𩨘 𦛃	
胵	腟	
胶	膠 㬵 𱐥	
胷	胸 匈	
胸	胷 𦙄 𦛄 𦚍 匈	
胹	𩰴 𦓒 𥅡 𦓠	
胺	𦛅 𳅔	
胼	腁	
能	𦝕 䏻 𱼑 𫧇	
胾	𦛹	
脀	𦚦 𦞪 𦛫	
脂	𱼈	
脃	脆	
脅	脇 胁 𦛕 䏩	
脆	脃 膬	
脇	脅 胁	
脈	脉 衇 𧖹 𧖴 䘑	
脉	脈 衇 䘑 𱧴	
脊	𦟝 𦠗	
脍	膾	
脏	髒 臟 臓 𱼝	
脐	臍	
脑	腦 脳	
脓	膿	
脔	臠	
脗	䐇	
脘	𦜐	
脙	䏫 𦜵 𤶩	
脚	腳	
脛	胫 踁 𨂈 𲤛	
脞	𢏬	
脟	𦛷	
脠	𦚺	
脢	脄 𩨿 胟	
脣	唇 𦟢 䐇 䫃	
脤	𦚠	
脥	𣍰	
脧	朘 䘒 𡱥 𧗔	
脩	𠋛	
脪	㾙 𤴾 𦢯 𦜓	
脫	脱 挩	
脬	胞	
脰	䐍 𦣓	
脱	脫 𱺄	
脲	尿	
脳	腦 匘 脑	
脵	股	
脶	腡	
脸	臉	
脹	痮 胀 瘬	
脽	𦞠	
脾	𦜠	
腁	胼	
腃	𦝘 𡸩	
腄	𦡘	
腆	𣇺 䐌 𥵶 㙉 𥳫 𥶚	
腊	臘 臈 𦝙 𱵻	
腌	𦜽 𦟩 𦛞	
腎	肾 𦚠	
腐	𢋲 𣩇 焤 𢉶	
腔	𤟄 羫 𳊰	
腕	𦙵 𢫪 捥 𢮗 𥆶 𢯲 𢮘	
腖	胨	
腘	膕	
腟	膣	
腡	脶	
腢	髃	
腣	䐭	
腤	𦝡	
腥	𱹏	
腦	脳 匘 脑 𦠤 𩩀 𦞄 𦠊 𠜶 𦛁 𦝶 𦛳 𱑄 𲾖 𳈦	
腧	𲌐	
腨	𨄔 𳃰 𲤥	
腩	𨡯 𦝧	
腪	𣍯	
腫	尰 肿	
腬	䏔	
腭	齶 𱼛	
腮	顋	
腯	𦝬	
腰	𦝫	
腱	𦞬 䇟	
腳	脚 𦛶 踋	
腴	𣧴 𣨃 𦚤	
腸	膓 肠	
腹	𦞶	
腻	膩	
腼	靦	
腽	膃	
腾	騰 𱅑	
腿	骽 蹆	
膀	髈 𦜶	
膁	𤑃 𦡶	
膂	膐	
膃	腽	
膆	嗉	
膇	㾽	
膈	䐙	
膊	𦣈 𦢸	
膋	膫 䒿	
膌	𦢕 㾊 脨	
膍	肶	
膏	𥆕	
膑	髌 臏 髕	
膒	𬁵	
膓	腸 肠	
膕	腘 𩪐	
膘	臕 𦣁	
膙	𢐩	
膚	肤 𦢚 𤺧	
膜	𦟦	
膝	𦡀 厀 䣛 𦡩 𦜔	
膞	䏝	
膠	胶 㬵	
膢	𦝼	
膣	腟	
膥	𱼚	
膧	𧬖 𩪘	
膩	腻 𦡸 胒 𧸉 㒃	
膫	膋	
膭	𱼏	
膮	𰮝	
膰	𥛮 㸋	
膳	饍 𳋱 𮜖 𪱋	
膴	𰮇 𦣌	
膶	𬂀	
膷	𰮅	
膸	髓 髄	
膹	𪱥 𦡛	
膺	𩪠 𦢖 𦢻	
膻	胆	
膽	胆	
膾	鱠 脍	
膿	脓 𧗕 癑	
臀	𡱂 臋 𡱒 𦞠 𩪡	
臂	𦠞 𦡍 𦡜	
臃	𱼤 𦙸	
臆	𩪩 𩪣 𩪙	
臇	𤎱 𩟥 𦠬 𦢥 䐪 㷷	
臈	臘 腊	
臉	脸	
臊	𦞣 𦠨	
臍	脐 䐡 𠬐 𪗇 𦠃 𪗌 𦙟	
臏	髕 膑 髌	
臐	𦢜 𦘶	
臒	𦫇 𲠗	
臓	臟 脏	
臕	膘 脿	
臗	𣎑	
臘	腊 臈 𦠼	
臙	胭	
臚	髗 胪 顱 𥀵	
臛	𦞦 𩟨 𩟸 𩟯 𱼡	
臜	臢	
臞	癯	
臟	臓 脏 𦿑 𱼔	
臠	脔 𦣐	
臡	𦣊 𦣚 𰯋	
臢	臜	
臣	𢘑	
臤	𠭃 𰀡	
臥	卧	
臦	𦣩	
臧	𡒉 𡒤 𢨑 匨 𡍱 𠗱	
臨	临 𦣷 瀶 𦣲 𲊎	
自	𦣼 𦣹 𩐍 𨈻 𲅘 𲚽	
臭	殠 臰	
臮	𡮧 𦤌	
臯	皋 皐 𦤎	
臱	𦤔 𤾜 𦤝	
臲	𨻄 𦤞 𦤙	
至	𡊏 𦤳 𦤴 𦤵	
致	緻 𦤹 𦤶 𦤺 𲻈	
臺	台 𦤼 𡔼 𳂄 坮 𡐉 𡌬 䑓 𡌫 㙵 㙜 𡋛	
臻	𧽕	
臼	旧 𦥑	
臽	𦥢 𥦶	
臾	𠒍 㬰	
臿	𢆍 𦥫 𠚏 𦦱 𦦈 𦥛	
舀	抌 𦥨 𦦌 𦥝 𦥞 抭 㧒 𦥟 𦥵 𤔘 𱬹	
舁	𦥠 𠢈 𦥹 𢱲 𢪓 𲻋	
舂	㫪 𦥽 𦥴 𦦓 摏	
舃	舄	
舄	舃 𣊣 𩍆 𩊿	
舅	旧 𦦊 𦥶 𠢎 𤽲	
舆	輿	
與	与 𦥸 𢌱 𦦲 𠔜	
興	兴 㒷 𠎢 𨑁 𢍯 𦥷 𱏵	
舉	擧 举 挙 㪯 𠔖 𢪓 𡕖 𦬠 𦦙 𠃥 𠢈 𱑏	
舊	旧 𦾔	
舍	舎 捨 𦧶	
舎	舍 捨	
舐	舓 咶 狧 䑛 𦧑 𦧧 𦧫 𲻓 𪙬 𦧇 𪙶 𦧓 𦧪	
舑	䑙	
舒	忬 𱎻 𱕴 𮰕	
舓	舐	
舔	餂	
舕	䗊	
舖	鋪 舗	
舗	鋪 舖	
舘	館	
舚	𦧻	
舛	踳 㱛 𣧒 僢	
舜	𡳉 𡐩 𡳈 䑞	
舝	𢮟 鎋	
舞	𦏶 儛 𦨅 𦐀	
舟	丹 𣍝 𮯱 𠔾	
舠	𦨣 𦩍	
舡	船	
舣	艤 𲄯	
舦	艜 𦨚 𦨐	
舧	舤 𦨌	
舩	船	
航	桁 斻 𦨵	
般	𦨚 𦨗 𦨟	
舮	舻 艫 櫓	
舰	艦	
舱	艙	
舲	𦫃 𦫊 𦪩 𦫄	
舵	柁 䑨	
舶	艊	
舸	𦨜 𦨒	
船	舩 舡 䚗 𣍬 𲺈	
舻	舮 艫 櫓	
舼	㮪 𦨰 𲻚 𦩺	
艇	𦪅 𦨿 𦨍	
艊	舶	
艎	𦪄	
艏	𦩽	
艐	朡 𦩇	
艒	𦨧 䑵 𦪷	
艕	𦪤	
艖	𦪮 𦪸 𦫅 䑡	
艗	𦩊	
艘	䑹 㮴	
艙	舱 𤾙	
艛	𰰑	
艜	舦 𰰏	
艞	𱸥	
艟	𦨴	
艢	檣	
艣	櫓 樐 艪	
艤	舣 檥	
艥	楫 檝	
艦	舰 𮶙	
艧	𦫇	
艪	櫓 樐	
艫	舻 舮 櫓	
艭	𰰋	
艮	㫔 𥃩	
良	𡆨 𥭣 𡰩 𣌩 𥭷 𣌣	
艰	艱 𱽇	
艱	艰 囏 𥌵 𡆒 𡅸 𦫒	
色	㐌 𢒸 𣤻	
艳	艶 艷 𲻬 豔 豓 𮱑	
艴	勃 𦫛	
艶	艷 豔 豓 艳 𲻬	
艷	艶 豔 豓 艳 𲻬	
艸	艹 草 屮	
艺	藝 兿 蓺 𮲐	
艽	𦸹 𦫶	
艾	㘷 芆 𮶝	
艿	𦮘	
芀	䒒	
芁	艽 𦫶	
节	節	
芄	雚	
芈	羋 芉 𦍋	
芉	芈 𦍋	
芊	茜 谸	
芋	芌	
芍	𦯪 𦱜 芕 薂	
芎	𦵡	
芐	芦	
芑	䄫 𦯸	
芒	杧 𦬆 笀 𪌁	
芓	茡	
芔	卉	
芗	薌	
芘	庇 菝 萆 蔽 蓖	
芛	𦭽	
芜	蕪	
芝	𦭩	
芞	䒗 𦬈	
芟	𠚹	
芣	䓏	
芥	𦬉 𦲈	
芦	蘆	
芨	𦳌	
芬	𦬉 馚 㞣	
芭	巴	
芰	𦼽 𲻱	
花	蘤 芲 𱾃	
芴	𦲇	
芵	𦯊	
芸	藝 兿 蓺 埶 秇 蕓 𦱚 蒷	
芹	斳 菦 䓅	
芻	蒭 刍 𦷝 茤 𦱪 𦮊 𠣧 𦱻 𱽧	
芼	𦳁 𦯮	
芾	𦬝	
苁	蓯	
苅	刈	
苇	葦	
苈	藶	
苋	莧	
苌	萇	
苍	蒼	
苎	苧	
苏	甦 稣 蘇 蘓 𲽕 囌	
苐	𦯔	
苑	菀 𨙨 𮵯	
苒	䒣	
苓	䕘	
苔	菭	
苕	䒒 芀 萔 𦴰 𳉋	
苗	𡩈 苖	
苜	𦴠 𦱒	
苟	茍 芶 𦴳	
苠	𦳜	
苡	苢	
苢	苡	
苣	𥬙	
苤	瞥	
若	𠭞 𦱢 𦱶 叒 𠭚 𦱡 𡻦 𡧻 𦴈 𠭀 𧁇	
苦	𩇵 瘔	
苧	苎 薴 芧	
苨	䕥	
苫	葠	
苳	𦵝	
苴	𦳘	
苵	𦼺 𦸴	
苶	𦬼	
苹	蘋	
苺	莓	
苽	菰 菇	
苾	馝 𥞻 𪏺	
苿	菋 茉	
茂	楙	
范	範 𦴮 𣔶	
茄	伽	
茅	茆 泖 芧	
茆	茅 𦯄 𦹉 𦮉 𦯆	
茇	𦳺	
茈	柴 𦶉	
茉	苿	
茍	苟 𦰶 𦲆 𠷜 𦯃	
茎	莖	
茏	蘢	
茑	蔦	
茔	塋	
茕	煢 焭 𱟂	
茘	荔 栛	
茜	芊 𦴛 𦻤 𦵻 蒨	
茝	𦯭 𦯱	
茠	薅	
茢	䓟 𠞝 𦴟	
茥	蓕	
茧	繭 𥭥	
茫	𱦡	
茭	椒 𦺏 𦽨 䕧	
茮	𦯝	
茲	兹 玆 茊 𢆶 𦱳	
茵	鞇 筃 䓰	
茶	𣘻 𲦥 𦯬	
茷	笩	
茸	𦶪	
茺	𦯇	
茻	𦬇	
茿	𦵶 𧏤 𦯋	
荅	答	
荆	荊	
荇	莕 䓷	
荈	𦯢	
草	艹 艸 皁 𦳕 𦳱 𦯑 皂 屮 𦷣	
荊	荆 𦮓	
荍	蕎	
荐	薦 侟	
荑	苐 𦳂	
荒	𦮋 𫟎 㐬 𠯚 𠃤 𱶊	
荓	𦰝	
荔	茘 栛 𦶭	
荘	莊 庄	
荙	薘	
荚	莢	
荛	蕘	
荜	蓽	
荝	萴	
荞	蕎	
荟	薈	
荠	薺 萕	
荡	蕩 盪	
荣	榮 栄	
荤	葷	
荥	滎	
荦	犖 𱴼	
荧	熒	
荨	蕁	
荩	藎	
荪	蓀	
荫	蔭	
荬	蕒	
荭	葒	
荮	葤	
药	藥 薬	
荳	豆	
荵	𦬄	
荶	䕾 芩	
荷	抲 𢬲 菏 𱣲	
荻	藡 萩 蔐	
荼	𦹍	
荽	萎 𦯩 芕 荾 䒘 䕑 𲼦	
荾	𦴅 䒘	
莀	農	
莃	𮶒	
莅	蒞 涖	
莆	蒲	
莉	菞	
莊	荘 庄 㽵 𤖊 𠗎 𤕶 𤖈 𦻊 庒	
莋	𦰼	
莌	𦸍 𦮀	
莎	𦹈 𢘿 𪍬 䔋	
莏	𲢘	
莐	䒞	
莓	苺 𦱞	
莔	𦳶 𦴖 𦱋 𧏊 𦮄	
莕	荇	
莖	茎	
莘	𨐍 𨐕 𦸯	
莚	葕	
莛	𨓍	
莜	蓧	
莝	𲵊	
莞	𦼍 萖 𦺊 𠴡 𦸌 唍 𦯜	
莟	𧂃	
莠	𦽧	
莢	荚	
莣	𦯌	
莤	𨣡 𨢲	
莥	𦶆 𦱙	
莦	𦷟	
莧	苋	
莨	䕞	
莩	𠬪	
莪	䕏	
莫	𦱤 䒬 𦱴 𦶛 䒩 𦮅	
莯	𦱈	
莱	萊	
莲	蓮	
莳	蒔	
莴	萵	
莵	菟	
莶	薟	
获	穫 獲	
莸	蕕	
莹	瑩 𮵳	
莺	鶯 鴬	
莼	蓴 蒓	
莽	𦷶 𦯨 莾 𢳠 𲦆	
莿	朿	
菀	苑	
菁	𰰫	
菅	𦭂	
菆	𦺵 𦮆 𦻡	
菇	苽 菰 𦱄	
菉	𦾯	
菊	𧂲 𧃓 𦵳 䕮 𦶗	
菋	苿	
菌	𦵼 箘 𦽖 蕈	
菎	𦸫 𧃣	
菏	𦶒 渮	
菑	災 灾 烖 甾 葘 𦿨 𧀗 𦵰 𥲞 𦸜	
菓	果	
菔	蔔 𦻉	
菕	𰰨	
菗	𦼾	
菘	𦬘	
菜	𦬁	
菝	萆 芘 蔽	
菞	𦴙	
菟	莵 䖘 𧈋	
菡	䓿 莟 𣣖	
菢	勽 𢯿 㲒 𣭀	
菣	𦸃 𬜤	
菤	𦶘	
菧	茋	
菩	䔒	
菫	堇 蓳 𦻠 𦸧 𦻍 䒺 𦸨 𦹆 𨤬 𦻋	
菬	𦻟	
華	崋 华 𧅅 𠌶 𡾀 𠫫 𫈐 𦰗 蘤 花 𦶎 蕐 䔢 𦮴 𣓚	
菰	苽 菇 𦺠	
菱	𧅊 𧃮	
菲	𦻥	
菴	庵 葊	
菵	䒽	
菶	𦺑	
菷	帚 箒	
菸	煙 烟	
菹	𥷟 𧗘 𧄗 𦼬 𧂚 𧀽 𧗎 葅	
菻	麻 蔴	
菼	𦽉 𦵹	
菽	尗 𦯂	
菾	𲽑	
菿	𦳙 𦻢	
萁	𦬟 𧯯	
萃	𦬡	
萄	𦻦	
萅	春	
萆	菝 蔽 蓖 芘 𦸣	
萇	苌 𲝡	
萈	𦏊 𦎻 羦 𲼘	
萊	莱 𦻣 𧄚	
萌	萠 𢡗	
萍	蓱 苹 𦭃 䓑	
萎	荽	
萏	𦽜	
萐	𦱥	
萑	雈 𦻃 𦻧	
萓	𦯥	
萕	薺 荠	
萚	蘀	
萝	蘿	
萠	萌	
萤	螢 蛍	
营	營 営	
萦	縈	
萧	蕭	
萨	薩	
萩	𦵒	
萬	卍 卐 万 𤈬 𢁭 𠃡 𥝅 𤍚 𠂍 𥝄 㸘 𫮮 𲘱	
萯	𰰷	
萱	萲 藼 蘐 蕿	
萲	萱	
萴	荝	
萵	莴	
萷	𣜎	
萸	茰 𦳅	
萹	𦽟	
萺	𦽹	
萼	蕚 𦹛	
落	𣧳	
葀	𱾀	
葁	薑 姜	
葂	莬	
葄	𦵬	
葅	𦿘 𦳎 𦯓 𥶎	
葆	𦽻 𦬽	
葇	𦺤 薷 𦽩	
葈	𦱓	
葉	頁 叶 𦰧 𦶫 𲆗 𮶡	
葋	𦶔 𦮿	
葌	䔵	
葍	䔰 𦿁 𦽪 𦽌	
葏	𦻄 𦽷	
葑	湗	
葒	荭 葓	
葖	𦴯	
著	着 箸 𣋐 𣥧	
葘	菑 𱰭	
葚	椹 𣞵	
葜	𦸉 𦳴	
葝	𫈎 𦳲	
葟	𦨄 𦨁 𦨃 䑟 𤯷	
葠	薓 𧄢 𱾯	
葢	蓋 盖	
董	𦱦 菫 蕫	
葤	荮	
葥	𦷱 𧁄 𦺍	
葦	苇 𦻪	
葧	𦸦	
葩	𦺂 苩 皅 䔤 𲼊	
葬	塟 𦱬 𦽱 𦴱 𦱼 𦿑 𦴓 𧂥 㘸 𱎠 𱖁	
葭	𦽸	
葯	藥 薬	
葰	𦶬 䕑 𲼦 𦵭	
葱	蔥	
葴	𦺘 𣿎	
葵	𦮙 𦷡	
葷	荤 蔒	
葸	𦷚	
葺	𦱫	
葻	𬜥	
葿	𦼻	
蒂	蔕	
蒄	𦵤	
蒇	蕆	
蒉	蕢	
蒋	蔣	
蒌	蔞	
蒍	蔿 𫇭	
蒐	搜 捜	
蒒	𦴫 𰰳	
蒓	蓴 莼	
蒔	莳 𦸎 𦱗 𦱎	
蒕	馧 蒀 𥠺	
蒙	朦 矇 懞 濛 𲬥 䝉 冡 𦿢 𣉭 𰰡	
蒜	䔉	
蒞	莅 涖 𦲷 䇐	
蒟	𦵑 𮶪	
蒡	𦾭 𦱘	
蒢	𦺪	
蒥	𱽻	
蒨	蔳 𦹤	
蒭	芻 𫇴	
蒮	𦿠	
蒯	𦮍 𠣯 䓒 𦳋	
蒲	莆	
蒳	𰱌	
蒵	𦷲	
蒶	𰱍	
蒸	烝 𩟘 䒱	
蒼	苍 𦭆 芲 𡶍 𳀂	
蒿	𦿣 𱾭	
蓀	荪 𦺈 䕖 𦽙 𧂍 𦳪	
蓁	𦳳 𮵣	
蓄	𧁃 𧁖 𦿤 稸	
蓆	席	
蓋	葢 盖 𲲑 𤇁 乢 𤇙	
蓌	䟶	
蓍	𦮂	
蓏	𦽝	
蓐	𦸳 𱾤	
蓑	簑 簔 𦸏 衰 𠱗 𡔤	
蓓	䔒	
蓖	萆 芘 𦯛 𦱔 𦶰	
蓘	蔉	
蓛	䔩 𦵪	
蓝	藍	
蓟	薊	
蓠	蘺	
蓡	參	
蓣	蕷	
蓥	鎣	
蓦	驀	
蓧	莜 𦰞 𦺰 𥁮	
蓨	蓚	
蓩	𦺒 𲻴	
蓬	𦿪 莑	
蓮	莲	
蓯	苁	
蓱	𧁕 䓑 𦶊	
蓲	𰰤 䓵	
蓳	堇 菫	
蓴	蒓 莼	
蓵	𥷩 䕹	
蓸	𧅝 𦿩	
蓹	𦼼	
蓺	藝 兿 芸 埶 秇 艺 蓻	
蓻	𱽜	
蓼	𦾷	
蓽	荜 𦸩	
蓾	𧀦 𦷕	
蓿	𦼑 𰱵	
蔀	𩅇	
蔂	虆 蘲 𡏱 𦿌	
蔄	𬜬 𧃪	
蔆	菱 𧅊 蓤 𧁽 䔖	
蔈	𧄖	
蔉	蓘	
蔊	䓍 𦸋	
蔌	䔩	
蔎	𰰺	
蔑	𥴸 薎 眜 衊 𲆢 𰰬	
蔓	𧂧 𦽦 䕕 𱾟	
蔔	菔 卜	
蔕	𦽢 𧀱	
蔖	𦳏	
蔗	𧀹 𤯋 𤯈	
蔘	𦼒 薓	
蔚	嶎 𦵥 𱬦	
蔜	𦽺 𦽠	
蔞	蒌 𦭯	
蔠	𰱛	
蔡	𣞖 𲆖 𦬁	
蔣	蒋	
蔤	苾 𦰷 𦻩 藌	
蔥	葱 䓗 𦴜 𦯎 菍	
蔦	茑 樢	
蔪	𦾶 𧀵 𰱑	
蔫	𣩙 𦮴	
蔬	䔫	
蔭	廕 荫 䕃 𦺼	
蔮	𬜿	
蔯	薼 𫈟	
蔱	𰰵	
蔲	蔻	
蔴	麻 菻	
蔵	藏	
蔷	薔	
蔹	蘞	
蔺	藺	
蔻	蔲 𦽛	
蔼	藹	
蔽	萆 芘 菝 𦿔	
蔿	蒍 𫇭	
蕁	荨 𧀷 𧁘 𧂗	
蕂	䕝	
蕃	䉒 𧂵	
蕄	䉍 𰱉 𢡗	
蕅	𦸲	
蕆	蒇	
蕇	𧂳	
蕈	𧅸 菌	
蕊	蕋 蘂 蘃 繠 𧄜 惢	
蕋	蕊 蘂	
蕎	荍 荞	
蕑	𰱇	
蕒	荬	
蕓	芸 蒷	
蕕	莸 𦳷 𦽈	
蕘	荛	
蕚	萼 𦹛	
蕛	𧀾	
蕝	𫈵	
蕞	𦸤	
蕟	𬜧	
蕡	𰱟 𦶁	
蕢	簣 籄 蒉 䕚 𤆂 𧷩 𧂟	
蕣	橓 𧂌	
蕤	甤 苼 𦼆 𱾴 𮶭 𲼖	
蕧	𰱦	
蕨	𧂱	
蕩	偒 蘯 盪 荡 簜 𠎯 𣿴 𣿘	
蕪	芜	
蕭	萧 䔥	
蕮	𧂙	
蕰	薀	
蕲	蘄	
蕳	𫈉	
蕴	蘊 藴	
蕷	蓣	
蕸	葭	
蕻	𦶓	
蕼	𧀳	
蕽	𫇽	
薀	蕰	
薄	𦻈	
薅	𦵢 𦼸 茠 𢫩 𣐾 𢬺 𲦁	
薆	𫉁	
薇	𦼻 𦵨	
薈	荟	
薉	𦿧 𬜨	
薊	蓟	
薋	𰱱 𦺱	
薌	芗 萫	
薍	𦯠 𦽞	
薏	𦺳 𡮕	
薑	姜 葁 𦷗 䕬 𧅁	
薔	蔷 𧃻	
薖	𰰾 𨗲	
薗	𱽪	
薘	荙	
薚	𦳝 𧀫 𲼀	
薛	辥 𦵮 𧀼 𲼗	
薞	蕵 𦻂	
薟	蘞 莶	
薠	𮐚	
薤	𣩶 𩐁 𩐉 䪥 𧂊	
薦	荐 𧄟 𠭶 𧲛 𥴱 𧂑	
薧	𧂎 𣨻 𮬕 𳍖	
薨	𣩾	
薩	萨 蕯	
薫	薰	
薬	藥 葯 药	
薮	藪 籔	
薯	藷 𦿫 𦬸 蠴 𧄔 𲽊 𦾧	
薰	薫 蘍 𱾶	
薱	𰰱 𱾉	
薲	𦿜 𬝯	
薳	䓕 𨘏	
薴	苧 𦺝	
薵	𦺚 䓓	
薶	䔆	
薸	䕯	
薹	𱾭	
薺	萕 荠	
薾	𦬼	
薿	𥣖	
藀	𦳖	
藂	䕺 𧆁	
藄	𦸀 𦻆	
藆	𧃕	
藇	𨣦 𰰠	
藈	𤬉 𦿡	
藉	借 躤 踖 耤 𧃫	
藋	𧅛 𧅈	
藍	蓝 𦾐	
藎	荩 𦾗 𧂰 𧃤 𦳒	
藏	蔵 匨 𢧿	
藐	𦯦 𧂀	
藑	𧃜 𧁰	
藒	䔾 𦼰 𦿋 𦼵	
藓	蘚	
藕	蕅 澫 㒖 𰰤	
藖	𬜾	
藘	𰱮	
藙	𧆈 𧄘 𧅙	
藚	𰱐 𧅎	
藜	𧅏 𦿾	
藝	兿 蓺 芸 埶 秇 艺 萟 𥡩 㙯	
藟	蘽 蕌	
藣	𧄾 𧀛 𰱯	
藤	籐 籘 䕨 𣳾	
藥	薬 葯 药 𱽚	
藦	蘑	
藨	𦳤	
藩	𮳺	
藪	籔 薮 蓃	
藬	𬞘	
藭	𧅉 𧅓 䓖	
藰	𰰹	
藴	蘊 蕴	
藶	苈	
藷	薯 𫉄 𦺪 𧂤 𧄔 𲽊	
藸	蕏 𦿀	
藹	蔼 𱲘	
藺	蔺	
藻	𧅂 𧁑 薻 𧃡 𧄩 𧂈 𧁍	
藽	𧅜	
藾	䓶 𰱾	
藿	𧆑	
蘀	萚 𦴕 𦿙	
蘂	蕊 蕋	
蘄	蕲 䕤	
蘆	芦 𱽗 𲼪	
蘇	蘓 𲽕 苏 囌	
蘈	𰲁	
蘊	藴 蕴 薀	
蘋	苹 𬞟 薲 薠	
蘌	蓹	
蘏	蘔	
蘑	藦	
蘓	蘇 𲽕 苏	
蘔	蘏	
蘖	檘 蘗 櫱 𰰟	
蘗	檘 蘖 櫱	
蘘	𧂘 𧁁	
蘚	藓	
蘛	𧃠	
蘜	蓻	
蘝	蘞	
蘞	薟 蔹 蘝	
蘟	𦻕 𲼻	
蘠	𲥥	
蘡	𮐨	
蘢	茏	
蘤	花 𤾸	
蘥	𦿈	
蘦	䖅 蕶	
蘧	𠙢 𧄒	
蘩	𦾴 𧄫	
蘪	𧃧	
蘫	𬞫	
蘬	𰰮 𦺕 𧁻	
蘭	兰 𬞕	
蘮	𦿦	
蘯	蕩 盪	
蘱	𰲒	
蘴	𱾧	
蘵	𰱲 𧄕 𦺿	
蘷	虁	
蘸	𧀡	
蘹	𬜸	
蘺	蓠 𧅯	
蘼	䓺	
蘽	藟 𣡺 𦶖 櫐	
蘿	萝	
虀	𧅱 𧅠 𲊦 𰲅	
虁	蘷	
虂	蕗	
虅	𰲂	
虆	蔂 蘽 䉂	
虈	䖀	
虉	𬟁	
虋	𧅾 𥡹 穈 𧄸	
虌	𧆊	
虍	𧇁	
虎	乕 𧆞 𪊖 𠂰 虝 𪋕 𢋪 俿 𧇂 𢁺 𠪳	
虏	虜	
虐	䖈 𥤫 𧆧 𧆱 䨋 䖋 𧆝 𣑾 𧆩 𱱡 𰀂	
虑	慮	
虓	猇 唬 𧆬 𱿏 𮰎	
虔	䖍 𠧘 𠧺 𡨊	
處	处 処 䖏 𩂭 𠙚 𧇤	
虖	乎 呼 嘑 𧆪 𧆜 雽 䖉	
虘	䖕 𧇇	
虙	宓 虑	
虚	虛	
虛	虚 𩴛 𧆳 𣦄 虗	
虜	擄 虏	
虞	𩦢 𠈌	
號	諕 号 呺 虠 𠳯 𱿕	
虡	𧆾 簴 𥲤 鐻 𣝛 𨯼 𧇆 𨮗 𣚛 𧇽	
虢	𧇧 𣂭 𲆣	
虣	暴 𧇑 𧇒 𧸾 𧇭	
虥	虦	
虦	𰲠	
虧	亏 𧇾 𧟯	
虨	𧈇 𧇨 𨞹 霦 𧇥 𩆱 𧇃	
虩	𧈅 𡅗	
虪	𧇐 𧇝	
虫	蟲 𧈰 䖝	
虬	蚪 虯	
虮	蟣	
虯	虬 𪓓 𪓔	
虱	蝨 𧌡 𠤋	
虴	䖳 𧎩	
虶	𧈯	
虷	𲾋	
虹	𧌫 𧈫 𧈬 蝎 𧍺	
虺	蝰 𧉇 𡯥 𩗝 𤴄 𤳹 螝 𤳳 𲾕	
虻	䖟 𧌦 䗈 蝱	
虽	雖	
虾	蝦	
虿	蠆	
蚀	蝕	
蚁	蟻	
蚂	螞	
蚃	蠁	
蚅	𧉵	
蚆	𧵅	
蚉	蚊 螡 蟁	
蚊	蚉 螡 蟁 𨷷 𧊈 䘇 𧓢 鴖 𧏎 𧉬 𧓹 𱢳	
蚋	蜹	
蚌	𧎞 𩷙 蜯 𧉳	
蚍	𧖈 𧖕 𧖎 𧒓 𧔯 𧔆	
蚎	蚏	
蚏	蚎	
蚑	𱿝	
蚓	螾	
蚔	𧎪 𧵄 𧉜 𧓑	
蚕	蠶 𧉕 𧉂 𧍦	
蚖	𧈮 螈 𧉗 䖠	
蚗	𧊍	
蚘	痐 蛕 蛔 蜖	
蚝	螆	
蚟	𧉣	
蚡	蚠	
蚤	䖣 𧎮 𧈠 䗢	
蚦	蚺	
蚧	𧎁	
蚩	𧈨 𧉌 𲹔 𫊵	
蚪	虬 𧏆 𧐵 𧌟 𧐝	
蚬	蜆	
蚮	𧊇	
蚰	𧏿	
蚱	虴	
蚳	𧐏 𨑉 𧋗 𧏔 𧏁	
蚴	𧍘	
蚶	䗣	
蚸	蝷 𧈼	
蚹	𧊆 𲾎	
蚺	蚦 𧊨	
蚻	𧊢	
蚼	𧊛 𱿵	
蚽	蚾	
蚾	𪓜	
蛀	𧉶 𧏼	
蛁	虭	
蛄	蛌	
蛆	𧐅 𧏏	
蛇	虵 它 𧉮 𣙛 𢕷 𤜣 𱥋	
蛊	蠱	
蛋	旦 蜑 疍	
蛌	蛄	
蛍	螢 萤	
蛎	蠣	
蛏	蟶	
蛑	䗋 𧋟	
蛓	螆 𧍤 䗹 𧏀 𧊸 螅 𧊚 𧉠 蚝	
蛔	蜖 蚘 蛕 𧍚 痐	
蛕	蚘 蛔 蜖	
蛗	𧌓 䘀 𧒂 𧌛 𧋰	
蛘	𧒃 𧓲 䖹	
蛙	鼃 𡔻 䖯 䵷 𪓤 𲀒	
蛚	𧌵 𧊿 𧍼	
蛛	鼄	
蛜	𧉅 𧊰	
蛢	𧏑 𧉤	
蛣	𲾦	
蛤	𧊧	
蛥	蛞	
蛧	𧈿 𧍑	
蛩	𧊡 蛬 𧉨 𧋳	
蛪	𧑨	
蛬	𧎦 𧏒 𧊮 𧋯 𧌪	
蛭	𧓳 𲾳	
蛮	蠻	
蛰	蟄	
蛱	蛺	
蛲	蟯	
蛳	螄	
蛴	蠐	
蛵	𰲶	
蛷	𧋛 𧒔 𮶽	
蛹	𧍛	
蛺	蛱	
蛻	蜕 螁 𲾛	
蛼	𰲬	
蛾	䖸 𧒎	
蜂	蠭 𧒒 𧓶 䗬 𧊩 䗦	
蜃	蜄 𧒏 𪓧	
蜆	蚬 䗾 𧖙	
蜇	𧋍 𧎴 𧑭 𧑱 䖧	
蜈	𧋋	
蜉	𧕰 𧖚	
蜊	䖿	
蜋	螂	
蜍	蠩	
蜎	蜵	
蜐	𧉧	
蜑	蛋 旦 蜒 䗺	
蜓	𧍿 𨑳	
蜕	蛻 螁 𲾛	
蜖	蛔 蚘 蛕	
蜗	蝸	
蜘	鼅 𧐉	
蜙	蚣 𧌻	
蜚	𧕒 𧓊 𧕿 𮶻	
蜛	䱟	
蜜	𧒧 𧓫 𦸞 𧉴 𧖅 𠖧 𧕵	
蜝	蜞	
蜞	蜝	
蜠	𧶞 𲿉 𧋕	
蜡	蠟 蝋 䄍	
蜢	𲿝	
蜣	𧍕	
蜤	𧎀	
蜥	𧎀 蜤 𧌨	
蜦	蜧 𰲰	
蜨	蝶 𧕊 𲀕	
蜩	𧊓	
蜫	䖵	
蜭	蛿 𧌤	
蜮	𧌒	
蜰	𧌘 𲾴	
蜱	螵 𧌠 𧓎	
蜳	𧔫	
蜴	蝪 𲾍 𧊤	
蜵	𬠔	
蜶	蟀	
蜸	䘆 𰲮	
蜹	蚋	
蜺	霓 𳀌	
蜻	𰀈	
蜼	𧳫 猚 𧳞	
蜽	𮔊	
蜾	𧒘	
蜿	䖤 䗕	
蝀	𬟽 𲿍	
蝁	𧑕 𰲸	
蝂	𧌿	
蝃	螮	
蝄	𧍑	
蝆	䖹	
蝇	蠅 蝿	
蝈	蟈	
蝉	蟬	
蝋	蠟 蜡	
蝌	𧎗	
蝎	蠍	
蝑	𧌖 𧌊 𧌋	
蝒	𧒪 𧏈 𧉄 蠠 𧍹	
蝓	𧊠 𳍤	
蝕	蚀 𧐂 𤸤	
蝘	𧓱 𧒛	
蝜	𮔅	
蝝	𧏹	
蝟	猬 𢑷 𧳪 𧒞 𢑯 𢑭	
蝡	𧔀 𧔇 𧑮 𧏦 蠕 𱿟 𲾯	
蝣	𧌕	
蝥	蟊 𧓿 𧎄 𧍟 𧒚 𲿕	
蝦	鰕 虾 𧎂	
蝨	虱 𠤋 𧋜 𧒢	
蝩	𧑆	
蝭	𧍝	
蝮	𧐛	
蝯	猨 猿 𧳭	
蝰	虺	
蝱	䖟 𱿺	
蝲	𱿴	
蝶	蜨 𧋞 𲿱 𲿴	
蝸	蜗	
蝼	螻	
蝾	蠑	
蝿	蠅 蝇	
螀	螿	
螂	蜋	
螄	蛳 𧏍	
螆	蛓 蚝	
螇	𧋉 𧕉	
螊	𧍧 𳀑	
螋	䗏	
融	螎 𥃼 𧖓	
螎	融	
螏	𧎿	
螔	𧏕 𧓗 𧌭	
螗	螳	
螘	蟻 𧑢 𧔮 𧍽 𰲹 𧕶	
螙	蠧 蠹	
螚	𦑴 䘅	
螜	𧐜	
螝	𧊫 𧏩	
螞	蚂	
螟	𧔲	
螡	蚊 蚉 蟁	
螢	蛍 萤 𧓌	
螣	𧑞 𧔟 𦢅 𧑥 𧏪 𧔶 𧖍	
螨	蟎	
螪	𧏸	
螫	𧐭 𧋒 𧏅 𱲓	
螬	𧖤 𧕐	
螭	彲 𡖟 𲾷	
螮	蝃 䗖	
螯	𨅚 𩪋 𩪨 𧒥 𩪕	
螰	𧐳	
螲	𧍱	
螳	螗	
螴	𰳄	
螵	蜱	
螷	蠯 𤼜 𢋜	
螸	𧐄	
螹	𧐮 𰳂	
螺	蠃 𮕗 𳍴 𧷳 𮤄	
螻	蝼	
螽	𧕠 𧑬 𧑸 𧒟 𳀃 𧍸 𧑄 𲀔	
螾	蚓 𧓒	
螿	螀 𧌜 𲾝	
蟀	蜶 𧏍 𧍓 𲿇	
蟁	蚊 蚉 螡	
蟂	䳋 𫋇 𱴯	
蟄	蛰 𧒦	
蟅	䗪 𧐚	
蟆	蟇 䗫	
蟇	蟆	
蟈	蝈 蜮	
蟊	蝥 𧎄 𧐘 𧕑 蛑 𧔨 𧎻 䖥	
蟋	螅 𧒓	
蟌	𧋙 䗓	
蟎	螨 𬠬	
蟏	蠨	
蟒	蠎 𧏉 𧎔	
蟔	䘃	
蟕	𧥕	
蟗	𧏋 𧍾	
蟘	𧎢 𫋌 𧈺 𧑰 𧈩 𧏪 𧎬 𱿢 𲀈	
蟙	𧊖 𧊄	
蟚	蟛	
蟛	蟚	
蟜	𫊸	
蟝	𧕎	
蟟	蟧	
蟠	𧓙 𧑪	
蟡	𰲲	
蟣	虮 𧎶	
蟥	𧓛	
蟦	𧑈 𰳊	
蟧	𮔚	
蟨	蟩	
蟫	𧖋	
蟬	蝉 蟺	
蟭	𧖝	
蟮	蟺	
蟯	蛲 𧑣	
蟱	𰲫 𧓼	
蟲	虫 䖝	
蟳	𫊻	
蟴	蟖	
蟶	蛏	
蟷	𧒩 𬠅 𧒾	
蟹	蠏 䲒	
蟺	蟮	
蟻	螘 蚁 𧔮 𧑢 𧍽 𧕶 𲿿 𡎕	
蟽	𰲻	
蟿	𧒼	
蠀	𧏗	
蠁	蚃 䖮	
蠃	螺 𧕳	
蠄	𲿮	
蠅	蝿 蝇 𡢘 𲿽	
蠆	虿 𦹌 𧓽 𧍣 𧓵 䘍 𧔐 𧔱	
蠈	𧒿 𬠠 𧍡	
蠉	𧑩 𧔘	
蠋	蠾	
蠌	𰲵	
蠍	蝎 𧒤 𧓚 𧕔 𧔄	
蠎	蟒	
蠏	蟹	
蠐	蛴 𧖊 𧏝 𧓉	
蠑	蝾	
蠒	𫊱	
蠓	𰲽	
蠔	𧐢	
蠕	蝡 𧑮	
蠘	䘁	
蠙	𧓍 𧏖	
蠚	𧍗 𧊝 𲾘 𧍷	
蠛	䘊 𧓡	
蠞	𬝋	
蠟	蝋 蜡 䗶	
蠡	𥯵 𢍝 䗍 𧱤 蟸 𧋠	
蠢	惷 𢧔 𢧋 𢧬 𧕹 𧅪 𧓟 𢧸 𧕷 𢨣 𢧨 𢨎	
蠣	蛎 䘈 蠇 𧖄	
蠥	𧒣 𧕏	
蠦	𫊮 𲾧	
蠧	蠹 螙	
蠨	蟏 蟰	
蠩	蜍 蝫 𳎊	
蠪	𰲴 𳑶	
蠬	𲾒	
蠭	蜂 𧒒	
蠮	𧏽 䗟 𲾡 𲿗	
蠯	𢌆 𤼜	
蠰	𧖗 𧖒 𧐀	
蠱	蛊	
蠲	𧔈	
蠳	𰳗	
蠵	𧓈 𩽨 𩺫 𳎃 𧓬	
蠶	蚕 𧕽 𧖟 䘉 𧌩 蝅 𧉏 䗞 𧑯 蠺 䗝	
蠹	蠧 螙 𧖌 𧑠 𧋌 𧓜 𧔬 𡕎 𧉓 𫊥	
蠻	蛮 𧖖	
蠽	䘁 𧕾 𧓷	
蠾	𧑏	
蠿	𧖀	
血	洫	
衁	𧖭 𥁃	
衂	衄	
衃	𧖯	
衄	衂 𧖩 䘐 𧗗 𧖷 𦤊 䏔	
衅	釁	
衆	眾 众 𬑔 𠂝 𲏀 𱲻	
衇	脉 脈	
衊	蔑	
衋	𧗙 𧗚	
行	𠎢	
衎	𧗡	
衒	𧗳 䝮 𧗹	
術	术 𧗱	
衔	銜 𱔡	
衕	同 㣚	
街	亍 𲃱	
衚	胡 𱝴 𳀚	
衛	衞 卫 𠀄 䘙 𱥊 𲀛	
衝	冲 𧘂 𤈭 𢖜 𲟫	
衞	衛 卫	
衡	𨏎 𧗣 𡙉 𡙏 𡘻 𠧲 𠧽	
衢	𧘆 𧗪	
衣	衤 𠅃 𱎣	
衤	衣	
补	補	
衦	𥾍	
衧	𧘚 𧘎	
表	錶 𪊘 𧘰 𧞱 𧞧 𪊬 𧘝 𧘦 𧜫	
衪	𧛖 袘	
衫	𧟖 襳 𥘎	
衬	襯 𥘑	
衭	㠸 䊿	
衮	袞	
衯	𧘠	
衰	蓑 𠆂 𳀮 𠌺 𤸬 𧜸 𣩖 𲁳	
衸	𧘷	
衹	祇 祗 只	
衺	𲀧 𲀯	
衻	袡	
衽	袵 𧙨	
衾	𧘭 𧙐	
衿	襟 紟 䘳	
袄	襖	
袅	裊 嫋 嬝	
袆	褘	
袈	𧛣 𣮱 𲨍	
袉	袘 衪	
袋	帒 𣅁	
袍	𧙘 𧙌 𧝘 袌 𧞯	
袎	𥿌	
袒	襢	
袔	𧝂	
袕	䋉	
袖	褎 褏 䄂 𧙏 𮵛	
袗	裖	
袚	𧙄 𧙂 𧘟 襏	
袜	襪 韈 韤 𥿉 𥘯	
袞	衮 𧚹 䙛 𧟗 𧟏	
袟	𧙍 袠	
袠	帙	
袡	衻 𥾢	
袣	𧙟	
袤	𧝺	
袧	𧘤 𧛩 𧙎	
袨	䘩	
袭	襲 𲀭	
袯	襏	
袳	𧚤 𧛧	
袴	褲 絝 绔 綯 裤 绹	
袵	衽	
袷	裌	
袹	帞	
袽	䘫 䋈	
袾	𧘣	
裀	𧛑 𧙊	
裁	𧚝 𧚶	
裂	𧙷 𧙩 𧚲	
装	裝	
裆	襠	
裈	褌	
裉	褃	
裊	嫋 嬝 袅	
裋	𧞫 𧞀	
裌	袷 𬡒 䘥	
裎	䄇	
裏	裡 里	
裓	𧚑 𧛠	
裔	𧘊 𧘉 𧚞 𧛲 𧜟 𧘯 𧛨 𮶿 𲑖	
裕	䘱 𥙿	
裗	𱵓	
裘	𧚍 𣰐	
裙	裠 帬 𧛬 𢃆 𢂽	
裛	𲀲	
補	补 䋠 𢒏	
裝	装 𧙜 𧚌 𧚒	
裠	裙 帬	
裡	裏 里	
裢	褳	
裣	襝	
裤	褲 絝 绔 綯 袴	
裥	襉 襇	
裨	𧚽 𥚈	
裭	褫	
裮	𢃑	
裲	𮖁	
裴	裵	
裵	裴	
裸	躶 倮 𡑤 𧝹	
裹	𦆪 𲐎	
裻	𧚛	
製	制 𧚳	
褂	袿	
褃	裉	
褅	䙗 裼 𧝐	
複	復 覆 复 𧜰	
褊	𱜯	
褋	𧝵 𧚦	
褌	裈 𢃚 裩 㡓	
褍	𧞖	
褎	袖 褏	
褏	褎 袖	
褐	𧝶 𧝽	
褑	褤	
褒	襃 𧝾 𧚱 𧛙 𧜯 裦 裒 闁	
褓	緥 𲴯	
褕	𮖜	
褘	袆	
褙	䋳	
褚	禇	
褛	褸	
褝	襌	
褟	溻	
褢	褱 𧞷 𧙪	
褥	𬡂	
褧	絅	
褫	裭 𧚜 𳁈 𧜑 𰉳 𲙈	
褭	䮍 𬡇 裊 𠌵 䙚	
褰	𧝱 𧞼 䙭 𧛓	
褱	褢 𧞷	
褲	絝 绔 綯 袴 裤 绹 𩊓 衭	
褳	裢	
褴	襤 繿 褓	
褵	縭 䙰	
褶	𧚻	
褷	𧚺	
褸	褛	
褺	褻 䙝 𬡓	
褻	褺 亵 䙝 暬 𢌀 絬	
褽	𧛽 𧜷	
褾	𧝼 裱 𧘡 𧟈 𢅚	
褿	㡟 𧟔	
襀	𫌀	
襁	繦 繈 𧟂 𧚴 𧝿	
襂	𰴂	
襃	褒	
襄	㐮 𡣿 𧞂 𧞜 𠆝 𧞻	
襆	幞 襥	
襇	襉 裥	
襉	裥 襇 𧟉	
襊	𧜮 𧜱	
襋	𧛘	
襌	褝	
襍	雜 雑	
襏	袯	
襐	𧝌 𢄵 𧞌 𧞦	
襒	𧝬	
襓	𫋹	
襕	幱 襴	
襖	袄 澳 𥜌 𧞯	
襗	𫋷	
襘	𫋻	
襛	𰳺 𧟒 𧜆	
襜	襝 衻 𧞟 䄡 䪜 裧	
襝	襜 裣	
襟	衿 𧛛 䘳 𥘞	
襠	裆	
襡	䙱	
襢	袒	
襤	繿 褴 𥜓	
襦	𧝄 𧞳	
襨	𰳸	
襩	𧟎	
襪	韈 韤 袜 𥀯 帓 𤿗 𥿉 𲵀	
襫	𧞲	
襬	䙓 𧟍 摆	
襭	𮖱	
襮	幞 𦃙 𦆿 𧟊	
襯	儭 衬 𳁀	
襰	𧝝 𢅭	
襱	𧙥 𰳲	
襲	袭 𧟟 褶 𧟛	
襳	𧞬	
襴	幱 襕 襽 𳁎	
襵	𫌇	
襸	𬡷	
襹	褷 𰳼	
襺	𧟐 𧟚	
襻	𧘵 䙪 𧘬 𧘋 𧘒 𧘙 鑻 𥘽	
襼	𰳵	
襾	覀	
西	㢴 𠧜 㐁 𠧪 卤	
覀	襾	
要	𠾅 𤐫 𡕹 𦥺 𦥼 𡢗 𡕯	
覂	䟪 𢇫	
覃	𧟩 𪉷 𪉲 𪉙 𧟹 𪉞	
覆	複 復 复	
覇	霸	
覈	核 𩅢 𥽶 𩅓 𲁍	
覉	羈 羇 覊 羁	
覊	羈 羇 覉 羁	
見	见	
覌	觀 観 观	
覎	觃 𧠐	
規	槻 规 䂓 𩑬 𩒙	
覐	覺 覚 斍	
覒	𧠑 𬆾	
覓	覔 觅 覛 𧠙 𧠘 𥦀 𥄃	
覔	覓 𲁑	
覕	𰴕 𧸈 𧠣	
視	眎 视 𥄇 𥄙 𤋇 𥉙 眡 眂 𥅭	
覗	𥄶 𬢊	
覘	觇 䦓 𦕒 䀡	
覙	覼	
覚	覺 斍 覐 觉	
覛	𧵬 𧠨 𫌪 𧡒	
覜	𬢋	
覝	䙺	
覞	𧡾 𧡷	
覟	𬢌	
覠	𰴙	
覡	觋	
覢	𬊦	
覤	𬟪	
覥	靦 觍	
覦	觎	
覧	覽 𳁖 览	
覩	睹 𬢎	
親	亲 𧡘 𢈥 𢾉 媇 𡩁 𧡿 𡪔 𲁗	
覫	𲁙	
覬	觊	
覭	𬢒	
覮	𲁖	
覯	觏	
覰	覷 𰴜	
覲	觐 𧢚 𩌶	
観	觀 覌 观	
覴	𬢔	
覵	覸	
覶	𰴝 覼 𧡓 覙	
覷	覰 觑 𧠢 䁦 覻	
覸	覵 𰴘	
覹	𫌭 𧢓 矀 𧢒 𲥋	
覺	覚 斍 覐 觉 𧠭 𡕚	
覻	𰴞	
覼	覙 𫌨	
覽	覧 𳁖 览	
覿	觌 儥 𧠫	
觀	観 覌 𳁙 𳁓 观 𥸑 𥍕 𧃼 𥍊 𥷯 𥍄 𩁰	
见	見	
观	觀 観 覌	
觃	覎	
规	規 槻	
觅	覓	
视	視 𱜢	
觇	覘	
览	覽 覧	
觉	覺 覚 斍	
觊	覬	
觋	覡	
觌	覿	
觍	覥	
觎	覦	
觏	覯	
觐	覲	
觑	覷	
角	甪 𧢲	
觓	觩 𤙠 𧢳 𧤝	
觔	筋 斤	
觕	粗 麤 麁 麄	
觗	觶	
觚	𧣗 䉉 𨠋	
觜	咀 嘴 𠲋	
觝	牴 抵 𳁝 𧣎 𧣜 𧣓 𲁛	
觞	觴	
觟	𧣓	
觠	𩓫	
觢	㸷 𧣯 𤙲	
解	觧 𦴘	
觤	𩊛 𧣂 䍯	
觥	觵 𧣥	
触	觸	
觧	解	
觩	𤙠 𧢳	
觪	𧤱	
觯	觶	
觰	𧤌 𧤺	
觱	𧤅 𧥑 𧥀 𥷑 𱏼 𲁟	
觲	觪	
觴	觞 𣝻 𤔰 𨢩	
觵	觥	
觶	觯 觗 𧣄 𦨟 𧣨	
觷	𰴣 𧣔 礐	
觸	触 𧥘 𧢻 𧤝 𧣈 觕 𲁠 𲯖	
觹	𧤤	
觻	𰴢	
觼	𧤾 鐍	
觽	𧥅	
觿	觹 觽 𧤪 𧤢 𧥁 𧣽	
言	訁 讠 𢍬	
訁	言 讠	
訂	订 𠄚	
訃	讣	
訄	訅	
訆	𰵊	
訇	渹 𢕐 𥔀 𧥻 𧥺	
計	计 𧨻 𲒳	
訉	𧥭 訙 𲂂	
訊	讯 𧫓 𠳱 䛜 𠱖 𧪄 𧨼 訙	
訌	讧	
訍	𲁤 𲂃	
討	讨 䚯	
訏	𬣙 𧥦	
訐	讦	
訑	𫍙 𧦩	
訒	讱	
訓	训 𧥥 𧥿	
訕	讪 𧧪 𧧚 䚲	
訖	讫 𧥷 𧪢	
託	侂 讬 䚽 𧥫	
記	记 𧪄	
訚	誾	
訛	譌 讹 吪 䚰	
訜	𫍛	
訝	讶 迓	
訞	𧨶 𫍚	
訟	讼 㕬 吅 𧧡 䛦	
訠	矧	
訢	䜣	
訣	诀 𧦾	
訥	吶 讷 呐 𧨣	
訦	諶 𰵒	
訧	𧥩 𰵎	
訨	𫟞	
訩	詾 讻	
訪	访 昘 𧪃 㕫	
訬	𰵏	
設	设	
訮	𧥪 詽	
訯	𲂅	
訰	𧦏 𧥫 𰵍 吨	
許	许	
訳	譯 译	
訴	愬 诉 𧦡 𧪜 𧩯 𧫋	
訶	呵 诃 𧬱 𧪆 㱒	
訷	𳁼	
訸	𰵝	
訹	𧧐 𰵓	
診	诊 𧠝 𧧂 𧦜 𧭉 覙	
註	注 𬣣 𲁩	
証	證	
訽	詬 𰵛	
訾	𧩢 訿 𤺒 𧬟 𱎷	
詀	𧮪 譧 䛸	
詁	诂	
詂	𧨽	
詃	𬣤	
詄	𧧲 𰵙	
詅	𰵚	
詆	诋 𠯝 𲔭 𠰋 𠯞 𧥮 𧦒 𧦚 𧦺 𠳉 呧	
詇	𰵗	
詈	𧩥 𧧧	
詉	𧪅 𰵠 訤	
詊	𫟟	
詋	呪 咒	
詌	𬣠	
詍	㖂 𧥨 呭 𰵔 䛖	
詎	讵	
詏	𬣦	
詐	诈	
詑	𫍟 𧦭 𧪁 𫍡 𧦧 訑	
詒	诒 𧦫	
詓	𫍜	
詔	诏 詺	
評	评	
詖	诐 𧫸	
詗	诇 𧨝	
詘	诎 𧬲 誳	
詛	诅 𧇘 𥛜	
詜	𬣥	
詝	𬣞	
詞	词 𧥝 䛐	
詟	讋	
詠	咏 𠰿 𰵞	
詡	诩 𧩘	
詢	询 𧪂 𧩛 𧪱 咰	
詣	诣	
詤	謊	
詥	𰵣	
試	试	
詧	察	
詨	誟 𰵦	
詩	诗 𧥳 𳁬	
詪	𧨛 𬣳 䛉 𧩺	
詫	诧 𧩫 咤	
詬	訽 诟 㖃	
詭	诡 謉 𠱓 譌	
詮	诠	
詯	䛛 𧩤 𬣰	
詰	诘	
話	话 䛡 咶 𦧵 譮 諙	
該	该	
詳	详	
詴	𬣩	
詵	侁 駪 诜	
詶	酬 醻 酧 𬣱	
詷	𫍣	
詹	𦧕 噡	
詺	𬣮	
詻	咯 𰵤	
詼	诙	
詽	訮	
詾	訩 𧧗 㕳 哅 𧦙	
詿	诖 𧭬 𧭑 𧬮	
誁	𧩱 𧫮 𬣲	
誂	𫍥 𠻩 𧨙	
誃	𰵥 䛂	
誄	诔 𧧈 䛶 讄	
誅	诛	
誆	诓	
誇	夸 侉 𧥢 咵 𧧳	
誉	譽	
誊	謄	
誋	𫍪 𲠚	
誌	志 識 𰵧	
認	认	
誎	𬣷	
誏	𬣼	
誐	哦 𰵮	
誑	诳 䚾 𧪴 𲲤	
誒	唉 欸 诶	
誓	𣂶 𣂯 䤱	
誔	𬣻	
誕	诞 𧩙 𧥡 唌	
誖	𢨋 悖 𢚦 怫 𢠜 𧪶 哱	
誗	𰵭	
誘	诱 䛻 𦎙 㕗 𦲃 𦎅 𥤃 唀	
誙	𰵡	
誚	譙 诮	
誜	𰵯	
語	语	
誠	诚	
誡	诫 䛺 𧪖	
誣	诬 𧨈 誈 𧨆 𧩄	
誤	悞 误 悮	
誥	诰 𧧞 𢍎 𧧙	
誦	诵	
誧	𰵩	
誨	诲 𠲯	
誩	競 竸 𧮣 𲂍	
說	説 说 𧧘 𳁲	
誫	𫍨	
説	說 说	
読	讀 读	
誰	谁 𳁶	
誱	𧫰	
課	课	
誳	𫍮	
誴	𫟡	
誵	訤	
誶	谇 譢	
誷	𤣴 𧧜 𫍬 𧦆	
誹	诽	
誺	𫍧 𧨇	
誻	𰵸 𠴲 𧪟 䜚	
誼	谊 竩 𧧼	
誽	𰵵	
誾	訚 𨶡 訔	
調	调	
諀	𧨬	
諁	啜 𰵷	
諂	谄 讇 謟	
諃	𰵱	
諄	谆 𧭫 𧭺 𧩽	
諅	𧬗 𧥽	
諆	𰵲 𧫠	
談	譚 谈	
諈	娷 𧬡 𰵶	
諉	诿 餵	
諊	鞫	
請	请 𰵕	
諌	諫 谏 𮷅	
諍	诤	
諎	𧬢 𬣾	
諏	诹 𧩻 𧩞	
諑	诼	
諒	谅	
諓	𬣡	
諔	𰵴	
諕	謼 唬 嚇 號 𧫒 𧪹 𬤀 𧩐 𧬵	
論	论 𧪺	
諗	谂 讅	
諘	𲂏	
諛	谀 䛕	
諜	谍 𧩜 𧨯	
諝	谞 𧫐 𧩑 㥠 𢝒	
諞	谝 𧫲	
諟	惿 𧫚 𬤊	
諠	喧 𬤎	
諡	謚 𧨦	
諢	诨 𧬪 𧮘 顐	
諣	𧬭 𫍩	
諤	讍 谔 𣤲 𡅡	
諥	𫍳	
諦	谛 諟 𧫚	
諧	龤 谐	
諩	譜 谱 𬣲	
諫	諌 谏 𧧅 𫍝	
諭	谕 喻 喩	
諮	咨 谘 嗞	
諯	𫍱	
諰	𫍰 𧪳	
諱	讳	
諲	𬤇	
諳	谙 𧩸 𧫧	
諴	𧬌 𫍯	
諵	喃 娚 䛁 𲂐	
諶	訦 谌	
諷	讽 𧩠	
諸	诸 𢒕 𧭷 𣦁	
諹	𰵌	
諺	谚 𠷗 喭 𧧑	
諻	𬤍	
諼	谖	
諽	愅	
諾	诺 喏	
謀	谋 呣 𠰔 𢘓 𧦥	
謁	谒	
謂	谓 𧬴	
謄	誊 𦫁 𲁿	
謅	诌 𧩖	
謆	𫍸	
謇	𠹟 𧮎 𡅶 𡄓 𧬯 𠽱 𧮈	
謈	𧬉	
謉	𧫏 𫍷	
謊	詤 谎	
謋	𰵼	
謌	歌 𬤐	
謍	𰴯 𧮆	
謎	谜 詸 䛧	
謏	𫍲	
謐	谧 𧨨 䛑	
謑	𧫟 䜁 𠿇 𰵾 𧨞	
謔	谑 𧫪 嚯	
謕	𧪥	
謖	谡	
謗	谤 𧩂	
謘	䜄	
謙	谦 𧫨	
謚	諡 谥 𧫺	
講	讲 𧪿	
謜	𰵺	
謝	谢 𧬄	
謞	𰵿	
謟	𰵽	
謠	謡 谣 䚺 䚻	
謡	謠 谣	
謣	𧪮 𰶀 譃	
謥	𧪳 𧩟 𰶂 𧩪	
謧	𧮛 㦒	
謨	谟 謩 𢜯 𠻚	
謫	讁 谪 𧬍 𡂓 𱞷	
謬	谬 𧬶	
謭	譾 谫	
謯	𫍹	
謰	𬣽 嗹	
謱	嘍 𫍴 𰵂	
謲	𬢳 𬤄	
謳	讴 𠥺	
謴	𬤆	
謵	𰶃	
謶	𧭧 𧫽 𲂔	
謷	𧭁 謸	
謸	𫍵 謷	
謹	谨 𧭩	
謺	𧬓	
謻	𧩀 𠗺 𰶁	
謼	呼 嘑 諕 唬 嚇 𠻢 𬤙	
謾	谩 𠿐 㗄 𧬒 𧫩	
謿	𲁻	
譀	𧧴 𧫫 𰶆	
譁	嘩 哗 𧪮 𧮉 𲂊	
譂	𫟠	
譄	𬤤	
譅	𧬃 𰶎	
譆	𫍻	
譇	𰶄 𧬅 𧩫	
譈	憝 懟 𬤣	
證	証 证 䥭 䥌 𧁅 𨪔 𨨾 𦷘 𨧭 𨨼 𧁆	
譊	𫍢	
譌	訛 讹 𰵑	
譍	𲂁	
譎	憰 谲	
譏	讥	
譐	噂 𬤢	
譑	𫍤	
譒	𮷊	
譓	譿 𬤝	
譔	𧩿 𬤥	
譖	谮	
識	识 𢨞 𧬣 䛊 𧨺 𧥾	
譙	誚 谯	
譚	談 谭 䜖	
譜	諩 谱 𧭘 𧫭	
譝	憴	
譞	𫍽 𧭴	
譟	噪 謲 𬤨	
譠	𰶉	
譡	𬣭	
譢	𲂖	
譥	譤	
警	儆 䜘	
譧	𲂕	
譨	𫍦	
譩	𰶊	
譫	谵 噡	
譭	䛼	
譮	諙	
譯	訳 译 𧬳	
議	议 𧭖	
譱	善	
譲	讓 让	
譳	𧬐 𰶌	
譴	谴	
譶	𧭛 𨑂	
護	护	
譸	诪 𡃮 𧪀 𡆓 𬢪 嚋	
譹	𬤫	
譺	𬤩 𧭐	
譻	𬢯	
譼	䛓	
譽	誉 𣁎 𳁰	
譾	謭 谫 𧬫 𫍿	
譿	𬤭	
讀	読 读 𡂝	
讁	謫	
讂	𰶍 譞	
讃	讚	
讄	𧮢 𧫖 𧬀	
讅	谉	
讆	讏 𬣀	
讇	𬤛	
讈	𧬎	
讉	𬤦	
變	変 变 㣐 𦇥 𠮓 𢻝 𢒦 𢒪 𢒭 𢒟 𣀵 𢒛	
讋	詟 𩐶 𧮩	
讌	宴 醼 燕 䜩 𧮃	
讍	諤	
讎	讐 𲗳 仇 雠 𢛇 𩀕 𠵁 𢢧	
讏	讆	
讐	仇 讎	
讑	𧭆 𰶏	
讒	谗 䜛 𲁷 𲁾	
讓	譲 让 誏 𦦬 𧮨	
讔	𧮐 𮙊 𲁼	
讕	谰 㘓	
讖	谶 䜟	
讗	𧮄	
讘	囁 𰵹 䜆	
讙	𬤰	
讚	讃 𬤮 𡂐	
讛	𰵖	
讜	谠 譡 𧭢 𧩡 𧫆	
讝	𰵨	
讞	谳 囐	
讟	㾄 𮙋	
讠	言 訁	
计	計	
订	訂	
讣	訃	
认	認	
讥	譏	
讦	訐	
讧	訌	
讨	討	
让	讓 譲	
讪	訕	
讫	訖	
讬	託	
训	訓 𱞱	
议	議 𲁤	
讯	訊 𱦮	
记	記	
讱	訒	
讲	講	
讳	諱	
讴	謳	
讵	詎	
讶	訝	
讷	訥	
许	許 𱢬	
讹	訛 譌	
论	論	
讻	訩	
讼	訟	
讽	諷	
设	設	
访	訪	
诀	訣	
证	證	
诂	詁	
诃	呵 訶	
评	評	
诅	詛	
识	識	
诇	詗	
诈	詐	
诉	訴	
诊	診	
诋	詆	
诌	謅	
词	詞	
诎	詘	
诏	詔	
诐	詖	
译	譯 訳	
诒	詒	
诓	誆	
诔	誄	
试	試	
诖	詿	
诗	詩	
诘	詰	
诙	詼	
诚	誠	
诛	誅	
诜	詵	
话	話	
诞	誕	
诟	詬	
诠	詮	
诡	詭	
询	詢	
诣	詣	
诤	諍	
该	該	
详	詳	
诧	詫	
诨	諢	
诩	詡	
诪	譸	
诫	誡	
诬	誣	
语	語	
诮	誚	
误	誤	
诰	誥	
诱	誘	
诲	誨	
诳	誑	
说	說 説	
诵	誦	
诶	誒 唉	
请	請	
诸	諸	
诹	諏	
诺	諾	
读	讀 読	
诼	諑	
诽	誹	
课	課	
诿	諉	
谀	諛 𱙚	
谁	誰	
谂	諗	
调	調	
谄	諂	
谅	諒	
谆	諄	
谇	誶	
谈	談	
谉	讅	
谊	誼	
谋	謀	
谌	諶	
谍	諜	
谎	謊	
谏	諫 諌	
谐	諧	
谑	謔	
谒	謁	
谓	謂	
谔	諤	
谕	諭	
谖	諼	
谗	讒 𲁰	
谘	咨 諮	
谙	諳	
谚	諺	
谛	諦	
谜	謎	
谝	諞	
谞	諝	
谟	謨	
谠	讜	
谡	謖	
谢	謝	
谣	謠 謡 𫍚	
谤	謗	
谥	謚	
谦	謙 𰵋	
谧	謐	
谨	謹	
谩	謾	
谪	謫	
谫	譾 謭	
谬	謬	
谭	譚	
谮	譖	
谯	譙	
谰	讕 𰵟	
谱	譜 諩	
谲	譎	
谳	讞	
谴	譴	
谵	譫	
谶	讖	
谷	穀 𠔌 𡵾	
谸	𧮮	
谹	𧮯 𲂙	
谺	𳂂	
谻	𠙏 𧮷 𠙆 𧮬	
谼	䜫	
谽	𧮳 𧮰 𲂘 𲭕	
谾	𩓅	
谿	溪 渓 嵠 豀 磎 𲖺	
豁	𧯉 𱘈 𲎢	
豃	𧯘	
豄	𰶔	
豅	𰶑	
豆	荳 梪 䇺 𧯜 𣅣 𧯚 𤽔 𣅋	
豇	䜶	
豈	岂	
豉	䜻 𢻃 䜵 敊	
豊	豐 𧯽	
豋	登 𧯭 𤮘 𡖚 𧰐	
豌	𧯳 𧯡	
豍	𧯪	
豎	竪 竖 䝂 䜿 𥪛	
豐	豊 丰 𣍈 𧯮	
豓	艶 艷 豔 艳	
豔	艶 艷 豓 艳 𡤩 𦫢 𲻬	
豕	𧰬 𧰧 𢁓 𡰯	
豖	𢒔	
豗	䝇 𧱉 拻	
豘	豚	
豚	豘 𠭣 𧰭 𤜨 𦚌 𢃻 㹠 𧱯 𧱔 𧱮 𧱸	
豛	𧱣 𧰶 𧱕	
豜	豣 𧲀 𧱚	
豝	羓 𤜱 𧲧	
豞	𧰴 𧲳	
豟	𧱒 䝈 𤜸 𧲒 𤝤	
豠	𧱑	
象	𤉢 𧰼	
豢	㹖	
豣	豜	
豤	𧱗 𧳢 狠 𧱟 𧱨 貇	
豥	𧱱	
豦	𤢓	
豨	狶 𧳐	
豩	𧲏	
豪	𩫕 𩫎 𩫞 儫 𢑸 𩫚	
豫	預 𢘕 𠄝 䂊 忬 𠄛	
豬	猪 䐗 𢑳	
豭	猳	
豮	豶	
豰	𧲇 𧲐	
豲	獂 𧱖 𧱂	
豳	邠 㟗 𡺳	
豴	蹢	
豵	䝋 𤡆 𧱷 𧲓 𫎆 𧱭	
豶	豮 𧴍 獖	
豷	𧱲 𤡬	
豸	廌 𦎋 𧋈 𧳃 𤞝	
豹	犳 𧲡	
豺	犲 𤝔 𤝦	
豻	犴 貋	
豽	𤜽	
豿	𧲿 狗	
貀	豽 𧰹 𤜽 𤝒	
貁	狖	
貂	鼦 㹦 𪔸	
貄	𤝽	
貅	䝗 𧲷 㹯	
貆	𧳔 狟 𱢡	
貉	狢 貈 𧴏 𧳇 𧲪 𳂊 𧴞 𧲩 𧲦 𧴘	
貊	貘 貉 貃 狛 𧲥 𱚦	
貌	皃 㹸 𨓅 皀 𧳖 𧳓 𧳒 𲮖 狠 𨉍 㒵 䫉 貇	
貍	狸 𧳟 𧴔 猍	
貎	猊 皃	
貏	𧳠	
貐	㺄	
貒	猯 𧳩 𧳲 䝎	
貓	猫	
貔	𤜻 𤠞 豼	
貗	𫎌	
貘	貊 獏	
貙	䝙 𧲰 𤠾	
貛	獾	
貝	贝 𪚾 蛽	
貞	贞 𠨀 鼑 𣦵 𱥂	
貟	贠	
負	负 偩 𧴥	
財	财 㒲 𧸄 𧴶 𧵤	
貢	贡	
貣	𰷞	
貤	𥅓 䝯 𰷠 𥃸	
貦	𰷡	
貧	贫 𡧋	
貨	货 𣱷 𧵰 𧴦	
販	贩 𧶶	
貪	贪	
貫	贯 䝺 𢿒	
責	责 𧵩 𧶌	
貭	質 质	
貮	二	
貯	贮 𧵤 𲂯 𲞜	
貰	贳 𧶚 𧴹	
貱	𬥶	
貲	赀	
貳	弍 二 贰 𢎐 貮 𠌗 㒃	
貴	贵 𡭙 𧸋 𧶪 䝿	
貶	贬 𧸘 𦥧 𦥘 𧴷 𦥕 𡬯	
買	买 𧵽 𧹒	
貸	贷 𠌗 𣃐	
貺	贶 𧵦 𧵮	
費	费	
貼	贴	
貽	贻 䞅	
貾	𧵇 𰷢	
貿	贸 𧵲 𥆆 𧴵 𧶻 𧶝 𧵍	
賀	贺	
賁	贲	
賂	赂 𧸚	
賃	赁	
賄	贿 𧶅	
賅	侅 赅 賌	
資	资 𪗑 𣣬 𧷕 𪗒	
賈	贾 𧵑 𧵎	
賉	恤 卹	
賊	戝 贼 𧵪	
賍	贓 贜 赃	
賏	𲂻	
賑	赈 𧵉 䝩	
賒	赊 賖 𧶟 𧴳	
賓	賔 宾 𧶉 𡪛 𤍘 𥦎 𡧍 𡧎 𡫅 𧶎	
賔	賓 宾	
賕	赇	
賖	賒	
賗	𬥸	
賙	赒	
賚	赉 𧶛 𧷖	
賛	贊 赞 𰷣	
賜	赐 𲤄	
賝	𧷉 𫎩	
賞	赏 𧶜	
賟	𧹖	
賠	赔	
賡	赓 𲟌	
賢	贒 贤 䝨 臤 𠤕	
賣	売 卖 𧶠 𧷓 𧷨 𧷵	
賤	贱 𧶤 𲛒	
賥	𰷤	
賦	赋 𧶣 𧷲 䝾 𧵐	
賧	赕 𧵊	
賨	賩 𰷥 𢃏 𧹆	
質	貭 质 筫 𧸲	
賫	齎	
賬	帳 账 𧹔	
賭	赌 𧶴 𧷿	
賮	贐 𧷇 𰷧	
賰	䞐	
賲	宲 𲃄	
賴	頼 赖 𩓃 𧡽	
賵	赗 𠙒	
賶	𬥳	
賸	剩 剰 𦫂 𬂉 𧷽 䞉	
賹	𰷪	
賺	贃 赚 𧸖	
賻	赙	
購	购 𧸊 𧶥 𧷻	
賽	赛	
賾	赜 𧶷 𧷤 歵 𡄙 𡁃	
贂	𬥞	
贃	賺 𧸖 𧹗	
贄	贽	
贅	赘 𧸞 𧷌 𧸆	
贆	𰷫 𧷼 賧	
贇	赟 𧸔	
贈	赠 𧸑	
贉	𧸘 𫎫	
贊	賛 赞 𲓏	
贋	贗 偐 赝	
贍	赡 𩟋 𧸸	
贎	𧸱 𧹇 𨲴	
贏	赢	
贐	賮 赆 䝲	
贑	𫎬	
贒	賢	
贓	贜 賍 赃 𰷭 𧷢	
贔	赑 屓 𩖏	
贕	𫧿 𧸷	
贖	赎 𧹎	
贗	贋 偐 赝	
贙	𧷠 𰷮	
贚	𫎦	
贛	赣 𩑅 贑 𩐬	
贜	贓 賍 赃	
贝	貝	
贞	貞	
负	負	
贠	貟	
贡	貢	
财	財	
责	責	
贤	賢	
败	敗	
账	帐 賬 帳 𧹔	
货	貨	
质	質 貭	
贩	販	
贪	貪	
贫	貧	
贬	貶	
购	購	
贮	貯 𮷍	
贯	貫	
贰	貳	
贱	賤	
贲	賁	
贳	貰	
贴	貼	
贵	貴	
贶	貺	
贷	貸	
贸	貿 𲂭	
费	費	
贺	賀	
贻	貽	
贼	賊 戝	
贽	贄	
贾	賈	
贿	賄 𲂨	
赀	貲	
赁	賃	
赂	賂	
赃	贓 贜 賍	
资	資	
赅	賅	
赆	贐	
赇	賕	
赈	賑	
赉	賚	
赊	賒	
赋	賦	
赌	賭	
赍	齎	
赎	贖	
赏	賞	
赐	賜 𰷟	
赑	贔	
赒	賙	
赓	賡	
赔	賠	
赕	賧	
赖	賴 頼	
赗	賵	
赘	贅	
赙	賻	
赚	賺	
赛	賽 𡧳	
赜	賾	
赝	贋 贗 偐	
赞	贊 賛 𰷣	
赟	贇	
赠	贈	
赡	贍	
赢	贏	
赣	贛	
赤	𤆍 烾 灻 𱫀	
赦	𤆅 𢽀 𢼜 𥘦	
赧	𧹞 𧹠 𢠱 𩈫 𤿜 𢟻 䚂 𩈑 𩈶	
赨	𧹝 𧌝 𧋒 蚒	
赩	𦫜	
赪	赬	
赫	爀 䓇 𧹘 焃 㚘	
赬	赪 䞓 𧹚 𧹙 緽 頳	
走	赱 㞫 𧺆 𣥕 𲝇	
赱	走	
赳	𠡟 𧺈 𧺇	
赴	䞯 䟔 𨕍	
赵	趙	
赶	趕	
起	𡆡 𨑓 𨑔 𱳠	
赹	𧻛 𧺓	
赽	𧻯	
趀	𧾒	
趁	趂 𢌝 跈 𲣫	
趂	趁	
趄	跙 𨒚 䞡 𥩢 𧼀 𧻾 𧽀	
超	𧺽	
趆	𧺽 𧻎 𧺦	
趉	𧿺 𧺖 䞷 𧺐	
越	𦈭 𧻂 𲃊	
趋	趨	
趌	𨀙	
趍	𧻬	
趏	𧽂	
趑	赼	
趒	跳	
趓	𧻞	
趕	赶	
趗	𧻻	
趙	赵 𱚣 𲆏	
趛	𧾏 赺	
趟	䠀	
趠	𢔄	
趣	𧻃 𠮋 𧺥 𧻽 趨 𧼝	
趥	䠓	
趦	𧾒	
趨	趋 𧻬 趍 𧼜 𧻫	
趩	𨅜	
趫	𰷶	
趬	𰷵 蹺	
趮	躁	
趯	躍 䢰 𧾟	
趰	趂	
趱	趲	
趲	趱 䟎	
足	𤴕 𠯁 𲧱	
趶	𧿉	
趸	躉	
趹	𨀆	
趺	呋 𠰵 𨁜	
趼	𥀹	
趽	𨁳	
趾	䟖	
趿	𢕬	
跂	𠈮 𧿍 𨀣 𩨝	
跃	躍	
跄	蹌	
跅	𨂫	
跇	𧻸 𧿱 𨂰 𨒧 𧼪 𧽁 𧺿	
跈	䟢 𨀀	
跋	䟦	
跌	趃 𳃑	
跎	𧿶	
跐	𧿿	
跑	𨀓	
跖	蹠	
跗	𨁵 趺 𧿤	
跘	𨀷	
跙	趄 𨆄	
跚	𨀢	
跛	𨈵 㝿 𤿑	
距	𧣒	
跞	躒	
跟	𦚣 𣥦 𨁞	
跡	蹟 迹 䟱 𨖊 䟢 𨒏 𨒪	
跤	𨃤	
跥	跺	
跨	𨁣 𨀗 㐄 𨃖 𧿾	
跩	𱖕	
跪	𥜏 𨅠 𧻜	
跫	𧿖	
跬	蹞 䞨 𨇪	
路	𡽘 𨱴	
跲	𨕽	
跳	趒 𨁓 䟭 𨃜 𨁔 𧿮	
跴	踹	
践	踐 𱗭	
跶	躂	
跷	蹺 屩	
跸	蹕	
跹	躚	
跺	跥	
跻	躋	
跼	𨄙	
跽	𨃡 𦜕	
跾	𨁀 𢢱 𢞣	
跿	𨃝	
踁	硜	
踂	踙	
踅	䠠	
踈	疎 疏 䟽	
踊	踴 䞻 𧻹	
踌	躊	
踏	蹋 躢 蹹 𨆀 𨅵	
踐	践	
踑	𨅤 𧿄 䟚 𨄎	
踒	𨄖	
踔	趠 𢔄 𳄦	
踕	𨄀	
踖	藉 躤 趞 𧾀 𨅦 𨆮 𱱈	
踚	𬦧	
踛	𨅩	
踡	䠰	
踢	踼 𰸄	
踣	𧻳 䞳 䟔 䞸 𧽴 𧽂	
踤	𧺒	
踧	𨁕 𨀚	
踨	蹤 踪	
踪	蹤 踨	
踫	𨂝	
踬	躓	
踭	㬹	
踯	躑	
踰	逾 𡫞 𨄫	
踱	𨀟	
踳	𨅱 堾 蝽 僢	
踴	踊 𨃒	
踵	歱 𣦟	
踶	𨁃	
踸	𲃘	
踹	跴	
踻	𨀩	
踼	𨆉 𨃠 蹚 𨄆 𰸄	
踽	偊	
蹀	𨂏 𨁻 𨅈	
蹁	𨇱	
蹄	蹏 𨄪 𨂶 𨀭	
蹇	𨇥 䮿	
蹈	𨂆 𰸁	
蹉	𨇏 𲃽	
蹊	𤲺	
蹋	蹹 踏 躢 𨆚 𱤻	
蹌	牄 跄 𦭫	
蹍	𨃨 𧿸	
蹎	𨈃 𧽍	
蹏	蹄	
蹐	𨇋	
蹑	躡	
蹒	蹣 𲃢	
蹓	𰜈	
蹔	𫏐 𲱐	
蹕	跸 𠌫 驆 𢕏 䟆 𧫤	
蹗	𨄭	
蹙	𨇳 䠞 𠏔 顣 𨈄 𠑯 𳂪	
蹚	𨅨	
蹛	䠠 𰸚 𢅊	
蹝	屣 躧 𡱦 𩎉 𨁾	
蹟	跡 迹 𧶷 𲃫	
蹠	跖 𨂂 𱴰	
蹡	𬧀 𧽩 𨄚	
蹢	豴 躑 𨅙	
蹣	蹒	
蹤	踨 踪 𧿛	
蹥	𰸔	
蹧	遭	
蹩	䠥	
蹪	𰸞 𨇚	
蹮	躚	
蹯	番 𣫯 𨆜 𩕈 𨅴 𨆌 𨁢 𥸨 𥻫	
蹰	躕	
蹱	徸	
蹲	𨀛 𣦝 𧿬	
蹳	𫏆 𨅢	
蹴	蹵 𨇳 𨉌	
蹵	蹴	
蹶	𨄬 嶡 𧽸 𨇭 𨇙 蹷 𨇮	
蹸	躙 轥 𨆴	
蹹	蹋	
蹺	屩 蹻 跷 𣦜	
蹻	蹺 屩 𫏋 𣦜 𨃧 勪	
蹿	躥	
躀	𬦻	
躁	趮 𨅶	
躂	跶 𨂧 𨂨 𨂛	
躃	𲄑	
躄	躃 𣦢	
躅	䠱 𨅛 𨁿 𨄃	
躇	𣦡 䠧	
躉	趸	
躊	踌 𨅡	
躋	隮 跻 𢁃 𨹶 𤼥 𨻕 䠁 𨹷	
躍	趯 跃 䠯	
躎	䟢	
躏	躪	
躐	𨆍 邋	
躑	踯 蹢 𨅙	
躒	跞	
躓	踬 䠦 𨆑 𨕽 𨂤 𨆦	
躔	𧾡 𨂷 𲄈	
躕	蹰 𨅒 䟞	
躖	𨇔 䠪 𨇰	
躗	躛	
躘	𨀁	
躚	蹮 跹 𢕖 𨇴 𨇤 𨇫	
躛	躗	
躜	躦	
躝	𨅬 𲃯	
躞	𲄕	
躟	忀	
躠	𨆳 𨇨	
躡	蹑 𧿜	
躣	忂	
躤	藉 踖 𨆮	
躥	蹿	
躦	躜 𨇇 𨇃	
躧	屣 蹝 𰸐	
躪	躏	
身	𨊘 𡰬	
躬	躳 𨈴	
躭	耽 眈	
躯	軀	
躰	骵 體 軆 体	
躱	躲	
躲	躱 軃 𩒜	
躳	躬	
躴	𨉰	
躶	裸	
躷	矮	
躺	𲄲	
躼	𲄚	
躿	𨈢	
軀	躯 𨈬 傴 𨊘 塸 鏂	
軁	𲄧	
軂	𬧤	
軃	𰹀	
軄	職	
軆	躰 骵 體 体	
軇	𨉔 𮜶	
軉	𨉗	
車	俥 车 𠦴 𨏖	
軋	轧	
軌	轨 𧗢 𧗝 𨑍 軓	
軍	军 𡗽 𦉼 𠣦 𡨏 𡗺 𠣞	
軎	𰹲	
軏	𫐄 䡇	
軑	轪 軚 𲄳	
軒	轩 𨍓 𨊻 𩋱 䡓	
軓	𨊠 𰹴	
軔	轫 杒	
軕	𫐅	
軖	𰹶 軠 𨌂 𨌃	
軗	𨐅 毄	
軘	𨊯 𰹸	
軚	𮷗	
軛	轭 軶 枙	
軜	𫐇 𨌣	
軝	𬨂 䡋	
軞	𬨁	
軟	輭 软 媆 𥎘 轜 𨉿	
転	轉 转	
軣	轟 轰	
軤	轷	
軥	𨊵 𰺁	
軧	𨌮 𨋆 𰺀 𨋇	
軨	𫐉 䡿 䡼	
軩	𨊺	
軫	轸 𨏤 𨋏 𨋎	
軬	𨋒 桳 𠫿 㮥 輽 𫐊	
軮	𬨄	
軯	𰹽	
軰	輩	
軱	𮝴	
軲	轱	
軳	𰺂	
軵	𰹿 搑 𨍷 𨊶 𩒷	
軷	𫐈	
軸	轴 𨌇	
軹	轵	
軺	轺 𨍳	
軻	轲	
軼	轶	
軽	輕 轻	
軾	轼	
軿	輧 𫐌 𨍍 𲄹	
輀	𮝵 輭 轜 𨎪	
輁	𰺄	
輂	𰺅	
較	较 䡈 𨊿	
輄	𨐈	
輅	辂 𨍇 𨎲	
輆	𬨇	
輇	辁	
輈	辀 𨏺 𳄄	
載	载 𡙚 𨌏 𢀃 𡔬 儎 𡙺 𤱱	
輊	轾 𨏡 䡹 𨎘 𨎌 軽 𨏅 𨍀 𦥎 𨏑 𨎐	
輋	𪨶	
輌	輛 辆	
輍	𨌯	
輐	魭 𰺇	
輑	𰺈	
輒	輙 辄	
輓	挽 𬨈	
輔	辅 𥙷 俌 𨊽	
輕	軽 轻 輊 𨌷 䡖 𨓷	
輖	𫐏	
輗	𫐐 𨌊 䡚 𨌵 棿	
輘	𰺊	
輙	輒 𰺋	
輚	𰹼 轏	
輛	輌 辆	
輜	辎 輺 𨍟 𨎜	
輝	煇 辉 灳 𤐕 𪏕	
輞	辋 𨋹 棢 𨊾	
輟	辍 𨌸	
輠	𨍹 𨍋 𰺍 楇	
輡	𰺐	
輢	𫐎	
輣	𰺏 𨍩	
輤	𰺉	
輥	辊 𨍲 𨎊	
輦	辇 𨘪 𨍻	
輧	軿	
輨	𫐑	
輩	軰 辈	
輪	轮	
輫	𰺎	
輬	辌 𨎅 䡙	
輭	軟	
輮	𫐓	
輯	辑 𨍾 𨍣 𨌖 𨎵	
輲	𰺒 輇	
輳	辏	
輴	𮝸 𣚆 𨋮 䡅	
輵	轕 𬨍	
輶	𬨎 輏	
輷	𨊷 𩧕 𨌨 𫐒	
輸	输	
輹	𨌥 𨎙 𨏟 𨋩 𰺓	
輺	輜	
輻	辐 㽬	
輼	轀 辒	
輾	辗 𥗷 𨋚 𣡃	
輿	轝 舆 𱘿	
轀	輼 辒	
轁	𮷝	
轂	毂 𨍔 䡰	
轃	𨍬 𰺖	
轄	鎋 辖 輨 𩏓 舝	
轅	辕	
轆	樚 辘 𨏔 𨌠	
轇	𫐖 𨎦	
轈	𬨓 𨏋	
轉	転 转	
轊	𫐕	
轍	辙 𨏁 𨏣 𳍽	
轎	轿 𨎄 𲄶	
轏	𰺞	
轐	𫐗	
轑	𰺛	
轒	𨎾 𮝷 𨎨	
轓	𰺜	
轔	辚 𨏏	
轕	輵 𮝺	
轖	𰺙 𩍙	
轗	㙳 𨎕 𫐘	
轘	𨏙 𮝹	
轙	𰹵 𨏢	
轚	𰺟	
轛	𣝉 𰺃	
轝	輿 𬛼	
轞	𨏊 𰺗 𨍒	
轟	軣 轰 𨎇 𨋮 𨋌 𨊷 輷 𮷛	
轠	𨏒 𫐙	
轡	辔 𨏯 𦆕 𦇷 𣦱 𢢦 𢥩 𱺍 𳄋	
轢	轹 轣 𨍮 𨏬	
轣	𫐆 𨏽	
轤	轳 䡎	
轥	轔 𰺣	
车	伡 車	
轧	軋	
轨	軌	
轩	軒	
轪	軑	
轫	軔	
转	轉 転	
轭	軛	
轮	輪 𱭓	
软	軟	
轰	轟 軣	
轱	軲	
轲	軻	
轳	轤	
轴	軸	
轵	軹	
轶	軼	
轷	軤	
轸	軫	
轹	轢	
轺	軺	
轻	輕 軽 𱭐	
轼	軾	
载	載	
轾	輊	
轿	轎	
辀	輈	
辁	輇	
辂	輅	
较	較	
辄	輒	
辅	輔	
辆	輛 輌	
辇	輦	
辈	輩	
辉	輝	
辊	輥	
辋	輞	
辌	輬	
辍	輟	
辎	輜	
辏	輳	
辐	輻	
辑	輯	
辒	轀 輼	
输	輸 𰹰	
辔	轡 𲄻	
辕	轅 𰹷	
辖	轄	
辗	輾 𰍰	
辘	轆	
辙	轍 𰹹	
辚	轔	
辛	𨐋 亲 𨐌	
辜	𡲞 𡱨 𨐞 𢩍 𢪿 𤿛 𨑀 𣧮 𢻄 𲅈	
辞	辭 辤	
辟	避 𠈳 闢 𦜺 𨐝 辥 𠊸	
辠	罪	
辢	辣	
辣	辢 𨐜	
辤	辭 辞	
辦	办	
辧	弁 辨 辯	
辨	弁 辧 辯 㸤 𧪔 𨐾	
辩	辯	
辫	辮	
辭	辤 辞 𤔧 𤔲 辝 𦧦 𨐲 𲁦	
辮	辫	
辯	辨 弁 辧 辩 𧭿 䛒 𧦪 𧮀 𧪔 𧦬 𨧕 𧩵	
辰	𠨷 𠩟 𠂮 𨑄 𠨱 𨑃 𫝕	
辱	𢟲 𧗈 𢟹 𢛚	
農	莀 农 辳 𣊤 𨑋 𣎭 蕽 䢉 𦦤 𦵢 欁 𢖢 𨑆 𦦥 𨑇	
辵	辶	
辶	辵	
边	邊 邉 辺	
辺	邊 邉 边	
辽	遼	
达	達 逹 迏 迖	
迁	遷	
迂	遇 𨑛 迃	
迄	𨑐 𨑵	
迅	𨑷	
过	過 𲅒	
迈	邁	
迊	帀 匝	
迋	𨓒	
迌	𲟓	
迍	𨑞	
迎	迊 𨒦	
运	運	
近	𠧣 𣥍 𣥪 𣂠	
迒	𨁈 䢚	
迓	𨓃	
返	𢓉	
迕	忤 遌	
还	還	
这	這	
进	進	
远	遠 逺 𮷣	
违	違	
连	連	
迟	遲 遅 遟	
迢	𦴚	
迣	𨓄 𨒍 𨑬	
迤	迱	
迥	逈 㢠 䢛	
迨	逮 𨽿 𨾃	
迩	邇 𨒛	
迪	廸 𨔅	
迫	廹 敀 𤽐	
迭	疊	
迮	𨕠	
迯	逃	
述	䢤 𠰲	
迳	径 逕 徑	
迴	逥 廻 廽 回 囘 囬 𢌞	
迵	𲅿	
迷	𨒲	
迸	逬 𨔧 𲅡 𲅩	
迹	跡 蹟	
迺	乃 廼 𠧟	
迻	移 𢼏	
追	𱏞	
迾	𨔭 𨔜	
退	𢓴 𨘍 𨓤 𢓇 𨑧 𨔫	
送	㮸 𨕼 𨔮 䢠 𨕩 𨓵 𨕪 𲆇	
适	適 𨓈	
逃	迯 𨓱 𨓖 𨒯 𳄞	
逆	𨒫 𨒾	
逈	迥	
选	選	
逊	遜	
逋	𨗗 𨕝	
逌	𨔟 𠧠 𠧷 𠧴 𨘁 𨓗 𨓘 𨔖	
透	䞬	
逐	𢄘 𨔡	
递	遞 逓	
逓	遞 递	
途	涂 𡒎	
逕	徑 俓 迳 径 𮷠	
逖	逷 𮷡 𳄡	
這	这 𳄗	
通	𨓛 𢓶	
逝	䠠	
逞	呈	
速	遫 𧫣 遬 𩦙	
造	䒃 𨒽 𧻰 𨕡 艁 𦹢	
逡	𢓭	
逢	逄	
連	连 𨘑	
逥	迴 廻 廽 回 囘 囬	
逦	邐	
逩	奔	
逪	𨗀	
逬	迸	
逭	𩁧 𨙕 䠉	
逮	迨 𨗻 𨓻	
逰	遊 游	
週	周	
進	进 𨙟 𡥦 𨗃	
逵	馗 㙺	
逶	㣦 𨖿	
逷	逖	
逸	𠡓 𤖚 劮 𤖍 𲅶	
逹	達 达	
逺	遠 远	
逻	邏	
逼	偪	
逾	踰 𧼯	
逿	𧼮 𨗪 𰺲 𱭀	
遁	𨆛 𨔡 䞺 遯 𳄽 𮟦 𳄨 𨖡 𨙆 𠎻 𨘹 𱥈	
遂	𨔱 𨓸 𨔲 𨒉	
遄	𨒎 𨖇 𨖺	
遅	遲 遟 迟	
遇	迂 𠓱	
遉	𲅗	
遊	逰 游 𨒰 𨒣 𨓗 䢟 𨓎 䢊	
運	运 𨔪	
遍	徧 𨖠 㴜	
過	过 𨓺 𲅒	
遐	徦	
遑	徨	
遒	逎	
道	𧗟 衜 𨗓 𡬹 𲜣 噵 𨔞 衟 𧗞 𨕥 𨕐 𨖁 𱥅 𲀣	
達	逹 达 𫐳 𨖫 𨔬	
違	违	
遖	𳅂	
遗	遺	
遘	𧽝 𢔵	
遙	遥 𨗽 𨖈 𨓧 𨔚	
遛	𨖻 𰜈	
遜	愻 逊	
遝	𨓬	
遞	逓 递 𨓝 𨒾 𨔛 𨕑 𨘬	
遟	遲 遅 迟	
遠	逺 远 𨖸 𢕱	
遡	溯 泝	
遤	𲅎	
遥	遙	
遨	𨗯	
適	适 𨗁 𮷧	
遪	𨗘	
遫	𨔤	
遭	蹧 𨗐 𨙠 𨘜	
遮	𨖥 𨖓	
遯	遁 𦟥 踲 𨙆 𳄽 𮟦 𨔡 𨘭 𳄨	
遰	𨘬 𰻆	
遱	𨘠 𫐷	
遲	遅 遟 迟 邌 𨒈 赿 迡	
遴	𨗄 䢯 𨖉	
遵	𨘊 𨗕 𢕰 𢍲 𰃝	
遶	繞 𰺷	
遷	迁 𨒿 𨙙 𨙘 𨙞 𨕞 𨗺 䢬 拪 𨗢 𢫥 𱥇 𳄭	
選	选 𨕖 𲅦	
遺	遗 𧸯 𨗮 𨗭 𧸃 𧸽 𨗔 𢸦	
遻	𨕓 𨕣 遌	
遼	辽 𢊻	
遽	𱝹 𲅥	
避	辟 𢕾 𨓶	
邀	𨖟	
邁	迈 𨙚	
邃	𢤪 䆳 㥞 𥤼 𢢝	
還	还 𨕔 𨖞 𨘣 𢕼	
邅	㣶	
邇	迩 𨒛 𨖹	
邈	𨙁 𨓅 𨘅 𨘷	
邉	邊 辺 边	
邊	邉 辺 边 𨓉 𦍇 𨓙 𨘢	
邍	𨙅	
邏	逻	
邐	逦	
邑	𡇃	
邓	鄧	
邔	𨙬	
邕	雍 𪪝 𡿷	
邘	𨙱	
邛	卭	
邝	鄺	
邠	豳 㟗	
邢	郉 𨙷	
那	𨚗 䢷 郍 𨚉 𨙻 𣟎 𢑽	
邦	𨚚 邫 峀 䢶 𤰫 𨛁 𨛟 邽 𱛖	
邨	村	
邩	𨚋 𨚊	
邪	𧘪 衺 耶 𲛎	
邬	鄔	
邮	郵 𨛕	
邯	𨚠	
邱	𨛆 𨚬	
邲	𱑘	
邳	𨛧	
邶	𨚍	
邸	𨚏 䣌 邱	
邹	鄒 𱜃	
邺	鄴	
邻	鄰 隣	
邼	𨝇	
邽	郌	
郀	𨚛 𨜆	
郁	喐 鬱 鬰 欝	
郄	隙 郤	
郅	胝	
郇	𨝁	
郈	𨜸 𨚨	
郉	邢	
郍	𱼶	
郎	郞 𨝥	
郏	郟	
郐	鄶	
郑	鄭	
郓	鄆	
郖	𨜹	
郚	䦜 𨵒	
郛	𡎽 垺	
郜	𨜋 𠰛	
郝	𳅆	
郞	郎	
郟	郏	
郠	𨜦	
郡	𨛦	
郢	𨙼 𱡩	
郤	郄 隙 𨜪 𨚥 𠜗 𨛠	
郦	酈	
郧	鄖	
部	卩 郶 𨛔 𰆊	
郭	𨟍 墎 𩫏 𨽏 𠆀 𩫃 𩫩 𱥅	
郯	𨞇	
郰	鄹 𨝮	
郲	𬩾	
郵	邮 𨞄 𨜚 𨜲 𲓷	
郷	鄉 鄕 乡	
郸	鄲	
郹	鄓 𨜯 郥	
郺	𡗌	
都	𨜁 𨟞 𨛷 𨚼	
郿	𨞅	
鄂	𨟨 𨞍 䣞	
鄄	𨞉	
鄆	郓	
鄉	鄕 郷 乡 𨜮 鄊 𨞸 𨞰	
鄋	𨜛	
鄑	𨝶 㬐 𨟕	
鄒	邹 鄹 𨝮 𨛄 𨜈 𨛃	
鄔	塢 邬	
鄕	鄉 郷 乡	
鄖	郧 䢵	
鄗	𨛴 䧚	
鄙	𨝣 啚 𠴿 𨚍	
鄜	𨟤 𨞻 𨝧	
鄝	𨝷	
鄟	䧠 𫑘	
鄠	𨛸	
鄡	鄥 郻 𰻮 𨜑	
鄢	𨺆 𨽑 𨻳 𲉟	
鄤	𨞼 𨟔	
鄦	𨝬 𰻡 𲆜	
鄧	邓 𲓱	
鄩	𬩽 𨟈	
鄪	𨚓 𨚭 𰻳	
鄬	䧦 𰻦	
鄭	郑 𨞀	
鄮	𨞵 𬪍 𲆝	
鄰	隣 邻 𨞁 厸 吅 𨞧 𨽃	
鄲	郸 𨞏	
鄳	𫑡 𨞚	
鄴	邺	
鄶	郐 𨞡	
鄷	酆	
鄸	𨞯 𨟁	
鄹	郰 𨜈	
鄺	邝	
酂	酇	
酃	𨟘 𨟮 𨞖 𨞎 𨟯	
酄	𨽧 𨞂	
酅	𨟎	
酆	鄷	
酇	酂 鄼	
酈	郦 𨜥 𨟫	
酉	丣	
酋	醔	
酏	𨠑 𨡪	
酒	𨠆 𨠊	
酓	𨟹	
酔	醉	
酖	鴆 𨠁	
酗	𨠮 䣱 䣴 𨠯 𳅐	
酝	醞 醖	
酡	𨠑	
酢	醋	
酣	佄	
酥	𦣑 𦢦 𨢭 𨣺 䜹	
酦	醱 醗	
酧	酬 醻 詶	
酨	𨠾	
酩	𠋶 佲	
酪	𠄇 嗠	
酬	醻 酧 詶 𨢫	
酱	醬 醤 𪧷	
酴	𨢬	
酵	𨣑 𨢀	
酶	䊈	
酸	痠 𲱷 𨣪 𨢽	
酹	𩛝	
酽	釅	
酾	釃	
酿	釀 醸	
醃	腌 𳐙	
醅	𨟷 𨡋	
醆	𬪨	
醇	䣩 䣨 醕 𨣳 𨣶 𲥬	
醉	酔 𨢛 酻	
醊	餟	
醋	酢 𨣋	
醍	䣽 𨠏	
醐	𨡷 𨠂 𨠀	
醑	𨡠 𨢺	
醓	𧖺 䏙 𨡍	
醕	𲆹	
醖	醞 酝	
醗	醱 酦	
醙	䤇 𨤇	
醚	𨡅	
醜	丑 𩳺 魗 𥆞 𨢄	
醝	𨣣 𨣩 𨢚	
醞	醖 酝	
醟	𨠕 𦟴	
醠	𨠗	
醡	榨 𨢦 𨣜 𥰾 𨣮 𨡗 𨢃 𨢛 𨢧	
醢	𧅽 𧆗 醘 酼 𨡝 𥂧	
醤	醬 酱	
醦	𮠳	
醧	𬪧	
醩	糟	
醪	𨣃	
醫	医 毉 𨢒	
醬	醤 酱 𤖙 𨡰 𨡓 𨟻 𤖕	
醮	𨣐 𥛲	
醯	𨣓 醘 𨤅 䤈 𩱗 𲆷	
醰	㽑 𨤌	
醱	醗 酦 䤆 𨡩	
醲	𨤉 𨠤 𬪩	
醳	𰼅 𨣠	
醵	𦟳 䣰	
醶	釅 𫑷	
醸	釀 酿	
醹	𨢾	
醺	𨤁 𲆫	
醻	酬 酧 詶 𲆭	
醼	宴 讌 燕	
醽	𨤍 𨤀 𨣖 𨠎	
醾	釄 醿 𨣿	
釀	醸 酿	
釁	衅 舋	
釂	𣤚 𣤹 𨤊	
釃	酾 𦌿	
釅	酽	
釆	采 採 埰 𠂠 𤓳	
采	釆 採 埰	
釈	釋 释	
释	釋 釈	
釋	釈 释 𥼶	
里	裏 裡	
重	𡍴 𡍺 𨤣	
野	埜 𡐨 㙒 壄	
量	𨤥 𨤦 𱔱 𰅊	
釐	厘 𣯕 𨤺 𡪂 𨤭 𲓉	
金	釒 钅 𨤾 𨥀 𨥄	
釒	金 钅	
釓	钆	
釔	钇 釶 𳀩	
釕	钌	
釖	刀 劍	
釗	钊	
釘	钉	
釙	钋	
釚	䤛 𫟲 𨥐 釓	
釛	𰽖	
釜	釡 𠿽 𩱉 𨥏 鬴	
針	箴 鍼 针 䥠	
釟	𫓥	
釡	釜	
釣	钓 鈟	
釤	钐	
釥	𰽛	
釦	𬬪	
釧	钏	
釨	鋅 𫓦	
釩	钒 𳀫	
釪	𰽗	
釫	𬬨	
釬	銲 𬬧 𱖇	
釭	𨊧 𮣲	
釮	𲇭	
釰	釼 劍 劎 劒 劔 剣 剱 𲇰	
釱	𰽘 鉪	
釲	𫟳 鈻	
釳	𨰿 𨥊	
釴	鉽 𬬩	
釵	钗	
釷	钍 𳀝	
釹	钕	
釺	钎	
釼	釰 劍 劎 劒 劔 剣 剱	
釽	䤨 𬬲 鈲 𨦝	
釾	䥺 鎁 鋣	
釿	𬬱	
鈀	耙 钯	
鈁	钫	
鈂	𬬵 𣜣 䤟	
鈃	钘 𦈨 㐩 㼛 𦈵 𨨵 𤭓 銒	
鈄	钭 𨥪	
鈆	鉛 𫓪	
鈇	𫓧	
鈈	钚	
鈉	钠 𳀬 𳆸	
鈊	𲇴	
鈋	𨱂	
鈌	𨥻 𰽤	
鈍	钝 𨆛 𫒇 䤜	
鈎	鉤 钩	
鈏	𰽣	
鈐	钤 𨥩	
鈑	钣	
鈒	钑	
鈓	𬬯	
鈔	钞 抄	
鈕	钮 㺲	
鈖	𫟴	
鈗	𫟵 䤞 鏸	
鈘	𲇱	
鈙	鈘	
鈚	𬬫 鎞	
鈛	𫓨	
鈜	𮣳	
鈞	銁 钧 𨥒 銞	
鈠	𨱁 𨦯	
鈡	鐘 鍾 钟	
鈣	钙	
鈤	𰽡	
鈥	钬	
鈦	钛	
鈧	钪	
鈨	𮷸	
鈪	𰽞	
鈬	鐸 铎	
鈮	铌 鉨 𲨠	
鈯	𨱄	
鈰	铈	
鈱	𲇸	
鈲	𨱃	
鈳	钶 錒	
鈴	铃	
鈵	𰽥	
鈶	𬭀	
鈷	钴	
鈸	钹	
鈹	铍 鈈 鉟	
鈺	钰	
鈼	𬬽	
鈽	钸	
鈾	铀 𳀘	
鈿	钿 䥖 𨰎	
鉀	钾 鑉 甲	
鉁	𨱅	
鉄	鐵 鐡 銕 铁	
鉅	巨 钜	
鉆	鑽 鑚 鉗	
鉈	砣 铊 𥓿 釶 𳅷 鉇 𥍸 𨧯 𥍢 鍦	
鉉	铉	
鉊	鍣 𬬿	
鉋	刨 铇 䥤 𨥹	
鉌	𰽬	
鉍	铋 𳆣	
鉎	𰽫 鍟	
鉏	鋤 耡 𬬺	
鉐	𬬷	
鉑	铂	
鉒	𰽯	
鉓	䤭	
鉔	𫓬	
鉕	钷	
鉗	箝 鉆 钳 䈤 𥮠	
鉘	𰽱	
鉙	𰽨	
鉚	铆	
鉛	鈆 铅 𲙍	
鉜	𰽮 錇	
鉝	𫟷	
鉞	戉 钺 𨬓 鋮 銊 鈛 䤦 鐬	
鉟	𰽧	
鉠	鍈 𫓭	
鉡	𰽰	
鉢	缽 钵	
鉣	𨧶 𨦲	
鉤	鈎 钩 𨪋 𰽭	
鉥	銝 𬬸	
鉦	钲	
鉧	𬭁	
鉨	鿭	
鉩	鈢	
鉬	钼	
鉭	钽	
鉮	𬬹	
鉱	礦 砿 鑛 卝 矿	
鉲	𰽩	
鉴	鑒 鑑	
鉵	𰽶 𨰍	
鉶	铏 䤯 𨦿	
鉷	𫟹	
鉸	铰	
鉹	𰽹 𨥌	
鉺	铒	
鉻	铬 𳆰	
鉼	𰽼	
鉽	𫟸	
鉾	𫓴 𨦜	
鉿	铪	
銀	银 艮 𨧏	
銁	鈞 𫓲	
銂	𫟻	
銃	铳	
銅	铜	
銈	𫓯	
銊	𫓰	
銋	鈓 𰽻 𳅽	
銌	𲇻	
銍	铚 𨧓 𨧵 𨫐	
銎	𨥲 𨥍 𨩹 𨥢 𨧎	
銏	𫟶	
銐	𨦙 𨨬 𨧳	
銑	铣 鍌	
銓	铨 硂	
銔	𬭃	
銕	鐵 鐡 鉄 铁	
銖	铢	
銗	𬭅	
銘	铭 詺	
銙	𩊓 𰽴	
銚	铫 鑃 鋽 𨰑	
銛	铦 𨨱 銽 𲻕	
銜	衔 㘅 衘 啣 䘖	
銠	铑	
銡	𰽲	
銢	䤨	
銣	铷	
銥	铱 𳆒	
銦	铟	
銧	𰽵	
銨	铵 𳇃	
銩	铥	
銪	铕	
銫	铯	
銬	铐	
銭	錢 钱	
銮	鑾	
銱	铞	
銲	釬 𬭍	
銳	鋭 锐 𨦣 𨧨 㓹 鈗	
銴	𨦬	
銶	𨱇 䤛 釚 𨥐	
銷	销 焇	
銸	𰽿 鋷	
銹	鏥 鏽 锈	
銻	锑 厗 𳅺	
銼	锉	
銾	𰾁	
鋁	铝 𳇤	
鋂	𰾄	
鋃	锒	
鋄	錽 𨩵 𨥧 鎫 𨧴 䥑 𨬄	
鋅	锌 𳆟	
鋇	钡 𳆹	
鋉	𨱈 䥔	
鋊	𰾆	
鋋	𮣴	
鋌	铤	
鋍	𰾀	
鋏	铗	
鋐	𬭎	
鋑	鐫 鑴 𮸏	
鋒	锋 𨦟 鏠	
鋓	𮸊	
鋕	𲇽	
鋖	鐁	
鋗	𫓶	
鋘	鋙 𬭌	
鋙	铻 䥏	
鋚	𨦷 鎥	
鋜	𰾃	
鋝	锊 𨫏 鋢	
鋟	锓	
鋠	𫓵	
鋡	𰾅	
鋣	铘	
鋤	耡 鉏 锄	
鋥	锃 䂻 𲸻	
鋦	锔 𨧙 𨦴	
鋧	𰽢	
鋨	锇	
鋩	铓 釯 𲇗	
鋪	舗 舖 铺 𠁃	
鋬	𨥃	
鋭	銳 锐	
鋮	铖	
鋯	锆 𳀪	
鋰	锂	
鋱	铽 𳆠	
鋲	𲇿	
鋳	鑄 铸	
鋶	锍	
鋸	锯	
鋹	𬬮	
鋼	钢 鎠	
鋾	𰾏	
鋿	鑜 鏛 𲈆	
錀	𬬭	
錁	锞	
錂	𨱋	
錄	録 录 𧧱	
錆	锖 䥊	
錇	锫	
錈	锩	
錉	鍲 鈱 䝧	
錋	镚 𬭖	
錍	𰾎	
錏	铔 鐚	
錐	锥	
錑	𬭜 銇	
錒	锕	
錔	𰾓	
錕	锟	
錗	𬭗	
錘	鎚 锤 𨪼 𨫻 𨭇	
錙	锱 鍿	
錚	铮 𨭗 鏳	
錛	锛 鐼	
錜	𫓻	
錝	𫓽	
錞	鐓 𬭚 𨯢 𳆙	
錟	锬	
錠	锭	
錡	锜 鈙	
錢	銭 钱 𫢊 㦮	
錣	𮣵 𨧨	
錤	𫓹 𳇑	
錥	𫓾 𳇦	
錦	锦 𣁙	
錧	𰾒 輨	
錨	锚	
錩	锠	
錪	𨮔 𬭓	
錫	锡 㒪 鍚	
錬	鍊 煉 炼 𲇷	
錭	鋾 𬭕	
錮	锢	
錯	错 𠪞 逪 䥄 䥘	
録	录 錄 𲈊	
錳	锰 𳇨	
錴	𲈁	
錶	表 𰾍	
錸	铼	
錺	𮸐	
錽	鋄 𫓸 𲋸	
錾	鏨	
鍀	锝	
鍁	锨	
鍂	𰾑	
鍃	锪	
鍄	𨱉	
鍆	钔	
鍇	锴	
鍈	锳	
鍉	匙 𫔂	
鍊	煉 錬 炼 𫔀 𮸀	
鍋	锅 𩰭 𢧘 鈛	
鍍	镀	
鍎	𨨷	
鍏	𬬬	
鍐	𰾞	
鍑	𰾟 鍢 𨫙	
鍒	𫔄	
鍔	锷 㓵 鑩 𨫘	
鍕	𮸈	
鍖	𰾘	
鍘	铡 䥷 𨰉 𳇣	
鍚	钖 鐊 𩋬	
鍛	煅 锻 𨪇 碫 鍜	
鍜	煆 𰾤	
鍝	𰾙	
鍟	𰾝	
鍠	锽 𨪽 鐄 鑅	
鍡	𰾚	
鍢	𮸕	
鍣	𨪓 𬭡	
鍤	锸	
鍥	锲 鐑 䥛 㓶 䤿	
鍦	𤟽 釶 鉇 𰾢 𥍸 𥍢	
鍧	𰾡 𨰌 𳁱	
鍨	𰾥	
鍩	锘	
鍪	䥐 𨩺	
鍫	鍬	
鍬	鍫 锹 喿 𠝡 𢊙	
鍭	𬭤	
鍮	𨱎 𨪐 鋀	
鍯	𬭥	
鍰	鐶 锾	
鍱	𨧲 𰾕 䥡 鐷 𨬘	
鍴	𰾜	
鍵	键 鑳 𨭙 楗 𨵭	
鍶	锶 𳀛 𳇢	
鍷	𲈌	
鍸	鈷 𲈋	
鍹	𲈎	
鍺	锗	
鍼	針 箴 䥠 𰾗	
鍾	鈡 钟 锺 鐘 斔 𦉂 螤	
鍿	錙	
鎁	𲈍	
鎂	镁 𳇔	
鎄	锿	
鎅	𰾛	
鎇	镅	
鎈	𫟿	
鎉	𰾬	
鎊	镑	
鎋	轄 𬭪	
鎌	鐮 劆 䥥 𰾮	
鎍	𫔅	
鎎	𥎃	
鎏	鏐	
鎑	𰾩	
鎒	耨 鐞 𬭦	
鎓	𬭩	
鎔	熔 镕	
鎕	𰾯	
鎖	鏁 鎻 锁	
鎗	鏿 𬬰	
鎘	镉 𨬑 䥶 𳇧	
鎙	槊 𫔈	
鎚	錘 𨮀 𬭨	
鎛	镈 𳇋	
鎝	𨱏	
鎞	𫔇 𲇚	
鎡	镃	
鎢	钨	
鎣	蓥	
鎤	𲈒	
鎦	镏 鐂 磂	
鎧	铠	
鎩	铩 𨭝 𨨽 𨦅	
鎪	锼 䤹 鏉	
鎬	镐	
鎭	鎮 镇	
鎮	鎭 镇 𨥵 𨦸 鍞	
鎯	𨱍	
鎰	镒	
鎲	镋 钂	
鎳	镍 𳆮	
鎵	镓	
鎶	鿔	
鎷	𨰾	
鎻	鎖 鏁 𳆮 锁	
鎿	镎	
鏁	鎖 鎻 锁 𬭲 𳆮	
鏂	𰽜 𠥺 𨫕	
鏃	镞 䃚 鋜 鉃 𥎫 𥏀 𳇟	
鏄	𲇲	
鏆	𨱌	
鏇	镟 旋	
鏈	链 䃛	
鏉	𨱒 𢑶	
鏊	𨪠 𨮽 𳐿	
鏋	𬭮	
鏌	镆	
鏍	镙	
鏏	𬭬 鏸	
鏐	鎏 镠 𨦰	
鏑	镝 鍉 𨬙	
鏒	𬭝	
鏓	𰾱 𨬃 鍯	
鏔	𬭰	
鏕	𰾲	
鏖	㩠 鏕 𳇓	
鏗	铿 銵 㧶 𲦂 鉺 鍞	
鏘	锵 𢐓	
鏙	𰾰	
鏚	𨭟 𬭭	
鏛	𮸟	
鏜	镗 鐺	
鏝	镘 槾 𨭜 墁	
鏞	镛 銿	
鏟	剷 剗 铲 刬 𩮲 𨲨 𠚿 𨪑	
鏡	镜	
鏢	鑣 镖 𨰐 𨭚	
鏤	镂	
鏥	銹 鏽 锈 𫔊	
鏦	𫓩 𥎋 䤸 𨥎 𨦱 𮷲	
鏧	䥢	
鏨	錾 鏩 𨮜 𳆲	
鏩	𰾌	
鏰	镚 斆	
鏱	𲈗	
鏳	𲈜	
鏴	𲈝	
鏵	铧 𨫽 釫 釪	
鏶	鍓	
鏷	镤 𨮓	
鏸	𰾶	
鏹	镪	
鏺	䥽 𨨻	
鏻	𬭸	
鏽	銹 鏥 锈	
鏾	𠜎 𫔌	
鐀	櫃 𬭢 匱	
鐁	𰾴	
鐂	鎦	
鐃	铙	
鐄	𨱑	
鐅	䥕	
鐆	䥙 鐩	
鐇	𫔍	
鐈	𫓱	
鐉	𰾼	
鐊	𬭏	
鐋	铴 𨧩 𨫖	
鐍	𫔎	
鐎	𨱓	
鐏	𨱔 銌	
鐐	镣 𨭼	
鐑	䥛	
鐒	铹	
鐓	镦 鐜 𨰩 𨰯 𨰮	
鐔	镡 𨰳	
鐕	𨯩 鐟 𰾷	
鐖	𰽕	
鐗	𨎫 𳄐 鐧	
鐘	鈡 钟 鍾 銿 𲈛	
鐙	镫 𨭕	
鐚	𰾪	
鐛	𲈚	
鐝	钁 镢	
鐠	镨	
鐡	鐵 鉄 銕 铁	
鐣	𳇲	
鐤	𰾸	
鐥	䦅	
鐦	锎	
鐧	锏 𲇏	
鐨	镄	
鐩	𬭼	
鐪	鏀 𫓺	
鐫	鋑 鑴 𳇕 镌 𨷫 𰾹 𩀟 鎸 䥴	
鐬	𰽷	
鐭	𨩬 𨪎 䥝	
鐮	劆 鎌 镰	
鐯	䦃	
鐰	𲈞	
鐱	𲈀	
鐲	镯 鉵	
鐳	镭	
鐴	𬭽 鐾	
鐵	鐡 鉄 銕 铁 𨫓 𨭓 䥫 鋨 𨮯	
鐶	鍰 镮 𨫑	
鐸	鈬 铎	
鐹	划 𰽾 𰼭	
鐺	铛 鏜	
鐻	𮣷	
鐼	𫔁	
鐽	𫟼	
鐿	镱	
鑀	𰾭	
鑁	𰾞	
鑄	鋳 铸 𨮾 𨮚 𤎧	
鑅	𳇯 𨪪 𮢚	
鑇	𬭉	
鑈	鉩 鿭 𨯡	
鑉	𳆴 𫠁 𲈘	
鑊	镬 𨯟	
鑋	𨮫 𰼻	
鑌	镔	
鑍	𲇑	
鑏	𬬾	
鑐	𰿂 𨬗	
鑑	鑒 鉴 𰾫 𨰲 鑬 𲇕 𮸖	
鑒	鑑 鉴 鍳	
鑔	镲	
鑕	锧	
鑖	𰿃	
鑗	𨬏 鏫 錅 鋫	
鑘	𨯔 𰿄	
鑙	𬭿 𨮺	
鑚	鑽 鉆 钻	
鑛	礦 砿 鉱 卝 矿 𰽚	
鑝	纄	
鑞	镴 𨭛	
鑠	铄 𨰤 𡤤	
鑡	𬭔 𨮷	
鑢	䥨 𮣶 鋁	
鑣	鏢 镳 𨯄 䮽 𧥍 𨮄 𲬡	
鑥	镥	
鑧	𮸠	
鑨	𰽦	
鑪	𬬻 𲈟	
鑬	𫔃	
鑭	镧 钄	
鑮	䥬 鎛 𬮁	
鑯	𰿈 𨯒	
鑰	钥 𨷲	
鑱	镵 䤫 𳆕 𰾠	
鑲	镶	
鑴	鋑 鐫 𳇕 䥴 𫔔	
鑵	罐 礶 缶 𲈡	
鑷	镊 鉨 鑈	
鑸	𰿉	
鑹	镩 𨭾 𳇌 𥎤 𲳀 𲵂	
鑼	锣	
鑽	鑚 鉆 钻 𰿆	
鑾	銮	
鑿	凿 𣫫 𨰒 𨖐 𣪲 𣫞 䥣 𣫩 𦦹 𣪻 𨗩 𪚆 𳆳 𨯳	
钀	𰾾	
钁	鐝 镢 䦆 矡	
钂	镋 鎲	
钃	𰾽 斸	
钅	金 釒	
钆	釓	
钇	釔	
针	針	
钉	釘	
钊	釗	
钋	釙	
钌	釕	
钍	釷	
钎	釺	
钏	釧	
钐	釤	
钑	鈒	
钒	釩	
钓	釣	
钔	鍆	
钕	釹	
钖	鍚 锡	
钗	釵	
钘	鈃	
钙	鈣	
钚	鈈	
钛	鈦	
钜	巨 鉅	
钝	鈍	
钞	鈔	
钟	锺 鐘 鍾 鈡	
钠	鈉	
钡	鋇	
钢	鋼	
钣	鈑	
钤	鈐	
钥	鑰	
钦	欽	
钧	鈞	
钨	鎢	
钩	鉤 鈎	
钪	鈧	
钫	鈁	
钬	鈥	
钭	鈄	
钮	鈕	
钯	鈀	
钰	鈺	
钱	錢 銭	
钲	鉦	
钳	鉗 箝	
钴	鈷	
钵	缽 鉢	
钶	鈳	
钷	鉕	
钸	鈽	
钹	鈸	
钺	鉞	
钻	鑽 鑚	
钼	鉬	
钽	鉭	
钾	鉀	
钿	鈿	
铀	鈾	
铁	鐵 鐡 鉄 銕	
铂	鉑	
铃	鈴	
铄	鑠	
铅	鉛	
铆	鉚	
铇	鉋	
铈	鈰	
铉	鉉	
铊	鉈	
铋	鉍	
铌	鈮	
铍	鈹	
铎	鐸 鈬	
铏	鉶	
铐	銬	
铑	銠	
铒	鉺	
铓	鋩	
铔	錏	
铕	銪	
铖	鋮	
铗	鋏	
铘	鋣	
铙	鐃	
铚	銍	
铛	鐺	
铜	銅	
铝	鋁	
铞	銱	
铟	銦	
铠	鎧 𮸛	
铡	鍘	
铢	銖	
铣	銑	
铤	鋌	
铥	銩	
铦	銛	
铧	鏵	
铨	銓	
铩	鎩	
铪	鉿	
铫	銚	
铬	鉻	
铭	銘	
铮	錚	
铯	銫	
铰	鉸	
铱	銥	
铲	鏟 剷 剗	
铳	銃	
铴	鐋	
铵	銨	
银	銀	
铷	銣	
铸	鑄 鋳	
铹	鐒	
铺	鋪	
铻	鋙	
铼	錸	
铽	鋱	
链	鏈	
铿	鏗	
销	銷	
锁	鎖 鏁 鎻 𲂫 𲃀	
锂	鋰	
锃	鋥	
锄	鋤 耡 𨱄	
锅	鍋	
锆	鋯	
锇	鋨	
锈	鏽 銹 鏥	
锉	銼	
锊	鋝	
锋	鋒	
锌	鋅	
锍	鋶	
锎	鐦	
锏	鐧	
锐	銳 鋭	
锑	銻	
锒	鋃	
锓	鋟	
锔	鋦	
锕	錒	
锖	錆	
锗	鍺	
锘	鍩	
错	錯	
锚	錨	
锛	錛	
锜	錡	
锝	鍀	
锞	錁	
锟	錕	
锠	錩	
锡	錫 钖	
锢	錮	
锣	鑼	
锤	錘 𱫘	
锥	錐	
锦	錦	
锧	鑕	
锨	杴 鍁	
锩	錈	
锪	鍃	
锫	錇	
锬	錟	
锭	錠	
键	鍵 𰽢	
锯	鋸	
锰	錳	
锱	錙	
锲	鍥	
锳	鍈	
锴	鍇	
锵	鏘	
锶	鍶	
锷	鍔 𲇢	
锸	鍤	
锹	鍬 𫓱	
锺	钟 鍾	
锻	鍛	
锼	鎪	
锽	鍠	
锾	鍰	
锿	鎄	
镀	鍍	
镁	鎂	
镂	鏤	
镃	鎡	
镄	鐨	
镅	鎇	
镆	鏌	
镇	鎮 鎭 𰾂	
镈	鎛	
镉	鎘	
镊	鑷	
镋	钂 鎲	
镌	鐫	
镍	鎳	
镎	鎿	
镏	鎦 𰜈	
镐	鎬	
镑	鎊	
镒	鎰	
镓	鎵	
镔	鑌	
镕	鎔	
镖	鏢	
镗	鏜	
镘	鏝	
镙	鏍	
镚	鏰 錋	
镛	鏞	
镜	鏡 𰽟	
镝	鏑	
镞	鏃	
镟	鏇	
镠	鏐	
镡	鐔	
镢	鐝 钁 𰽤	
镣	鐐	
镤	鏷	
镥	鑥	
镦	鐓	
镧	鑭	
镨	鐠	
镩	鑹	
镪	鏹	
镫	鐙	
镬	鑊	
镭	鐳	
镮	鐶	
镯	鐲	
镰	鐮 劆 𰾮	
镱	鐿	
镲	鑔	
镳	鑣	
镴	鑞	
镵	鑱	
镶	鑲 𰽙	
長	长 𠔊 镸 𡕣 𠑿 兏 𠑷 𠤐 𠑻 𨱗 仧 𨱘	
镺	𨱧 𨱩 𮸤	
镻	𨱷	
镼	𩭪	
镾	𨲼	
长	長	
門	门 閅	
閂	闩 𣟴	
閃	闪 𱢚	
閄	𬮘	
閅	𮤫	
閆	閻 闫	
閇	閉 闭	
閈	闬	
閉	閇 闭 𨳓 𨳰 𨳲 𨵰	
開	开 𨴔 𨵑 𨴂 䦐 𫔭 𨶷 𨵹	
閌	闶 䦎	
閍	𨸂	
閎	闳	
閏	闰 𥹿 䦞 閨	
閐	𨸃	
閑	闲 䦥 閖	
閒	𨳡 𨳢 闲 𫔮 间 間	
間	间 𨳡 𨳿 閒 𨳢	
閔	闵 㥸 𱞘 𲈨	
閕	𰿩	
閖	𲈵	
閗	𫔯	
閘	闸	
閙	鬧 闹	
閛	䦕 𨳵 𰿬	
閜	𬮠 閕	
閝	𫠂	
閞	㭓 𫔰	
閟	𮤲	
閡	阂	
関	關 闗 关 𨶹 𬮦	
閣	閤 阁	
閤	合 闔 閣 阖 𬮤	
閥	阀	
閦	𨴠 𨴖 𨴨 𨴳 𬮥 𨴟	
閧	鬨 哄 𬮢	
閨	闺	
閩	闽 𨷷	
閪	𲈹	
閫	阃	
閬	阆 𨶈	
閭	闾	
閯	𬮪	
閱	閲 阅 𧢅	
閲	閱 阅	
閳	𳈑	
閵	𫔴 𨶄	
閶	阊 𨵷	
閷	𰿳	
閹	剦 阉	
閺	𨳶	
閻	闫 閆 阎 𨵀 𨵁 𨴫	
閼	阏	
閽	阍	
閾	阈 𨵨	
閿	阌	
闀	𲉁	
闃	阒 閴 𨵢	
闄	𬮲	
闅	閿 閺	
闆	板 𬮳	
闇	暗 晻 𬮴	
闈	闱	
闉	𨶾 𨶴 𬮱	
闊	濶 阔 𨶖 𨴿 䦢	
闋	阕 𨶋	
闌	阑 𨴨 䦨	
闍	阇	
闐	阗	
闑	𫔶	
闒	阘	
闓	闿 𲉄	
闔	合 閤 阖 𨵯 𨵵 𨵲	
闕	阙 𨴸 𨷂 𨵗	
闖	闯 𨳐	
闗	關 関 关	
闘	鬥 鬦 鬪 鬬 鬭 斗 𳈗	
闚	𨶳 𬮭	
闛	𰿺	
關	闗 関 关 𨳹 寡 閞 𨵈 𨶚 𫔢 𨳡	
闞	阚 𨶞 鬫 𮤜 𳈁	
闟	𰿻 𩰙	
闠	阓 𨷪 𳈇	
闡	阐 閳 𨴁 𨴝	
闢	𨴔 𰿾 𨵓 辟 𨳥	
闤	阛 𨷤	
闥	闼 𨵉	
门	門	
闩	閂	
闪	閃 𱢚	
闫	閻 閆 阎	
闬	閈	
闭	閉 閇	
问	問	
闯	闖	
闰	閏	
闱	闈	
闲	閑 閒	
闳	閎	
间	間 𱡹	
闵	閔	
闶	閌	
闷	悶	
闸	閘	
闹	鬧 閙	
闺	閨	
闻	聞	
闼	闥 𲈱	
闽	閩	
闾	閭	
闿	闓	
阀	閥	
阁	閣	
阂	閡	
阃	閫	
阄	鬮	
阅	閱 閲	
阆	閬	
阇	闍	
阈	閾 𲈯 𲈲	
阉	閹	
阊	閶	
阋	鬩	
阌	閿	
阍	閽	
阎	閻 闫	
阏	閼	
阐	闡	
阑	闌 𲈮	
阒	闃	
阓	闠	
阔	闊 濶	
阕	闋	
阖	闔 閤 𲈰	
阗	闐	
阘	闒	
阙	闕 𮸧	
阚	闞	
阛	闤	
阜	阝 峊 𡸠 𠻰 𨸏 𳈚 𲓪	
阝	阜	
队	隊	
阡	仟 谸 𧮮 圱	
阤	陁	
阧	陡	
阨	厄 阸 戹	
阪	坂 𡊃 𨹘 𠭔 岅	
阬	坑	
阭	𨺥 𨸮	
阮	𨸘 𲠃	
阯	址	
阰	𨻀	
阱	穽 㘫 𥤴 汬 𠁲 汫 坓 𱶷	
防	埅 𨹛	
阳	陽 昜 氜	
阴	陰 隂 𱛈	
阵	陣	
阶	階 堦	
阸	阨 厄	
阺	𨸝 𨸞	
阻	岨	
阼	䟭 𲉌	
阿	𡹣	
陀	陁 𡶊 𥞒 𨹕 岮 阤	
陁	陀 阤	
附	坿	
际	際	
陆	陸	
陇	隴	
陈	陳	
陉	陘	
陋	𨹟 𲆐	
降	夅 𨹓 𡲛 𡲣 𱗘	
陏	隋	
限	㡾 𨹎 𳈢	
陑	𨼏 隭	
陔	垓	
陕	陝 陜	
陗	峭	
陘	陉 𨹢 𨺄 𡷨	
陛	㙄 𨻘 𨹼	
陜	陝 狹 陕 陿 𩂘	
陝	陜 陕 狹 𨹈 𨹊 𩂘	
陞	昇 升 𧿘 𨁠 阩	
陟	徝 𠌹 徏 𠉡	
陡	阧 𨹜 𨻉	
院	寏 𡌗	
陣	阵 𨸬 𣃻 塦 𣃵 陳 敶	
陥	陷	
陦	隯	
陧	隉	
陨	殒 隕	
险	硷 險 険 𱕤	
陪	𨻓	
陫	𨻃	
陬	𨽁 𲙔	
陭	埼 崎 嵜 碕 𥔎 﨑 㟢	
陮	𨻵	
陯	𤲕 埨 𲉉	
陰	隂 阴 霒 𩃬 𨼖 𤽎 𨻔 阥 𣍤 𠊺 𣱙 侌 𨽙 𨹉	
陲	𨺪 𨼦	
陳	陈 𨸬 𢽬 迧 軙 𨻰 𨊴 敶	
陴	𩫮 𡦟 𩫫 𩫪	
陵	𨹧 𨻎 𨻪 䧙	
陶	匋 𨺃 𨹋 𱞢	
陷	陥 𨺂 䧟	
陸	陆 𤱒 𨽫 𨽐 𨽱 𲉊	
険	險 礆 险	
陻	堙 垔	
陼	渚 𨼑	
陽	昜 氜 阳 𥌖 𨹈 𣆄 𨽐 阦 𨼗 𨼘	
陿	𬯅	
隁	𲉞	
隂	陰 阴	
隄	堤 碮 䧑 埞	
隅	𨺁 𳈛	
隆	𨻦 𨹠 𨹿 𤯲	
隇	𨻒	
隈	渨 𨺯	
隉	陧 𨻄 棿	
隊	队 𨺵	
隋	陏	
隍	堭	
階	堦 阶	
随	隨 𲆞 𲉜	
隐	隱 隠	
隑	𬮿 𨻯 𡎼	
隓	𡐦 𨼰	
隔	𤗦	
隕	殞 磒 陨 殒	
隖	塢 𬮻	
隘	𨻹 𨽪 塧 阸 𲝯	
隙	郄 郤 𨻶 𧯊 䧍 隟 𡮱 𨻈	
際	际	
障	鄣 墇 㢓	
隝	塢	
隠	隱 乚 隐	
隣	鄰 邻	
隤	墤 𨽠 𨓾 𡓤 𬯎 䫋 𨘿 𨽟	
隧	𡑞 𨺅 𨽡	
隨	随 遀 䢫 𨼕	
隩	𡒃	
險	険 礆 险 𡽃 嶮	
隫	𱀡	
隮	躋 𬯀 𨹶 𨻕 𨽘 𨹷	
隯	陦	
隰	𨻽 𨻸 𨻋 𨻿 𮸩 𫠃	
隱	隠 乚 隐 𤔌 𨼆	
隲	騭 𱀑	
隳	隓 𢀡 𱟘	
隴	陇	
隶	隸 隷 𱧲 𱵰	
隷	隸 隶	
隸	隷 隶 歀 𨾁 𥻊 𨾀 𥻳	
隻	只 𨾏	
隼	鵻 鶽	
隽	雋 𮱠	
难	難	
隿	𨾓 𩾢 𨾍	
雀	䲵 𩾟	
雁	𲔀 鴈 𳐃 鳫 𳎽 𪁡 𳏘	
雂	𨾠	
雄	𩿅	
雅	疋 𤴓	
集	亼 雦 㯤 雧	
雇	僱 鳸 𩿇	
雈	萑	
雉	𪅊 𥏷 𨾤 𪁰 𪁩 𨿘 鴙 𳎵	
雋	隽	
雌	䳄 䧳 𩾰	
雍	邕 𪪝 雝	
雎	睢 鴡 𪂓 瞗 𣻰	
雏	雛	
雑	雜 襍 杂	
雒	𩁗	
雔	㘜	
雕	彫 琱 㓮 鵰 錭 𲉧 𨾆 𳐀	
雖	虽 𨾡 𧐌 𨿽	
雗	𨿨	
雘	艧	
雙	双 䨇 𩀝 𩀱 㕠	
雚	𧃦	
雛	鶵 雏 𨿉 𪀫 𪀩	
雜	雑 襍 杂	
雝	廱 簌 𪪝 𪄉	
雞	鷄 鶏 鳮 鸡 䳶	
雟	𪈥 嶲 巂	
雠	讎	
離	离 𩀌 𨾫 𳌓	
難	难 𩁤 𩀏 𩀤 𩁘 𩁲 𪇼 𪄿 𩁩 𩁢 𩀙 𩁬 𩀡 𩁣	
雥	𲉩	
雨	㲾 𠕘 兩 𩁼 𠕒 𡷎 𠕲	
雩	𦏻 𩁹 𦏴	
雪	䨮	
雰	𩃼	
雱	霶 䨦	
雲	云 𦤆 𮸬	
雳	靂	
零	𥥋 𠏡 𩅶 𩆖 霗 𡈍 𩃞 𤅫 〇	
雷	𩄣 𤴑 䨓 𩂩 靁 𩇓 𤳹 𤴐 𤳳 畾 𤴌	
雹	𩇌 𩆗 𩅒 𩄉 𩅟 䨌 䨔	
電	电 𩅎 𩂵 𩅏 𩃓 𩃿 𩂬	
雾	霧	
需	𦓔 𩂉	
霁	霽	
霃	𩂷 𩂸	
霄	㲵 䨭	
霅	𤁳	
霆	𨖝 𩆆 𩄫 𨗒 𩃀 𲉾 𨑳	
震	𩆉 𩇒 𱱁	
霉	黴	
霊	靈 灵	
霍	癨 𲊌	
霎	雭	
霏	䬠	
霐	䨎	
霒	陰 𩃬 霠 𩃛 䨧 𩂇	
霓	蜺	
霕	𩃌	
霙	𩅊	
霜	孀	
霞	赮	
霡	霢	
霢	霡 䨫	
霣	𩇂 𫕥 䨶 𩆆	
霤	𩅐	
霥	濛	
霧	雾 雱 霚 𩅬 雺	
霩	㸌 𩇑 𩇊	
霪	䨙 𣽮	
霫	雭	
霭	靄	
霮	𩅷 䨢 𩅾	
霰	䨘 𩅤 𩄧 䨷 𩃝 𩃂 𩆵 𩆥	
霵	𩆭 𩇋	
霶	雱 䨦	
霸	覇 𧈉 𣍸 𩄤 𧟲 𧟳 𲁌	
霹	礔 𥗲	
霼	𪵣	
霽	霁 𩄄 䨖	
霾	𩆲 䨪	
霿	𠍢 愗 𢝠 𠊮 雺 𢝽	
靀	濛	
靂	雳	
靃	霍 𱾻	
靄	霭 䨠 䔽	
靅	𰷦	
靆	叇 𩃷 霴	
靈	霊 灵 𧨈 䨩 𠳄 𩆮 𤴤 𤫊 𢩙 霛 𧈀 𩄀 𩅶 𡀓 𩂳 𩃞 𢩝	
靉	叆 𨙤	
靋	𩄞 𩅩	
靑	青	
青	靑 𤯞 𡷉 𤯝 寈 𡴑 𡴏 𡗡 㞭 𰀈	
靓	靚 靜	
靔	靝 天 𱥭	
靖	𰩢	
静	靜 靚 𲊖 𰁓	
靚	靜 靓 静	
靛	𰍎	
靜	靚 静 靓 㣏	
靝	靔 天	
非	飛	
靠	𩇸	
靡	𠠣 𱴌	
面	靣 麵 麺 麪 麫 𠚑 𡇢 𨉥 𫩑	
靣	面 麵 麺 麪 麫	
靥	靨	
靦	覥 腼 𡆎 𩈍 䩄 𥈅 𧡝 𧡻 𨡁 𩉊	
靧	頮 𫖃	
靨	靥 𩉂 嬮 𩉇	
革	𠦶	
靪	䩚	
靬	𩎒	
靭	韌 靱 肕 韧	
靱	韌 靭 肕 韧	
靴	鞾 𩍇 𩎁 𡲲 𩋾 㞜 𱚻 𲊢 𰆳 𳊡	
靶	𳊝	
靷	𩍟 𩎋 𩍱 𩍫	
靸	𩎕 𲊛	
靼	𩍕 䩢	
靾	𩋛 𩊈 𩊒	
鞀	鞉 鼗 𩌿 𩊲 㲈 𡣐 𪔛	
鞃	𩉦 䡌 䩑 䡏 𨌆	
鞄	𩊋 𩋲 䩝 𩍂 𩎘	
鞅	𳊜	
鞇	𩎪	
鞈	䩡 𪔮	
鞉	鞀 鼗	
鞋	鞵 𩋘 𩋔 𩋧 𰆻	
鞌	鞍	
鞍	鞌	
鞎	𩊷 𨋨 𩎤	
鞏	巩	
鞑	韃	
鞒	鞽 橇	
鞓	䩠	
鞔	𩋭	
鞕	𩋸	
鞗	䩦	
鞘	韒 𤿨 鞩	
鞙	琄 䩰	
鞚	𲊞	
鞝	绱 緔	
鞞	𩌛 琕	
鞟	鞹	
鞠	𩊸 𩍸 䪕 𣮴 躹 𥷥 𩍔 𠮑 𲭠	
鞢	𩋑	
鞣	𦎤	
鞤	䩷 𥀂 𩋮	
鞦	鞧 秋	
鞧	鞦 𳊞	
鞨	𩍛	
鞫	諊 𥯺 𥷤 𥷚 𥲩 𥷴 𡫭 𥰬 𥱩 𧃈	
鞬	𩎅 𩎀 𲊤	
鞭	𠓥 鞕 𩌻 𠓠	
鞮	䩚 䩘 𳊢	
鞯	韉	
鞲	韝	
鞳	𩌐 𩌔	
鞴	絥 𩎬 韛 𩎻 𩍁 㰆 𩍘 𣠻 𩌎 𩏕 𩏃	
鞵	鞋	
鞶	䩔 𣎤	
鞸	𱁴	
鞹	鞟 𩎏 𩌒	
鞻	𱁺	
鞼	𩏱 𱁹 𩍾 𩏡 𩍨	
鞽	鞒 橇	
鞾	靴 𫖇	
鞿	𩉜	
韁	繮 缰 𦆊	
韂	䩞 䪜	
韃	鞑	
韄	䪝	
韅	𩏰 𩌺 𩎍 𩌹	
韆	千 𱁶	
韇	𱁷 皾	
韈	襪 韤 袜	
韉	鞯 𦇩 𦆉 韀 𩎇 𩋋 𩌮	
韊	𱁾	
韋	韦 𥀊 𡚈 𥐄 𡙝	
韌	靭 靱 肕 韧	
韍	韨 𩎡 𩎛	
韎	𣝖	
韏	𱂇 𲢃	
韐	𢂷 𱂆 𩎱	
韒	鞘 𱂉	
韓	韩 𩏑 𡋶 𲓭	
韔	䩨 𮧴	
韗	𩏆 𱂈 𩎨 䩵 𩏅 𩍹	
韘	𱂊 𩏁 𢏲 弽 𢏼 𢐇 䪓	
韙	韪 䪘 愇 𳃀	
韚	𫠅	
韛	𫖔	
韜	弢 韬 鞱 𩊹 轁 𩏋	
韝	鞲 𩎬 𫖕 𩏎	
韞	韫 鞰	
韟	𩏤	
韠	𫖒	
韡	𮧵 𩏬	
韢	𬰶 𩎰 𩏲	
韣	韥 䪅 𱂋	
韤	韈 襪 袜	
韦	韋	
韧	韌 靭 靱 肕	
韨	韍	
韩	韓	
韪	韙	
韫	韞	
韬	韜 𲊟	
韭	韮	
韮	韭	
韰	𩐂	
韱	𧃖 韯	
韲	齏 齑	
韵	韻 𮷏	
韶	㲈 𢨍 𮸳	
韸	韼 𩐛	
韻	韵 𱂐 𡁩 𧥺	
韽	𪛏 𩐧	
響	响 㗽 𥖡 𩐢 𡪥 𩐿 𡪆 𡩉 窨 𥥣 𡨇	
頁	葉 页 𩑋	
頂	顶 𩠑 𩕩 𩒆 𧵜 𩕢	
頃	顷 𩒵 𩔥	
頄	𬱓	
項	项	
順	顺 𠈼 㥧 幁	
頇	顸	
須	湏 须 𩓣	
頉	頤 頣 颐	
頊	顼	
頋	顧 顾 𩒒	
頌	颂 𩔜	
頍	𫠆	
頎	颀	
頏	颃 𩑜	
預	豫 预	
頑	顽	
頒	朌 颁 肦 䫞	
頓	顿 𩠫 𢻴	
頔	𬱖	
頕	𬱗	
頖	𬱙	
頗	颇 𩑼	
領	领 頜	
頙	𲊪 𲊺	
頚	頸 颈	
頛	𩓕 𬱜 𩑚	
頜	颌 𠹄 𦛜	
頞	𱂨 𩕬 齃	
頟	額 𱂥	
頠	𬱟 𲊭	
頡	颉	
頢	𩒲 𬱠 𩈙	
頣	頤 頉	
頤	頉 頣 颐 𩠢 𩑪 頙 𩒫 𦣞 𩠛 頥 顊 𦣝	
頦	颏 𦝣	
頩	𱂦	
頪	𱂧 𩑩	
頫	俯 𫖯 𨾾 𩒙 䫍 俛	
頬	頰 颊	
頭	头 䫁 豆 𥘖	
頮	靧 颒	
頯	𱂬 𩓰 𩒶	
頰	頬 颊 𩠗 脥 𩔯 𩠣	
頲	颋 𩑙 𩒞	
頳	𲊼	
頴	穎 颕	
頵	𫖳	
頷	颔 𩓱 𩩊 𩩂	
頸	頚 颈 𩒤	
頹	頽 颓 頺 䫋	
頻	频 𩓯 𩔤 𩕘	
頼	賴 赖	
頽	頹 颓	
顀	𱂭	
顁	𬱫	
顃	𩖖	
顄	𩔓 𩔞 𦜆 𱂰	
顅	𫖶	
顆	颗	
顇	𱂯	
顈	𦅐	
顉	𰽳	
顊	𬱪	
顋	腮 𱂲	
題	题 𧡨 𲋭	
額	頟 额 𩓘	
顎	颚 䫷	
顏	顔 颜 𦫞 𩠪 𦫤 𩕝	
顐	𬱢	
顑	𱂱	
顒	颙 𩔔 𩤛	
顓	颛	
顔	顏 颜	
顕	顯 显 𲊿	
顖	囟 𱂶	
顗	𫖮 𲊳	
願	愿 𩔊 𢥧 𩕮 𩕾 𫖸 𠪰	
顙	颡 䫙	
顚	顛 颠	
顛	顚 颠 㒹 傎	
顜	𱂴	
顝	𱂵	
類	类 𩔗 𩔧 𩔖 𣈪	
顠	𱂺 𩮳	
顡	𩕺 𩔀 𩕑	
顢	颟	
顣	𫖹	
顤	𱂣	
顥	皓 晧 皝 颢	
顦	憔 𱂻	
顧	頋 顾 𮸹	
顩	𩖆 𩕿 𩒯 𱂫	
顪	𱂤	
顫	颤	
顬	颥 䫱	
顮	𱂸	
顯	顕 显 㫫 㬎 𩔰 𳂗	
顰	嚬 颦 𨏞 𩖓	
顱	髗 臚 颅 𩔺	
顲	𩖋 𩕴	
顳	颞	
顴	颧 𩪼	
页	頁	
顶	頂	
顷	頃	
顸	頇	
项	項	
顺	順 𱞱	
须	須 鬚 𳌥 𲅻	
顼	頊	
顽	頑	
顾	顧 頋	
顿	頓	
颀	頎	
颁	頒 朌	
颂	頌	
颃	頏	
预	預	
颅	顱	
领	領	
颇	頗	
颈	頸 頚	
颉	頡	
颊	頰 頬	
颋	頲	
颌	頜	
颍	潁	
颎	熲	
颏	頦	
颐	頤 頉 𱼧	
频	頻	
颒	頮	
颓	頹 頽	
颔	頷	
颕	頴	
颖	穎	
颗	顆	
题	題	
颙	顒	
颚	顎	
颛	顓	
颜	顏 顔	
额	額	
颞	顳	
颟	顢	
颠	顛 顚 𱂪	
颡	顙	
颢	顥	
颣	纇	
颤	顫 𲌒	
颥	顬	
颦	顰	
颧	顴	
風	凨 风 凮 𠙗 𠙊 凬 飌 檒 𠙈 𲋄	
颩	𱃔	
颬	𱃕	
颭	飐	
颮	猋 飇 飑	
颯	飒 䬃 𩗁	
颰	𩙥 𩖽	
颱	台 𱃗	
颲	𩘃 𱃘	
颳	刮	
颴	𬱽 𲋅	
颶	飓 𩗗	
颷	𩙪	
颸	飔 𩗮	
颹	𩘚 𠑒 𬱵 𩙃	
颺	飏 䬗	
颻	飖 䬙	
颼	飕 䬒 颾 𩘦 𩘌 𩗆	
颽	𬱼 𩘥	
颾	𩙫 𩙈 𩘼	
颿	𬳳 䬚 䭵	
飀	飗 𩖴 飂 𩗠	
飁	𱃟	
飂	𩘷 𩘸 𮨵	
飃	飄 飘	
飄	飃 飘 𩙒 𩙞	
飆	飙 飇 𱃠 飈 飊 𲮻 𩗈 𩖚 𩖧 𩖡 颷 颮 飑 𳋂	
飇	猋 颮 飆 𲮻 飈 飊 𱃠	
飈	飚 飆 𲮻 飇 飊	
飉	𩙂 𬲅	
飊	飆 飇 飈 𮸼	
飋	𫗋 䫾	
飍	𱃝	
风	風 凨	
飏	颺	
飐	颭 𲋉	
飑	颮	
飒	颯	
飓	颶	
飔	颸	
飕	颼	
飖	颻	
飗	飀	
飘	飄 飃	
飙	飆	
飚	飈	
飛	飞 飝 𠃧 𦒮 𩙱 𦐭	
飜	翻 繙	
飝	𮸽	
飞	飛	
食	飠 饣 𩚁 𠊊 𠋑 𨢁 𩚃 𩚀	
飠	食 饣	
飡	餐	
飢	饥 饑 𩜆 𩚎 𩚮	
飣	饤 𦘭	
飤	飼 𬲦	
飥	饦 𩟰 𪌂	
飦	饘 𫗞	
飧	飱 𩛈 䬸 𩚏 餐 湌	
飨	饗	
飩	饨 𪌋 𩚊 𥸵	
飪	餁 饪 䏕 䭃 㶵 𤏼 𤇲 𦜙	
飫	饇 饫 𩜏 𩜢 秗 𩜈 𩚿	
飭	饬 餝	
飮	飲 饮	
飯	飰 饭 𩚳 𲖣	
飰	飯 饭 𱃴	
飱	飧	
飲	飮 饮 淾 𨡢 𩚜 𨡳 𣤗 㱃 𣲎 酓 𣵂 𩚕	
飴	饴 𩛛	
飵	𫗢 𩜅	
飶	𫗣	
飷	𬲭	
飺	㖢 呲	
飼	飤 饲 𩚅	
飽	饱 𩜕 𩜿 䭋 𩛒 𩝩 𩛞 𩛁 𩝰 𩛊 飹	
飾	餝 餙 饰 鉓 𩚍 𩜓	
飿	饳	
餀	𮩜 饚 𦤦	
餁	飪 饪 䭃	
餂	舔 𱃺	
餃	饺	
餄	饸 𩛩 𩚲	
餅	餠 饼 䴵	
餈	粢 䭣 𩜴 糍	
餉	饟 饷 銄 𥹝 𩜋 䊑	
養	养 𩛬 䍩 𢽁 眷 𢼝	
餋	飬	
餌	饵 𧊗 𩛣 𩚪 㢽 𲺂 𩱓 𳋘	
餍	饜 𲄊	
餎	饹	
餏	饻	
餐	湌 飡 𩛳 䬸 𳋙 歺	
餑	饽	
餒	馁 餧 鮾	
餓	饿	
餔	𫗦 䊇 𥂈 𥹴 𧗉	
餕	馂 𩝘 𦿉	
餖	饾	
餗	𫗧 𩱖 𢐌 𩞌 𩞍	
餘	余 馀 𠎳	
餙	飾 餝	
餚	肴 𬳁	
餛	餫 馄 䊐	
餜	馃 䴹	
餝	飾 餙 饰	
餞	饯 䬻	
餟	醊 𬳂	
餠	餅 饼	
餡	馅	
餢	𱃾	
餣	𬲼	
餤	𱃿	
餦	𫗠	
餧	餵 喂 餒 𫗪	
館	舘 馆	
餩	𱃽	
餪	𩞪 𫗬	
餫	餛 𫗥	
餬	𫗫 饐 䭍 𩞵 䭌 𩚩	
餭	𫗮 䊗 䊣	
餮	𩚝 飻 𩚸 𩚺 𲋗	
餯	𱄄 𩛾	
餰	𬳆 𩜾	
餱	糇 𫗯 𩛫	
餲	𮩝	
餳	饧 𩛿 糃	
餴	𱃼	
餵	餧 喂 諉 𫗭	
餶	馉	
餷	馇	
餸	𩠌	
餹	糖 𬳍	
餺	馎 䭦 䬪 𪍡 𪎄 𩟛 𩞽	
餻	糕	
餼	饩 䊠 氣	
餽	饋 馈 𳋮	
餾	馏 𩞷	
餿	馊 𩜯 𱄂 𲷒 𩝯 𳋯 𮩏	
饀	𬳊	
饁	馌 𩝉	
饃	馍 饝 𩞁	
饅	馒 𪍩 䊡	
饆	𮩛 𪍪	
饇	飫 𱃲	
饈	馐 䐰 𦟤	
饉	馑 𩞎	
饊	糤 馓 𩟴	
饋	餽 馈 匱 櫃 𩟱	
饌	籑 馔 䉵 𩜹 𦠆 𩝁	
饍	膳 𳋱	
饎	𩟄 𩝮 𩜂 糦 𩛉 𱄆 𩞡	
饐	䭇 𩚂 䓹 𮩞 䬥	
饑	飢 饥 𩜆 𩚮 𳂤	
饒	饶 𲋘	
饔	𩝹 𩟷 𩛛 𩟀 𩞠 𲁅	
饕	叨 𩚓 𩞂 餥 𧈐 飸 䬭 𩝵 𩞣 䬢 𩜻 𲇦	
饗	飨	
饘	飦 𫗴 𢐹 餰 𩛻 䬤 䭈 𥼷 䊕 𩱯	
饙	餴 𩞑 𱄀 𩝂 𩝼 𩚰	
饛	𱄈 𥁚 䀄 𥁶 𩝬	
饜	餍 𩞚 𤞣 𤹍 𩩶	
饞	嚵 馋 𩟖	
饟	餉 𩞥 𫗵 𩝾	
饠	𫗩 𥽺 𪎆	
饡	𱄊 𩛻 𩟌 䬤 𩟪	
饢	馕	
饣	食 飠	
饤	飣	
饥	飢 饑	
饦	飥	
饧	餳	
饨	飩	
饩	餼 𱹗	
饪	飪 餁	
饫	飫	
饬	飭	
饭	飯 飰	
饮	飲 飮	
饯	餞	
饰	飾 餝	
饱	飽	
饲	飼 𲋛	
饳	飿	
饴	飴	
饵	餌	
饶	饒	
饷	餉	
饸	餄	
饹	餎	
饺	餃	
饻	餏	
饼	餅 餠	
饽	餑	
饾	餖	
饿	餓	
馀	餘 𱑷	
馁	餒	
馂	餕	
馃	餜	
馄	餛	
馅	餡	
馆	館	
馇	餷	
馈	饋 餽 𲌩	
馉	餶	
馊	餿	
馋	饞	
馌	饁	
馍	饃	
馎	餺	
馏	餾 𰜈	
馐	饈	
馑	饉	
馒	饅	
馓	糤 饊	
馔	饌 𲋝	
馕	饢	
首	𥃻 𩠐 𩠬 𦣻 𩖐	
馗	𠃳 𦔱	
馘	聝 𩠲 𳌛	
香	薌 㿝 𩠼 䅨 麘 𪏰	
馚	馩	
馝	䭱	
馞	𩡒 䭯	
馠	𩠻	
馤	𩡔 𩡚 𩡤	
馥	𩡊 𩡑 𪐒 䫝 𩡘	
馦	㽐	
馨	䅽 㯏 𪐕 𡄈	
馩	馚 𬳟	
馪	𮹀	
馬	马 傌 𢒧 𢒗 𩡮 𢒠	
馭	御 驭 馼 𩤾 𡕺	
馮	冯 𠗦 溤	
馯	𫘛	
馱	駄 驮 䭾 𳌖 佗	
馲	𩢐 𱄽 𩧐 驝 𩢵 𤜤 𲟠	
馳	驰 𧂓 䮈	
馴	驯	
馵	𩢓 𱄼	
馹	驲 𩡲	
馺	𢕬 𱅂 𲋴	
馼	𫘜 𩢌	
馽	𩢏 𩡳 𱅁	
馾	𩣤	
馿	驢	
駁	駮 驳 𩣄	
駂	𩢈 𩡰 𩣎 𱅀	
駃	𫘝	
駄	馱 驮	
駅	驛 驿	
駆	駈 驅 敺 驱	
駈	驅 駆 敺 驱	
駉	駫 䮐 𬳶	
駊	𫘟 𩢘	
駍	𬳴	
駎	𩧨	
駏	𱅃 𤝙	
駐	驻	
駑	驽	
駒	驹 馰	
駓	䮆 𩣚 𬳵	
駔	驵	
駕	驾 𤙑 𩢟	
駖	𲌅	
駗	𱅇 𩢜	
駘	骀 𩢠 𩦽	
駙	驸 䮛	
駚	𩧫	
駛	驶 𩢲	
駜	𱅈	
駝	駞 驼 佗 𩣾 𳌉	
駞	駝 驼 𫘞	
駟	驷	
駠	駵	
駡	罵 傌 骂	
駢	騈 骈 𩡼 䮁 𩤳 𩢝 𩤾	
駣	𩣛 𱅏	
駤	𫘠	
駥	𱅉 𩤭	
駦	騰 𱅑	
駧	𩧲	
駩	𩧴 騡	
駪	侁 詵 𬳽 𩣂	
駫	𫘡	
駬	𱅋	
駭	骇 駴	
駮	駁 驳 𱅐	
駰	骃	
駱	骆 𢆇 𩦼	
駴	𮪢	
駵	駠	
駶	𩧺	
駷	𱅔 䮟 摗	
駸	骎 𩤿 𩤨	
駹	𮪡	
駺	𬴀	
駻	𫘣 馯	
駼	𪊸 𬳿	
駽	𱅖 駨 𩢺	
駾	𱅙	
駿	骏	
騀	𱅗 𩭝 𩣣	
騁	骋 𩣁 𩢆 𩧢	
騂	骍 𩥍 𤙡 𤛫	
騃	呆 獃 𫘤 𤶗	
騄	𫘧	
騅	骓 𳏗	
騆	𮹋	
騇	𤙱 𱅚	
騈	駢 骈	
騉	𫘥	
騊	𫘦	
騋	𱅕	
騌	骔 騣 鬃 鬉	
騍	骒	
騎	骑	
騏	骐 䭶 䭼	
騐	驗 験	
騑	𩦎 𬴂 𩥰	
騒	騷 骚 𲹌 𲹆	
験	驗 騐 验	
騔	𩨀 𩦞	
騕	𩡻 𱅜	
騖	骛 𩤝 𩥎	
騗	騙 𱅝	
騘	驄	
騙	騗 骗 𩤬	
騚	𩨊	
騛	𮹂	
騜	𫘩 䮲	
騝	𩨃	
騞	𬴃 𩦐 𱴵 𲋽	
騟	𩨈	
騠	𫘨 𩤢	
騢	𱅞	
騣	骔 騌 鬃 鬉 𮪣 𩮀	
騤	骙 𩦟	
騥	𱅟	
騧	䯄 𩦣 𩢍	
騨	驒	
騩	𩥢 𱅡	
騪	𩨄	
騫	骞 𡅶	
騬	𱅢 𩦆 䮪	
騭	隲 骘 𨽥	
騮	骝 驑 𩥖 駵 駠 𩤷 𩣒 𩥺	
騯	𬴅 𩤐	
騰	駦 腾 𩥱 𩧔 驣 䠮 𦫀 𲪴 𩧖 𩦜 𲪩	
騱	𫘬 𩤻	
騲	𮪤	
騳	𱄿 𩥋	
騴	𫘫	
騵	𫘪	
騶	驺 𩣿	
騷	騒 骚	
騸	骟 𩦐	
騹	𬴆	
騺	驇 𱅊	
騻	𫘭	
騼	𫠋	
騽	𱅩	
騾	驘 𳌘 骡 䯁 𩧣 𩦻	
驀	蓦	
驁	骜 䮯	
驂	骖 𲌂 𬳯	
驃	骠 𩦈 𩦾 𩧙	
驄	騘 骢 𩣭 𩣢 𲋼 𩨂	
驅	駈 駆 敺 驱 𢿛 𩢧 𩣌 𩣕 𣦘 𩤀 䮃 𳌄 𩧧	
驇	騺	
驈	𱅫 䮇	
驉	𤡣 𱅧	
驊	骅 𦽊 𩤉 𧄋 𧄪	
驋	𩧯	
驌	骕	
驍	骁	
驎	䮼 𬴊	
驏	骣	
驐	𮪥	
驑	騮	
驒	騨 𱅛	
驓	𫘯	
驔	𱅪 𩧤	
驕	骄 䮦 𲌖	
驖	𩦷 𩥳 𩥏 𬴋 𩧀	
驗	験 騐 验	
驘	騾 𳌘	
驙	𫘰	
驚	惊 𳏱	
驛	駅 驿	
驝	𬴎	
驞	𩦿 𱅤	
驟	骤 𨓭	
驠	𱅬	
驡	𱅅	
驢	馿 驴 𩧥 䮫 𩢉 𳌒	
驤	骧 𩦪	
驥	骥 蘎 𩦸 𩥉	
驦	骦 騻	
驧	𩣽 𩧛	
驨	𩧎 𫘱	
驩	𩥤 𬴐	
驪	骊	
驫	骉 䮶	
马	馬	
驭	馭	
驮	馱 駄	
驯	馴	
驰	馳	
驱	驅 駈 駆	
驲	馹	
驳	駁 駮	
驴	驢	
驵	駔	
驶	駛	
驷	駟	
驸	駙	
驹	駒	
驺	騶 𲂣	
驻	駐	
驼	駝 駞	
驽	駑	
驾	駕	
驿	驛 駅	
骀	駘	
骁	驍	
骂	罵 駡	
骃	駰	
骄	驕	
骅	驊	
骆	駱	
骇	駭	
骈	駢 騈	
骉	驫	
骊	驪	
骋	騁	
验	驗 験	
骍	騂	
骎	駸	
骏	駿	
骐	騏	
骑	騎	
骒	騍	
骓	騅	
骔	騌 騣 鬃 鬉	
骕	驌	
骖	驂	
骗	騙	
骘	騭	
骙	騤	
骚	騷 騒	
骛	騖	
骜	驁	
骝	騮	
骞	騫	
骟	騸	
骠	驃	
骡	騾	
骢	驄	
骣	驏	
骤	驟	
骥	驥 𱅌	
骦	驦	
骧	驤	
骩	骫	
骪	骫	
骫	骪 骩 𩨖	
骬	𩨗	
骭	𧿂 䯎 𩩃	
骯	肮 𩨺	
骱	𩨦 𩨶 𩨧 𩨢	
骴	胔 𦙼 𣨁 𩨱 𣧨	
骵	躰 體 軆 体	
骶	𩨤	
骸	𡱍 𩩰 䠹 𩩏 䯐	
骹	𩨟 𨃤 跤	
骺	𩩽 𩩵	
骻	胯 𡱼	
骼	胳	
骽	腿	
骾	鯁 挭 𩩹 𦛟	
髀	䠋 𩪅 𩩚 𩩙 䯗 𲇂	
髁	𡱼	
髂	𩩱 𦝣 䯊 𨂥	
髃	腢	
髄	膸 髓	
髅	髏	
髇	𩩉	
髊	𩪒 𩪳	
髋	髖	
髌	膑 髕 臏	
髍	𤼑 䯢	
髎	𩪚	
髏	髅 䫫	
髐	𱅮	
髑	䫳 𲊮	
髒	脏 𩦦	
髓	膸 髄 𩩜 𩪦 𩪷 𩪏 𩪄 䯝 𲄭 𲌓	
體	躰 骵 軆 𳂆 体 𩪆 𨉦 𨉥 𲥩	
髕	臏 髌 膑	
髖	髋	
髗	臚 顱 胪	
高	髙 𦕺 𠇃	
髙	高	
髞	𩫦	
髡	髨 𨱤 髠	
髣	仿 彷 𩬝	
髥	髯	
髦	牦 氂 犛 斄 䭷 𳌗 𰚧 𩫷 𨱢 𨱞	
髪	髮 发	
髫	𲌚	
髬	𩬴	
髭	𨲝 𨲦 頿 頾 𩑽	
髮	髪 发 㛲 𲛯 𩬕 𩬃 𨱳 𩬊 𩑛 𩠙 𩠖 𡞝 𩠕 𩑱 𤕥	
髯	髥 𣱄 𩑺 𳊳 𩑞 䫇 𩒹 𩓾 𣬭	
髲	𣬮	
髳	䟥 𨱨	
髴	彿 𪒀 𠔘	
髹	髤 𩭘 䰍 𥿴	
髺	䯺 𩬁 𳌧	
髻	䯻 𨲡 𣯦	
髼	鬅 鬔 𩭉	
髽	𩭃 𩮢	
髿	䯯	
鬀	剃	
鬂	鬢	
鬃	骔 騌 騣 鬉 𨲃	
鬄	𩬲 髢 髰	
鬅	髼	
鬆	松 𩮀 䯳 𨱛	
鬇	𩰅 𩫿 𩯎 𩯩	
鬉	骔 騌 騣 鬃 𨲔 𨲇 𨲃 𩭤	
鬊	𩯐 巛 𩮦	
鬋	𩮣	
鬌	𨲕 𲐴 𩬻 𮫄 䰇 𩯚	
鬍	胡 𣬣	
鬐	𨲘	
鬒	㐱	
鬓	鬢 𩯭	
鬖	𩯑 𩯟 𩭹	
鬗	𱆆 𲌢	
鬘	𨲾 𩮺 䯶 𨲛 𩦧 𩮉 𩭈 䰋	
鬚	𳌥 须 䰅 䰑	
鬜	鬝 𩮁 𱆁 𩭠	
鬝	鬜 𱆀	
鬞	𣰊 𬴩	
鬠	𫘽	
鬡	𮫂	
鬢	鬂 鬓 𨲺 𩯭 髩	
鬣	巤 鬛 𨲲 㲱 𣰫 𢀂 𳌦 𩰆 䝓 𩯝 𩯻	
鬤	𨳃 𣰶	
鬥	鬦 闘 鬪 鬬 鬭 斗 𫔡 閗 𨶜 𩰑 𨷵 𩰒 𨷖 𩰖 𩰚 𫔯 𨴜 𲈬	
鬦	鬥 闘 鬪 鬬 鬭 斗	
鬧	閙 闹 𠆴 𢂂	
鬨	閧 哄 𩰓 闀	
鬩	阋 䦧 𳇾 𧨃 𩰕	
鬪	鬥 鬦 闘 鬬 鬭 斗	
鬬	鬥 鬦 闘 鬪 鬭 斗	
鬭	鬥 鬦 闘 鬪 鬬 斗	
鬮	阄 䰗 𨵜 𨷺 䦰 𩰘	
鬯	𠚍 𥠴	
鬰	鬱 欝 郁	
鬱	鬰 欝 郁 𣡸 𦉠 𦉚 𩰪	
鬲	𨬑 䰜 鬴 㽁 䰛 䥶 𩰲 𩱉 𩱔	
鬵	𩱕 𢑋 𩱩 𩱠 𩰿	
鬶	鬹	
鬷	𩰼 𩰷 𩱅 𩱛 𲡉	
鬹	鬶	
鬺	𱆌 𩱑 𩱀 𩱐 䵼 𩰱	
鬻	粥 𧶠 㣃 儥 𢑍 俼 𩱱 𩱌	
鬼	𩴿 𩳉 𣆠 𩳹 𩲚 𩲞 𢇼 𢧩 𩲡	
鬾	𩳣	
魁	𩲙 𩲔 𩳭 鬿 𩲅 𲎮	
魂	䰟	
魅	𩲀 𩴈 𩴎 𣷛 𣼙 𩳪 䰨 祙 𢑙 𩳟 𩲑 𤲄 𩲿 𩲈 𤱮 𢑛 䰪 鬽 𩲐 𩱿 𢑘 𩲝 𱳆	
魇	魘	
魈	𤢖	
魉	魎 𲌮	
魊	䰥 𩳠	
魍	䰣 𩲛 𲌫 𳌱	
魎	魉 𩳮	
魏	巍	
魑	𩳩 䬜 𩴭 𩳀 𩘉 𩲶 𩱹 𩗨 𲌨 𳌯	
魖	𥛳 𧴆 𩴛	
魗	𱆛	
魘	魇 㱘	
魙	聻 𩴕	
魚	鱼 𤉯 𩵋 𤋳 𲩜	
魛	鱽	
魜	𬶁	
魝	𬶀 𠟮	
魟	鰩 𫚉	
魠	𱇏	
魡	𬶄	
魢	鱾	
魣	𮬛	
魤	𳎒 𩵏 𩵡 𩷴	
魥	𩽹	
魦	鯊 鯋 𫚌 𩵮 𩸌 𩺳	
魧	貥 𩵸 𱇘	
魨	鲀	
魪	𬶇 䰺 䱄	
魫	𩵨 𱇙	
魬	𱇖	
魭	𱇐 𩵶	
魮	𱇒 𩹻	
魯	鲁 𣥓 𢻛 𩶑 𣥐	
魱	𩵷 𩵯 𱇓 鱯	
魴	鲂 𩷸 鰟 𳌃	
魵	𫚍	
魶	𩹾 𱇔	
魷	鱿 鰌	
魺	鲄	
魻	𱇟	
魼	𱇜 鱋	
魽	𫠐 𩼉	
魾	鮃 𩶨 𱇝 𳍐	
魿	𳎕	
鮀	𩵔 𩷿 𬶍 䰿	
鮁	鲅 鱍	
鮂	𱇠	
鮃	鲆	
鮄	𫚒	
鮅	𫚑 𩺷	
鮆	𩶆 鱭 𫚖	
鮇	𱇛	
鮈	𬶋	
鮊	鲌 𩹏 𩸊	
鮋	鲉	
鮌	𱇢	
鮍	鲏 𩸉	
鮎	鲇	
鮏	鯹 𱇡	
鮐	鲐	
鮑	鲍	
鮒	鲋 𩺹 𩷺 𩸅	
鮓	鲊 𩽟 鮺 𩼮 𩽫 𩼻 𩺆	
鮕	𲍌	
鮗	鿴	
鮘	𬶌	
鮚	鲒	
鮛	䱙 𱇨	
鮜	鲘	
鮝	鯗	
鮞	鲕 𩶫	
鮟	𩽾	
鮠	𬶏	
鮡	𬶐 𩸼	
鮣	䲟	
鮤	𩹒 𩶽 𫚓	
鮥	𱇪	
鮦	鲖 𩻡 䱰	
鮧	鯷 𱇧	
鮨	𩷾 䱈 鰭 𮬜	
鮩	𩹁	
鮪	鲔	
鮫	鲛 𳍋	
鮬	𱇦 𩶮	
鮭	鲑	
鮮	尠 尟 鱻 鲜 䲆 觧	
鮯	𫚗	
鮰	𫚔	
鮳	鲓	
鮵	𫚛	
鮶	鲪	
鮷	𬶕	
鮸	𩾃 䲄 鰵	
鮹	𱇯	
鮺	鲝 䱹 鮓 𩽫 𩼻 𩺃 𩻢 𩼫	
鮻	𱇳	
鮿	𫚚	
鯀	鲧 鮌 𩩌 𧣙	
鯁	挭 骾 鲠 𩹐 𳍋	
鯃	𩶭	
鯄	𩾁	
鯅	𱈁	
鯆	𫚙 䲕 𩶉 𩹲 𩺼	
鯇	鲩 鰀 鯶	
鯈	𱇱 䱔	
鯉	鲤 𩼆 𩼞	
鯊	鯋 魦 鲨 𩺳 𩵮	
鯋	鯊 魦 鲨 𲍔	
鯌	𬶔	
鯎	𲍒	
鯒	鲬	
鯓	𳎘	
鯔	鲻 𩻨 𩺅 𩞮	
鯕	鲯 𩵧	
鯖	鲭	
鯗	鮝 鲞 𩺁 鱶	
鯘	鮾 䲎	
鯙	𳎜	
鯚	𱇺	
鯛	鲷 𩶣 鮉	
鯝	鲴	
鯞	𫚡	
鯠	𱇭	
鯡	鲱	
鯢	鲵	
鯤	鲲 𩻋 𩽞	
鯥	𱇶	
鯦	𱇼 𩶧 𩶿 鰽 𳍛	
鯧	鲳 䱽 鱂	
鯨	鲸 𩼃 䲔	
鯩	𱇗	
鯪	鲮	
鯫	鲰	
鯬	𩸢 𫚞 𩺸 𩼽 䱘	
鯮	𱇾	
鯰	鲶 鮎	
鯱	𩾇	
鯴	鲺	
鯶	𩽼	
鯷	鮧 鳀 鮷	
鯸	𱈄	
鯹	𬶢	
鯻	𬶟 䱫	
鯼	𱈅 鯮	
鯽	𩼚 鲫 鰿 𩺀 𳎡 𩼿	
鯾	𫚣 鯿 𩺂	
鯿	鳊	
鰀	𲍗	
鰁	鳈	
鰂	鲗 鱡 䰹 鯽 𩽠	
鰃	鳂	
鰅	𱈂	
鰆	䲠	
鰇	𬶧	
鰈	鲽 𩸏	
鰉	鱑 鳇	
鰊	𬶠	
鰋	𩷑 𩹽 𫚢 鮟 𩻖	
鰌	鰍 鳅 魷 䲡	
鰍	鰌 鳅 魷	
鰎	𩻥	
鰏	鲾	
鰐	鱷 鳄	
鰑	𫚊	
鰒	鳆 𩺽 𩼵	
鰓	鳃	
鰕	蝦 𫚥	
鰗	𬶞	
鰛	鳁 鰮	
鰜	鳒	
鰝	𱈋	
鰟	鳑	
鰠	鳋 𩷃	
鰡	䱖 𱈊 𩺜	
鰣	鲥 𩶬	
鰤	𫚕 魳	
鰥	鳏 𩹌 鱞 𩻴 𥉀 𩶊 𧤩	
鰦	𫚤 𩼑	
鰧	䲢 鮝 𩺭 䲍	
鰨	鳎 𩻵 鮙	
鰩	魟 鳐	
鰪	𩺻	
鰫	𫚦 鱅	
鰬	𱈉	
鰭	鳍	
鰮	鳁 鰛	
鰯	𱈍	
鰱	鲢	
鰲	鼇 鳌 𩼡	
鰳	鳓	
鰴	𱈑 𩽚	
鰵	鳘	
鰶	𬶭 䱥	
鰷	鲦 𩵌 䱔	
鰹	鲣	
鰺	鲹	
鰻	鳗 𩺴 𩻠	
鰼	鳛	
鰽	𫚧	
鰾	鳔 𩼾	
鰿	𧐐 𩼜 𩼱 𱇵	
鱀	𩵪 𬶨 𩺺	
鱁	𱈏	
鱂	鳉	
鱃	𱈌	
鱄	𱈐 𫚋 𧐕	
鱅	鳙	
鱆	𫠒	
鱇	𩾌	
鱈	鳕	
鱉	鼈 龞 鳖 𪔀 蟞	
鱊	𫚪	
鱋	𬶬	
鱌	𬶲	
鱍	𩸿 𱇣	
鱎	𱇩 𩺙	
鱏	𱈓	
鱐	𱇿	
鱑	鰉 𬶫	
鱒	鳟	
鱓	鱔 鳝 𬶛 䱇 𳀊	
鱔	鱓 𳀊 鳝 䱇 鱣 䱧 䱉	
鱕	𱈕	
鱖	鳜 鱥	
鱗	鳞 𩼩 䰼	
鱘	鲟 鱏 𩽶	
鱙	𲍑	
鱚	𬶮	
鱝	鲼	
鱞	𬶵 𩻲	
鱟	鲎	
鱠	膾 鲙	
鱢	𫚫 𩻦 鰺	
鱣	鳣 䱳 𩼼 𧖞 𩽱	
鱤	鳡 𩹸 鰔	
鱥	𮬝	
鱦	𱇸 䱆	
鱧	鳢 𩷋 𩽵	
鱨	鲿 𩼝 𱈘	
鱬	𩻞 𱈗	
鱭	鲚	
鱮	𫚈 魣	
鱯	鳠 𩹹 𩽕 魱	
鱲	𫚭	
鱳	𩺮	
鱴	𩽣 𱈙	
鱵	𮬤 𩼘	
鱷	鰐 鳄 𩻙 𩶍 𧊜 𱈚 𩷜 𳀋	
鱸	鲈 魲	
鱹	𬶺	
鱺	鲡	
鱻	鮮 尠 尟 𱈜	
鱼	魚	
鱽	魛	
鱾	魢	
鱿	魷	
鲀	魨	
鲁	魯 𲅭	
鲂	魴	
鲃	䰾	
鲄	魺	
鲅	鮁	
鲆	鮃	
鲇	鮎	
鲈	鱸	
鲉	鮋	
鲊	鮓	
鲋	鮒	
鲌	鮊	
鲍	鮑	
鲎	鱟	
鲏	鮍	
鲐	鮐	
鲑	鮭	
鲒	鮚	
鲓	鮳	
鲔	鮪	
鲕	鮞	
鲖	鮦	
鲗	鰂	
鲘	鮜	
鲙	鱠	
鲚	鱭	
鲛	鮫	
鲜	鮮 尠 尟	
鲝	鮺	
鲞	鯗	
鲟	鱘	
鲠	鯁	
鲡	鱺	
鲢	鰱	
鲣	鰹	
鲤	鯉	
鲥	鰣	
鲦	鰷	
鲧	鯀	
鲨	鯊 鯋	
鲩	鯇	
鲪	鮶	
鲫	鯽	
鲬	鯒	
鲭	鯖	
鲮	鯪	
鲯	鯕	
鲰	鯫	
鲱	鯡	
鲲	鯤	
鲳	鯧	
鲴	鯝	
鲵	鯢	
鲶	鯰	
鲷	鯛	
鲸	鯨	
鲹	鰺	
鲺	鯴	
鲻	鯔	
鲼	鱝	
鲽	鰈	
鲾	鰏	
鲿	鱨	
鳀	鯷	
鳁	鰛 鰮	
鳂	鰃	
鳃	鰓	
鳄	鱷 鰐	
鳅	鰍 鰌	
鳆	鰒	
鳇	鰉	
鳈	鰁	
鳉	鱂	
鳊	鯿	
鳋	鰠	
鳌	鰲	
鳍	鰭	
鳎	鰨	
鳏	鰥	
鳐	鰩	
鳑	鰟	
鳒	鰜	
鳓	鰳	
鳔	鰾	
鳕	鱈	
鳖	鱉 鼈 龞	
鳗	鰻	
鳘	鰵	
鳙	鱅	
鳚	䲁	
鳛	鰼	
鳜	鱖	
鳝	鱔 鱓	
鳞	鱗	
鳟	鱒	
鳠	鱯	
鳡	鱤	
鳢	鱧	
鳣	鱣	
鳤	䲘	
鳥	鸟 𪈼 𩾑 𲾅	
鳦	乙 𱉇 𩾐 𠃉	
鳧	凫 𩾖 鳬	
鳨	𩾜	
鳩	鸠 𪀏 䲥 䧱 𩾛 䲫	
鳪	𨾇	
鳫	雁 鴈	
鳭	𱉈 𳐀	
鳮	雞 鷄 鶏 鸡	
鳯	鳳 凤	
鳱	䧲 𩿫 𩾝 𱉊 䳚	
鳲	鸤 𨾋 䲩 𨾈	
鳳	鳯 凤 鴌 𪆍 𢐴 𧱶 𪈵 风 𠤈	
鳴	鸣	
鳶	鸢 𪃘 𩾷 𩾢 䳒 𪀝	
鳷	𫛛	
鳸	𱉓	
鳹	鵭 雂	
鳺	𨾚 𱉎	
鳻	𪂔 𩿈 𱉑 𩿉	
鳼	𪉃 鴍	
鳽	雃 𫛚	
鳾	䴓	
鳿	𱉍 𩿱 琟	
鴀	𫛜	
鴁	𨾘 𪁾 𮭢	
鴂	䳏 𱉔	
鴃	鵙 𫛞 鴂 𪁠 䳏 𨾕	
鴄	𳎦 𩿞 𩿌 𳐂	
鴅	𩿊 𦝲 𣎅 𫛝	
鴆	酖 鸩 䧵 𩾺 𪀩 䲴 䲳 䳉	
鴇	鸨 𨾙 𪀀 䳈 𪁣 𨾑 䴐 𳏺 䳰 𪃁 鳵	
鴈	雁 鳫 鳱 𩾦 𩾸 𤻉	
鴉	鵶 鸦 𪀨 𩿗	
鴊	𤰨 𨾖	
鴋	𲍮	
鴍	𬸀	
鴎	鷗 鸥	
鴐	𫛤 𪀁	
鴒	鸰 䴒 𪈝	
鴓	𮭤 𪂁	
鴔	𫛡 𩾳 𪃃	
鴕	鸵	
鴗	𫁡	
鴘	𱉡	
鴙	𩾥 𱉛 𳎵	
鴚	𱉕	
鴛	鸳 夗	
鴜	𪉈 䳄	
鴝	朐 胊 鸜 鸲 𪁖 𩿩 𪀊	
鴞	梟 鸮 𳎭	
鴟	鸱 䲭 𨾽 𩿒 鵄 𨾛 𩿨 𨾦	
鴠	𱉗	
鴡	𱉘	
鴢	𱉢	
鴣	鸪	
鴤	䧷	
鴥	𫛣 鴧 鴪	
鴦	鸯 𲜜	
鴨	鸭 𪀌 𪀋 𩿼 𪁗 𪁨	
鴩	䳀 𨾤 𱉚 𪀒	
鴫	𮴿	
鴬	鶯 鸎 莺	
鴮	𫛦 𨾺	
鴯	𳎱 鸸 𨾿	
鴰	鸹 𪁝 𳎸	
鴱	𩾘 𨿆 𱉪	
鴲	𪉆	
鴳	鷃 𫛩 𨾶	
鴴	鸻	
鴶	𱉥	
鴷	䴕 𨾸	
鴸	𨾲 𱉫	
鴹	𱉯	
鴺	鵜 𱉩	
鴻	鸿 䲨 𪀤 𪅯	
鴽	𫛪 鴑 𨾵 𨾯	
鴾	𱉲	
鴿	鸽 䧻	
鵀	𨿂 𪀼 𨿃 𬸊 𳐉	
鵁	䴔 𪁉 𩾾	
鵂	鸺 𪀪	
鵃	鸼 鴅	
鵄	𬸈	
鵅	鴼 𱉮 𪃕	
鵉	鸞 鸾	
鵊	𳎰 𫛥	
鵋	𱉽	
鵌	鷋 𳏙 𪄫 𱉸 𪇝 䳜	
鵍	𪁤	
鵎	𱉻	
鵏	𨿌 𪁭 𬷕	
鵐	鹀	
鵑	鹃 𨿔 䳌	
鵒	鹆 𨾳 𪃪 𩀑 𪀙 𳐏	
鵓	鹁	
鵔	𨿓 𱉿 鵕	
鵕	𱉾	
鵖	𱉝	
鵗	𨿕 𱉹	
鵙	鴃 鶪 𱉐	
鵚	𪉍 𨿖	
鵛	𱉠 𨿋	
鵜	鴺 鹈 𪁩	
鵝	鵞 鹅 䳗 䳘 𨿍	
鵞	鵝 鹅	
鵟	𫛭 𨿗	
鵠	鹄 䧼	
鵡	鹉 𨾥 䳇	
鵥	𳐋	
鵧	𫛨	
鵨	𪅰 䧾	
鵩	𫛳 𪀢	
鵪	鹌 𩀂 𪂻 䳺 𪈍 鶕 𪁟	
鵫	𨿧 𫛱	
鵬	鹏	
鵮	鹐 𪅎	
鵯	鹎 鴄 𨿵 𪂃 𪄆	
鵰	𫛲 𪄄	
鵱	𪂚 𨿲 𱊀	
鵲	鹊 𩁆 䧿	
鵳	𱊋 𨿱	
鵴	𪀣 𪈅 𪈓 𪈢 𨿥 𱊇	
鵵	𱊆 𪆆 𨿮	
鵶	鴉 鸦 𱉨	
鵷	鹓 𪀈	
鵸	𱊁 𨿫	
鵹	𪇺 𱊃 𩁟 𨿯	
鵺	𨿤 𲍳 𲍿	
鵻	隼 鴭 䳡 𱊅	
鵼	𱊊	
鵽	𩿩 𱊍	
鵾	鹍	
鶀	𪅾 䳢 𬸒 𨿣	
鶂	鶃 𬷼 鷁 𱊈 𪁌	
鶃	鶂 𱊄	
鶄	䴖 𨿬 𪂴	
鶅	𱊎 𨿴	
鶆	𱉵	
鶇	鸫 𪂝	
鶈	𨿩	
鶉	鹑 𪂎 𩁛 㝇 𪆾 𨿡 𳏔	
鶊	鹒 𨿶	
鶋	𱊌	
鶌	𫛵	
鶏	雞 鷄 鳮 鸡	
鶒	𫛶 𳏠 𪄠 𪃠	
鶓	鹋	
鶔	𱊗	
鶕	𬸝	
鶖	鹙 𪀣 䨂 𪀖 𪃩 𳏑	
鶗	𫛸 鶙 𪂿	
鶘	鹕 𩀉	
鶙	𱊕	
鶚	鹗 𪄍 𪅴 𩀇 𪀝	
鶛	𱊐 𩀊	
鶝	𱊏	
鶞	𱊑 𩀐	
鶟	𱊖 𩀆	
鶠	𬸘 𩀀	
鶡	鹖 䳚	
鶢	𱊒	
鶣	𬸜	
鶤	𱉱 𨿪 鵾	
鶥	鹛	
鶦	𫛷	
鶧	𲎀	
鶨	𩀅 𱊘 𪁥	
鶩	鹜 䨁 𨾣 䳱 𳎾	
鶪	䴗 鵙 𩀎 𨿎	
鶬	鸧 𩀞	
鶭	䲱 鴋 𫛯 𨾔 𪁢	
鶯	鴬 鸎 莺 鶑 鷪 𮹘	
鶰	𫛫	
鶱	𬸣	
鶲	鹟	
鶳	鳾 𪄜 𩿐	
鶴	鹤 鶡 鶮 䳽 𪈯 𩿖 鸖 隺	
鶵	雛 𪄞 𪀩 𬸅 𩿮 𪀫	
鶶	𱊝 𩀛	
鶷	𱊟 𪃜 𳏪	
鶹	鹠 𪅳	
鶺	鹡 𪃹 䳭	
鶻	鹘 𪆸 𩾲 𩾥 𩀜 𩾤 𩾻 𩿆 𳏃	
鶼	鹣	
鶽	隼 𱊛	
鶾	𳐑	
鶿	鹚 𪇔 鷀 䲿	
鷀	鹚	
鷁	鹢	
鷂	鹞 𩀘	
鷃	鴳 𮭨 𨾶 䨃 䳡 䳛 𲊵	
鷄	雞 鶏 鳮 鸡	
鷅	𫛽	
鷆	鷏	
鷇	𪃟 𩀠 𪄽 𬆮 𪇄 𪆪 𳏖 𪆉 𪈞 𣪸	
鷈	䴘 𪁦 鷉 𪁯 𩀗 𪂬 𳏅	
鷉	䴘	
鷊	鹝 䳬	
鷋	𱊠	
鷌	𲍬	
鷎	𪈪 𬸢 𩀹 鷱 𳏼	
鷏	鷆 𱊚	
鷐	𪁧 𫜀 𩀭	
鷑	𱊢 䲯 𩀩	
鷒	䳪 𱉏	
鷓	鹧	
鷔	𪉑	
鷕	𪄼 𪂣 𱊡	
鷖	鹥	
鷗	鴎 鸥 䳼	
鷘	𪀦 䳵 𪀸 𪅍 鶒 𳏠 𪆵 𳏹	
鷙	鸷 𪁻 𪁊	
鷚	鹨 𪅡	
鷛	𱊤 𪅟 𩀬	
鷜	𪈜 𬸞 𩀮	
鷝	𲍴	
鷞	鸘 𮭪	
鷟	𩀥 𬸦	
鷡	𨿏 𪂐 鵐	
鷢	𱊧 𩀾	
鷣	𫜃 𩀽	
鷤	𫛴 𩿷	
鷥	𳎷 𪆓 鸶	
鷦	鹪 𪆅 𪇶 𪆔 𪆄 𳏩	
鷧	𪆖 𱊦	
鷨	𪉊 𩀵	
鷩	氅 䨆 𫜁	
鷫	鹔 𪄑 𪆭 𪂸 𱈷	
鷭	𬸪 𩀷	
鷮	𪄘 𳈿 𱉬	
鷯	鹩 䨅 𱉉	
鷰	燕 𬸧	
鷲	鹫 𩾵 𪆩 𩀻	
鷳	鹇 鷼 鷴	
鷵	𱊩	
鷶	𱉳 𩀺	
鷷	𫜄	
鷸	鹬 𪈄 鶐 𪁀 𨙧	
鷹	鹰 𪇿 䧹 𨿳 𤸰 𤼡	
鷺	鹭 鴼 𪇸 𪆽 𩁐	
鷻	𪆃 𪈷 𪆝 𳐓	
鷼	鷳 𲍻	
鷽	鸴 雤 𳏧	
鷾	𩁈 𱊰	
鷿	䴙 𩁊 鸊 𬸯 𪇊 𳏰	
鸀	𩁍 𪅱 𪇆 𱊬	
鸁	𱊮	
鸂	㶉 䳶	
鸃	𱉌 䴊 𳐁	
鸄	𱊯 𩦨	
鸅	𱉟 𩁇	
鸆	𱊫	
鸇	鹯 𪄐 𪇮 𪄃 𩁉 𪃋	
鸉	𱉴 𩁒 𪇚	
鸊	䴙	
鸋	𫛢 𩁔 𪆮	
鸌	鹱 𪇡	
鸍	𩁖 𩿥 𲍰	
鸎	鶯 鴬 𬸕	
鸏	鹲 䴌	
鸐	𱊱	
鸑	𬸚 𩁓	
鸒	𳏿 𱊭 𪇬 𩁕 𱉰	
鸓	𱊳 𤴒 𪆼 䴎 𪈦 𩁜 𪉀 𲍩	
鸔	𪈫 𩁠 𪇰 𪈚	
鸕	鸬 𩁨 𪇸 𪈒	
鸖	𬸰	
鸗	𫛟	
鸘	鹴	
鸙	𱊵	
鸚	鹦 𪈤 䨉	
鸛	鹳 𪈻 雚 𪈩 鵍	
鸜	朐 胊 鴝 𬸱	
鸝	鹂 𪁐 𳏇 𪅆 𪈹 鵹 𪅌	
鸞	鵉 鸾	
鸟	鳥	
鸠	鳩	
鸡	鷄 雞 鶏 鳮	
鸢	鳶	
鸣	鳴	
鸤	鳲	
鸥	鷗 鴎 𲍨	
鸦	鴉 鵶	
鸧	鶬	
鸨	鴇 𲍞	
鸩	鴆	
鸪	鴣	
鸫	鶇	
鸬	鸕	
鸭	鴨	
鸮	鴞	
鸯	鴦	
鸰	鴒	
鸱	鴟	
鸲	鴝	
鸳	鴛	
鸴	鷽	
鸵	鴕	
鸶	鷥	
鸷	鷙	
鸸	鴯	
鸹	鴰	
鸺	鵂	
鸻	鴴	
鸼	鵃	
鸽	鴿	
鸾	鸞 鵉	
鸿	鴻	
鹀	鵐	
鹁	鵓 𲍠	
鹂	鸝 鹃	
鹃	鵑 鹂	
鹄	鵠	
鹅	鵝 鵞	
鹆	鵒	
鹇	鷳	
鹈	鵜	
鹉	鵡	
鹊	鵲	
鹋	鶓	
鹌	鵪	
鹍	鵾	
鹎	鵯	
鹏	鵬	
鹐	鵮	
鹑	鶉	
鹒	鶊	
鹓	鵷	
鹔	鷫	
鹕	鶘	
鹖	鶡	
鹗	鶚	
鹘	鶻	
鹙	鶖	
鹚	鶿 鷀	
鹛	鶥 𠃜	
鹜	鶩	
鹝	鷊	
鹞	鷂	
鹟	鶲	
鹠	鶹	
鹡	鶺	
鹢	鷁	
鹣	鶼	
鹤	鶴	
鹥	鷖	
鹦	鸚 𲍣 𰋷	
鹧	鷓	
鹨	鷚	
鹩	鷯	
鹪	鷦	
鹫	鷲	
鹬	鷸	
鹭	鷺	
鹮	䴉	
鹯	鸇	
鹰	鷹	
鹱	鸌	
鹲	鸏	
鹳	鸛	
鹴	鸘 𱻦	
鹵	卤 𪉖 塷 卣 𠧸	
鹸	鹻 鹼 堿 碱 礆 硷 𫠗	
鹹	咸 𪉳 醎 𳐝	
鹺	鹾 𪊁 𪉵 醝 𪊈 𪉤	
鹻	鹼 鹸 堿 碱 礆 硷	
鹼	鹻 鹸 堿 碱 礆 硷 𨢑 𥃡 𠑲 鹹 醎 𨣇 𪉦	
鹽	塩 盐 𥂁 䀋 𪉩 𤅸 𨣎 𪉟 𱲠	
鹾	鹺	
鹿	𢉖 𲎌	
麀	𪊛 𪋎	
麁	粗 觕 麤 麄	
麂	𪊨 𳐹 𪊋	
麃	麅 𳐨 𲎋 𳐠	
麄	粗 觕 麤 麁	
麆	𪊹	
麇	麕 𲽻 𪊼 麏 𳐾 𳐬 𲎔	
麉	𪊑	
麋	䴢	
麌	𪋬	
麐	麟	
麑	𳐯	
麒	𪊔 𱝌 𳐳	
麓	梺 𣝹 㯟 𱎂	
麕	麇 𲎔 𲽻	
麖	𲎍 𳐶 𳑃 𪋔 𪋠 𪋥	
麗	丽 婯 𪋘 䴡 𠪕 𠧥 𠀙 𡡜	
麚	䴥 𲜘	
麛	𱋂 𪋈 𳐡 𪋸	
麝	𪋧	
麞	獐	
麟	麐 𪋷 𪊓 𪊺 𪋲 𪊱 𪊭 𱝏	
麠	𪋥 麖 𪋔	
麡	𬸾	
麤	粗 觕 麁 麄 𤿚 蔍 𪋙 𡔙 𡔘	
麥	麦 𲚳	
麦	麥 𲎏	
麧	𥝬 𪌇 𱋇 𥝖 籺	
麨	𪎊 𪍑 𩚙 𪌕 𪍉 𱋏	
麩	麸 䴸 麱 麬 𪌻 𳑅	
麪	麫 麵 麺 面 靣 𮮄	
麫	麪 麵 麺 面 靣	
麬	𤿲	
麭	𮮆	
麮	𱋋 𪌥	
麯	麴 麹 曲 𱋐	
麰	牟 𪌚 𦭷 𪍓 𮮇 𪍫 𪌸	
麱	𱋖	
麲	𪎉	
麳	𪎌	
麴	麹 麯 曲 𪋼 𥶶 𪌬 𩍔 𪍚 𪌲 𪌗	
麵	麺 麪 麫 面 靣 糆 𪋽	
麷	䵄 𫜑	
麸	麩	
麹	麴 麯 曲	
麺	麵 麪 麫 面 靣	
麻	菻 蔴 𦱍 𦲬	
麼	庅 麽 么 𢇝 𡭯 𡻤 尛 𡭚 𤹳 𡮡	
麽	庅 麼 么	
麾	𣬡 𪎮 𪎜	
黀	𪎪	
黂	𪎬 𱋱 𪎯 𪎰	
黃	黄 𡕛	
黄	黃	
黇	𪏊	
黈	斢 紏 𪏘 𪏜	
黉	黌	
黌	黉 𪏬 𣍜	
黍	𥞆	
黎	𨞃 𨝟 𪏯 𥡚 𪏱 㴝 菞 𥢀 𪏭 𳑈	
黏	粘 溓 䴴 𳋼	
黐	𥺡 粚 𥼝 𪐑 𦡬 𲥅	
黑	黒 𪐫 𪐗	
黒	黑	
黓	䣧	
黔	𦌣	
黕	𪐨	
黗	𪐠	
默	黙 嘿	
黙	默 嘿	
黚	𪒭	
黛	𪐝 黱	
黜	㔘 絀	
點	点 奌 㸃	
黟	𢉬 𪑁	
黡	黶	
黤	𩅝	
黥	剠 𪐛 䵞	
黦	𪒣 䵫 𪑲	
黧	䵩 𪒅 𪒚 𪒺 𪒁	
黨	党	
黩	黷	
黪	黲	
黫	𪐜	
黭	𪒈	
黯	𪒠 𰼝 𭟛 𲬖	
黰	𪑳	
黲	黪	
黴	𪑛 霉 黣 𲙵	
黵	𪒧	
黶	黡 𪒞	
黷	黩	
黸	𱋶	
黻	𦓗 𭸪 𮋟 𳑑	
黼	𦓞 𩠤	
黽	黾 𪓝 𦊣 𪓑 勔 𪓖 𦋍 𪓕	
黾	黽	
黿	鼋 𪓒 魭 𪓗 𠒞 𠀻	
鼀	鼁 𪓡 𪓰 𫜟 𱋾 䵸 𪓵	
鼁	𧉧 𪚸 𱋿	
鼂	鼌	
鼃	蛙	
鼄	蛛 𬹣	
鼅	蜘 䵹 𱌄 𪓳	
鼆	𱌆	
鼇	鰲 𪓾 𪓴 𪓶	
鼈	鱉 龞 鳖 𱌇	
鼉	鼍 𪓸 𪛄 𪓽	
鼊	𱌉	
鼋	黿	
鼌	鼂	
鼍	鼉	
鼎	𪔂 㫀 𥇴 𣂨 𣃊 鼑 𥅀	
鼏	冪 羃 冖 幂	
鼒	𪔄	
鼓	鼔 皷 皼 𩉨 𪔐 𩉩 𡔷 𩊉 𪔨 𪔎 𮆟 𲶞	
鼔	鼓 皷 皼	
鼕	冬 𪔖 𪔝 𪔜 㲇 𪔳	
鼖	𢿠 𥀢 𪔫 𪔵 𡒡 䩿	
鼗	鞉 鞀 𱲈	
鼘	鼝 𪔗 𪔥 𪔱	
鼙	𧯿 𲎜	
鼚	𱌊	
鼜	𪔑 𪔯 𧒕 䥢 𥀽	
鼞	𨲗 鞺	
鼟	𣫤	
鼠	鼡 𦥩 䑕	
鼡	鼠	
鼢	𪖅	
鼣	𪖆 鼥 𪕟	
鼥	𪖆	
鼨	𪔻 𪕄	
鼩	𪖏	
鼪	䲼 𲎞	
鼬	䶇 𪕏	
鼭	𪕵	
鼯	𪁙 𪕜 𧋋 𪕡	
鼲	𱌏	
鼳	鼰	
鼴	鼹 𲎠 𳑟	
鼵	𳑚 𳑝 𳑣	
鼶	𪕻 𪕧 𪕽 𪕬	
鼹	鼴 𳑟	
鼻	𢍂	
鼽	𪖒 𪖓 𪖖	
鼾	哻 𠱢	
鼿	𪖤 𪖡	
齁	𪖙	
齃	𩕬	
齅	嗅	
齆	𪖵	
齇	齄	
齈	𱌖	
齊	斉 亝 𲔂 齐 䄢 𦙟 𠫼 斊 𡕓	
齋	斎 斋 䬩 㪰 𩝦 𢋿 𠮘 𥚪 夈 𪗒 𠫱 𩱳	
齌	𱌗 㸄	
齍	𱌘 𪗉	
齎	賫 赍 䝴 𠬎 賷 𲪭 𧷔 𬹳	
齏	韲 齑 䪡 䪢 𩐊 䪣 𧅴 䪠 𧅠 𠬘 𧅱 𩐇 𩐋 𦦏 𩐓	
齐	齊 斉 亝	
齑	齏 韲	
齒	歯 齿 𣦗 㒶 𦥒 𣥫 𡽔 𦦂 𣦋 𠔒 𠚄 𠚒	
齔	龀 𪗕 𪗥 齓 𪗠	
齕	龁 𪗟 𪗚	
齖	𬹺	
齗	龂 𪗯 𪘎	
齘	𪗣 𬹼 𪗢	
齙	龅 𪗼	
齚	𱌬	
齛	𪙚 齥	
齜	龇 𪘿 𪗶	
齝	𪗪 𪙋 𪗺 𱌯 呞	
齞	𪗛 齴 𱌫	
齟	龃 𳑬	
齠	龆	
齡	齢 龄 𪗲	
齢	齡 龄	
齣	𱌮 出	
齤	𪙖 𱌲	
齥	𪙥 𱌱	
齦	啃 龈 𪘄 𪘟 齗 𪙲 㸧	
齧	嚙 囓 𫜩 𠲼 𪗘 𪙓 𪘅 𠼜 𪘖 𲎤	
齩	咬 𫜪	
齪	龊 齱 𪘏 𪘮 𪘛	
齬	龉	
齭	𫜭 齼 𪙀 𪘷	
齮	𪙴 𬺈 𡄘	
齯	𫠜 𦦃	
齰	𪙮 䶦 𫜬 齚	
齱	𪘸 𱌶	
齲	龋 𪚌 䶚 𤘐	
齳	𪙣 𪘩 齫 𳑪 𱌳	
齴	𫜮	
齵	𪙃 𱌹	
齶	腭 𪘽 𪘰 㗁 𳑭	
齷	龌	
齸	𱌽	
齹	𪘡 𪙐 𪙉 𬺎 𪙸 𪘓 𪘠 𪙼	
齺	𪙗 𪘴 𱌭	
齻	𱌺	
齼	𬺓	
齽	𬺔	
齾	𪙿 𪚋 𫜰	
齿	齒 歯	
龀	齔	
龁	齕 𱤾	
龂	齗	
龃	齟	
龄	齡 齢	
龅	齙	
龆	齠 𱥁	
龇	齜	
龈	齦	
龉	齬	
龊	齪	
龋	齲	
龌	齷	
龍	竜 龒 尨 龙 靇 𥫈 𥪑 𢅛 𥪐 𠉒 𢄫 㡣 𢀀 𦱸 𦱉 𠊋	
龎	龐 厐 庞 庬 厖 尨	
龏	𱍁	
龐	龎 庞 厐 庬 厖 尨 䮾	
龑	䶮	
龒	龍 竜 尨 龙	
龓	䪊 𫜲 𪚞	
龔	龚	
龕	龛 𪚕 𱤵	
龖	𱍂 龘	
龗	𩆇 𪚙 𩆈	
龘	𮹝	
龙	尨 龍 竜 龒 𱚭 𱷥 𮸲	
龚	龔	
龛	龕	
龜	亀 龟 𪚧 𤕣 𧑴 黾 𪚿 𠁴 𪚨 𠃾 𪚦	
龝	秋 穐 䆋 𬓫	
龞	鱉 鼈 鳖 𱍈	
龟	龜 亀	
龠	籥 𠋁 𱰓	
龡	吹	
龢	咊 和	
龣	𪛓 觮	
龤	諧	
龥	籲 吁 𬱳	
龭	𩨎 𮹆	
龯	𨱆	
龲	𰾋	
龻	𰁜	
龽	𰞳	
鿀	𰱃	
鿁	䜤	
鿂	𮷙	
鿌	涼	
鿎	䃮	
鿏	䥑	
鿐	䲤	
鿒	鿓	
鿓	鿒	
鿔	鎶	
鿕	𱆥	
鿭	鑈 鉨	
鿳	鿸	
﨑	埼 陭 𥔎 崎 嵜 㟢 碕	
𠀾	𠁞	
𠁔	𫷘	
𠁞	𠀾	
𠁟	𱝀	
𠁾	㔿	
𠂝	匝 𲏀 衆 眾	
𠂤	𣳨 堆	
𠂲	𬓡	
𠂹	𢏒	
𠃓	昜	
𠄍	𠂈	
𠄏	𢆳 𢆴 𱹫	
𠄑	𡳾	
𠆌	庸	
𠆲	儣	
𠆺	伭	
𠆿	𠌥	
𠇐	㒜	
𠇱	佅	
𠇹	俓	
𠈨	作	
𠈪	𠈖	
𠉂	㒓	
𠉗	𠏢	
𠊧	併	
𠊬	𠙆	
𠊰	𠈕	
𠋫	候	
𠋳	𠊾	
𠋵	𠊒	
𠋸	𠋕	
𠌉	𦴐	
𠌋	𠈻	
𠌥	𠆿	
𠌬	徲	
𠍦	𫢲	
𠎅	𰂃	
𠎒	𫢨	
𠏄	𮯻	
𠏢	𠉗	
𠏮	𫢘	
𠏵	𮯹	
𠐇	𭫝	
𠐊	𫝋	
𠐍	𫣫	
𠐒	𱏂	
𠐮	𬾣	
𠐻	𠎾 𨼭 𠏯	
𠐽	𫢔 𱝺	
𠐿	𩖎 顭	
𠑃	𱏅	
𠑇	𰂻	
𠑍	𠑚	
𠑘	𱴗	
𠑙	𫢹	
𠑞	𠏾	
𠑟	𠐈	
𠑲	𫣛	
𠑹	𧟣	
𠒫	𲤱	
𠓇	𱏮	
𠓗	䞯	
𠓭	𢞥	
𠔃	兮	
𠔢	𮲴	
𠕁	冊	
𠕄	凹	
𠕠	晟	
𠕦	𦋢	
𠕭	𠕥	
𠖥	寵 𮰄	
𠖫	𫤽	
𠖷	㓏	
𠗣	㓆	
𠗦	憑	
𠗴	𠗙	
𠗺	𠗄 𣻗	
𠗿	𰄁	
𠘖	𤁩	
𠘢	𠘇 𠘒	
𠘥	𫥍	
𠘧	几	
𠘱	𢒀 㐱 𢒁	
𠙦	䒮	
𠚘	𠚡 𠥒	
𠚥	刟 𠛪	
𠚳	𠠎	
𠚹	芟	
𠛅	剾	
𠛆	𠞆	
𠛎	𠚸	
𠛔	𠚷	
𠛾	𪟖	
𠜎	鏾	
𠜒	𠜥	
𠜱	𠞇	
𠜲	𫥼	
𠜴	划	
𠜷	𱐞	
𠜼	掐	
𠝐	𱐤	
𠝝	䥷	
𠝞	𠜕	
𠝿	𫦁	
𠞆	𠛆	
𠞈	𨨹	
𠞉	𠜒 𠟫	
𠞭	𫦉	
𠞮	𦞛	
𠞰	剿	
𠟅	箌	
𠟊	𠟖	
𠟍	𠝤	
𠟨	刢 𠠢	
𠟪	𫥺	
𠠁	䥪	
𠠃	㔐 𠟜	
𠠎	𠚳 𠠰 𠠛	
𠠏	𫥵	
𠠜	𫦕	
𠠝	𠟄 𫥳	
𠠥	劖	
𠠫	𰄭	
𠠸	扐	
𠡠	勑	
𠡡	𠡹	
𠡭	𪋾	
𠡯	𠡸	
𠢉	𠡾	
𠢤	憠 𠢭	
𠢥	㔗	
𠢺	𣙂 𣜨	
𠣀	勥 𠣃	
𠣊	㔧 𠢻 𠣋 𲓐	
𠣾	𠣸 𠣴 𠤇	
𠣿	𠣽 匓 䬨	
𠤄	𠣮	
𠤏	𠦀	
𠤗	𠤑 𠤕 𠤘 𠤜	
𠤴	𠥁	
𠤼	𠥑	
𠤿	𠤾	
𠥮	㔷	
𠥴	𱑊	
𠦌	卌	
𠦒	𠦆	
𠦘	𠦕	
𠦫	𠦣	
𠧟	𠨅	
𠧪	𠨋	
𠨍	夘	
𠨎	𠨖 𠨓	
𠨭	𡴈 厈 𩰋 𠩀	
𠨲	𠩃	
𠩁	庝	
𠩗	𣢭 𠩦	
𠩘	𫨆	
𠩬	𰆙	
𠩺	𢿍	
𠪇	𠩹	
𠪚	𠪘 𠪔	
𠪟	𠩂	
𠫓	𡿮 㐬	
𠫨	𠫞	
𠬍	㕙	
𠬙	𪠡	
𠬛	𠬸	
𠬝	𠬩	
𠬢	𠬥 㞵	
𠬤	睪	
𠬦	𣲿	
𠬮	𠬩	
𠭗	𠭘 𠭮	
𠭴	㑁 䂐 𥏞	
𠮐	𦦖	
𠮫	𠮬	
𠯍	呥	
𠯑	舌 㕲 𠮮 𤯁	
𠯔	𠰊	
𠯗	咂 𠴴 𠶴	
𠯙	𠯬	
𠯟	哯	
𠯠	噅	
𠰓	啝 咊	
𠰜	𠱫	
𠰷	嚧	
𠱓	𠼮	
𠱘	𠸺	
𠱙	𠴫	
𠱚	咔 𧧎	
𠱜	喗	
𠱞	𫝜	
𠱡	𠵡	
𠱫	𥩭 𥩮 𠲗	
𠲋	𠲿	
𠲌	㖅	
𠲥	𡅏	
𠲷	㖩	
𠲻	听	
𠲿	欶	
𠳋	𨺫	
𠳞	𠶸	
𠴢	𡄔	
𠴨	𠶽	
𠵔	𭇴	
𠵘	𫩖	
𠵸	𡄣	
𠵹	𫩚	
𠵾	㗲	
𠶷	訲	
𠶸	𠳞	
𠶹	𰇡	
𠷄	𠶲	
𠷈	哷 𠻜	
𠷉	𨔗	
𠷌	𰇘	
𠷏	𫡬	
𠷑	㗶	
𠷕	𲔒	
𠷾	𠷙	
𠸹	㖪 喐	
𠸺	𠱘	
𠹃	𧪪	
𠹇	𧪫	
𠹛	𫩯	
𠹦	㗪	
𠺖	𭈈	
𠺪	𠯏	
𠺮	𫪅	
𠼗	𫪚	
𠼤	𫪄	
𠼪	𱔏	
𠼮	𠱓 𫩳	
𠽈	𭈟	
𠽫	𱒸	
𠽭	𠽮 𠽯	
𠽲	𠽳 𡂑	
𠽵	𡁄	
𠽸	𬱞	
𠾉	𠼡 𠷎 𠭵	
𠾡	𱒁	
𠾬	𫪽	
𠿎	𡁑	
𠿓	𧬩	
𠿕	𡰑 𠿻 𡁗 𪜎 𡰘 髚	
𠿘	𭉨	
𠿞	𡅹	
𠿠	𡅺	
𠿿	𭇀	
𡀠	𭈜	
𡀿	𫫵	
𡁃	𱓐	
𡁈	𡅼	
𡁉	𡂣	
𡁓	𧭌	
𡁚	𭇙	
𡁟	𰈚	
𡁯	𭇡	
𡁻	𲕚	
𡂏	𡅘	
𡂒	𫪪 䜠 𡀹	
𡂖	𲗺	
𡂙	𡁂	
𡂛	𡆏	
𡂡	𪢒	
𡂣	𡁉	
𡂩	𡁓	
𡂸	𱓣	
𡂺	𱓧	
𡂿	𫪘	
𡃄	𪡺	
𡃈	𰈮	
𡃤	𪢐	
𡃴	𱓬	
𡃴	𲗃	
𡃹	𱔩	
𡄃	𱓚	
𡄒	𱕞	
𡄔	𠴢	
𡄖	𭈉	
𡄣	𠵸	
𡄤	𭈮	
𡄩	𭝫	
𡄵	𱒨	
𡄷	𠱣	
𡅈	嚹	
𡅏	𠲥	
𡅘	𭊸	
𡅥	𫬟	
𡅧	𭉼 𱔪	
𡅭	𱓥	
𡅯	𪢖	
𡅻	𡅱 𡅽	
𡆕	𱓽	
𡆘	𱓛	
𡆩	𡇘	
𡇈	𡇵	
𡈙	囮	
𡈛	㘤	
𡈯	𱖅	
𡈳	𡈢	
𡈼	𡔛	
𡉜	㘰	
𡉟	壯	
𡉽	𱎂	
𡊄	拚 𡓴 𢹔 𢷥 𡍊 𡏰 𠬁 𡊅 𢍨 𮰟	
𡊑	壐	
𡊻	𡎗	
𡋀	𡓾	
𡋗	𡑭	
𡋤	壗	
𡋯	𡍧	
𡋽	𲝛	
𡌦	𩇭	
𡌩	塔	
𡌪	𡖪 㷇	
𡌭	㙍	
𡍂	𱷣	
𡍌	𱖒	
𡍦	堚	
𡍨	𢾅	
𡍩	拆 坼	
𡍫	𫭮	
𡍬	𱖯	
𡎠	𱲎	
𡎴	𱖭	
𡏆	𡒶	
𡏯	𱖼	
𡐔	璌	
𡐰	壢	
𡑍	𫭼	
𡑎	𫭯	
𡑑	𮰠	
𡑞	隧	
𡑟	窩	
𡑩	𱗥	
𡑭	𡋗	
𡑯	𰉱	
𡒃	隩	
𡒄	壈	
𡒈	𡑣	
𡒊	𮰡	
𡒍	埾	
𡒵	𲙻	
𡒶	𡏆	
𡒸	𱖷	
𡓁	𪤄	
𡓇	𲚈	
𡓗	𫝡	
𡓦	𰊅	
𡓫	𲙴	
𡓰	㚀	
𡓳	𱗝	
𡓾	𡋀	
𡔑	𱗏	
𡔕	𡎴	
𡔢	𨖰 𧦂	
𡕔	夃	
𡕠	𡖆	
𡕢	𡕩 𡕫 𱘥	
𡕧	𡕬	
𡕷	夐 敻	
𡖔	𡖝 𡖭	
𡖶	𡠜	
𡖾	𪀩 夡	
𡗆	𰋖	
𡗦	𡗟	
𡗷	𡘎	
𡗼	𡘌	
𡘌	𡗼	
𡘍	𡘟	
𡘐	𡙄	
𡙐	𧡩 𥆗	
𡙮	𢧜 𢧤	
𡚁	弊	
𡚇	𡙷	
𡚊	𩁂 𧃦	
𡚦	屄 𲛌	
𡚰	奺	
𡚽	侴 妞 𡥆	
𡛖	𡜮 㛂	
𡛝	𡛒 𡦞 㛑	
𡛷	姊	
𡜂	𡜡 𡞠	
𡜥	𡟴	
𡜱	嫉	
𡜼	𮱃	
𡜿	𲛥	
𡝠	㜷	
𡞋	㜗	
𡞢	娔	
𡞧	𱙩	
𡞱	㜢	
𡞵	㛟	
𡞾	嫩	
𡟪	𡠋	
𡟫	𫝪	
𡠚	𰋾	
𡠟	孎	
𡠦	𡠗 𡣼 𡢂	
𡠪	𮱔	
𡠹	㛿	
𡠽	摵	
𡡇	𡣨	
𡡓	嬃	
𡡕	㜧 𡜆	
𡡤	𡚫	
𡢃	㛠	
𡢄	𮱆	
𡢕	𡢝	
𡢘	𰌉	
𡢦	𮰒	
𡢨	𱙍	
𡢿	𭑸	
𡣔	𡣤 𡡽	
𡣕	嬪	
𡣙	𱙑	
𡣨	𡡇	
𡣬	嬽	
𡤒	𲛡	
𡤠	𫰣	
𡤡	𭑹	
𡤢	𮱊	
𡤧	𡝬	
𡤫	𫱿	
𡤶	𮱐	
𡥈	𠭂	
𡥧	孻	
𡦵	𡦭	
𡧁	𱚏	
𡧍	𡧎 𡧂 𥤵	
𡧖	𢉣 𡧰 宲	
𡧭	𢈌	
𡨚	寃	
𡨥	寇	
𡨴	寧	
𡨽	𨵥	
𡫟	𡫳	
𡫬	𥩁 𥨼	
𡫽	𡬊	
𡬁	𡬃	
𡬌	𡬆	
𡬍	㝥	
𡬖	𡪶	
𡬘	𦒨 𱚛	
𡭐	𡭍 𠪻 𠃃	
𡭜	𡮉	
𡭬	𡮣	
𡭴	𡮂 𡭽	
𡮉	𡭜	
𡮣	𡭬	
𡮤	𫴼	
𡮥	𱚥	
𡮿	𲉫	
𡯏	𡯝	
𡯛	㝾	
𡯜	𡯠	
𡯳	𡯷	
𡰌	𡰍	
𡰖	𡰄 𡯻	
𡰾	㞖 𡳠	
𡰿	𡕡 𡕞 𡕠	
𡱂	㞘 𡰪 𡱒	
𡱆	屬 属	
𡲕	屜	
𡳃	𡳳	
𡳒	𦘧	
𡳭	𧖛 𡳨	
𡳳	𡳃	
𡴆	𡴫	
𡴎	峊 𡶫	
𡵚	岕	
𡵜	𡵣	
𡵝	嵸	
𡶃	𡺬	
𡶐	𲵐	
𡶥	𱚅	
𡶴	嵼	
𡷙	𡿊	
𡷛	屽	
𡷥	峼	
𡷨	𫵸	
𡷹	𱛊	
𡸃	𡽗	
𡸊	𡷭	
𡸗	𪨩	
𡸣	𡸢	
𡸦	𡵗	
𡸨	𡸘	
𡹄	𱛝	
𡹣	𲝬	
𡹬	𪨹	
𡹵	𡺝	
𡺃	嶈	
𡺠	𰎝	
𡺨	𫵶	
𡺭	𱛨	
𡺱	𱛚	
𡻕	岁 歲 亗	
𡻘	𭗡	
𡻚	嵻	
𡻰	𲝼	
𡼊	𡻭 𡾚 𡿜 𡻱	
𡼱	𰎢	
𡼸	𱜏	
𡼾	𰎛	
𡼿	𥖚 𡶏 崫	
𡽁	𡽕	
𡽅	㟦	
𡽉	𮱲	
𡽗	𡸃	
𡽠	𡶅 𡶆	
𡽣	𱛟	
𡽳	𫶊	
𡽵	𫵹	
𡾆	𰎷	
𡾈	𡺺	
𡾒	𱛙	
𡾓	𲞕	
𡾰	𡼌	
𡾱	㟜	
𡿇	𡿏	
𡿖	𪗘 𪩛 𡾐	
𡿝	𥗾	
𡿞	𱛾	
𡿡	𱛰	
𡿩	𡿪	
𡿯	𤽃	
𢀖	巠	
𢀜	巩	
𢁋	𱜞	
𢁕	𢄦	
𢁘	𢁚 𢒌	
𢁼	𢅔	
𢂁	𢄠	
𢂑	拭	
𢂓	𢄟	
𢂷	𢄍	
𢂿	𱜤	
𢃀	幠	
𢃎	𢃤	
𢃗	䘶 𢄜	
𢄋	𦭬	
𢄌	𧜁 𦃏	
𢄐	幪	
𢄓	𰏓 𩓩	
𢄧	𢄲	
𢄺	𧝈	
𢄼	𫷈 𩒧	
𢅇	𱬣	
𢅏	㡘 簾	
𢅖	簾	
𢅡	𫷌	
𢅣	𭘚	
𢅫	𢄣	
𢅮	𢅲	
𢆍	臿	
𢆚	䅐 䄯 𢆬 𡘸 𠠅	
𢆞	䄯	
𢆶	𢆾	
𢇇	𡮟	
𢇋	㡫 𤣨	
𢇨	𢇹	
𢈈	㕉	
𢈉	庝	
𢈠	𢉨	
𢉿	𰏲	
𢊀	𢊐	
𢊃	𰏽	
𢊍	㕑 厨	
𢊕	𢉛 𢈣	
𢊰	䵇	
𢋈	㢝	
𢋔	𢇣	
𢋻	𢌃	
𢌔	𧯙	
𢌷	𮶇	
𢍁	畁 𢌿	
𢍏	𨤑 𠔉 𢍊 𢍒	
𢍚	𢍖 𣓑	
𢍣	𦅽	
𢍰	𪪴	
𢍱	𠨧 𢍹	
𢍺	弋	
𢍿	𤘚	
𢎘	𠮤	
𢎫	𢎩	
𢏏	弥 彌	
𢏯	𢏶	
𢐊	𢎷	
𢐗	𰐚	
𢐚	𱝞	
𢐟	𮱵	
𢐧	檠	
𢐲	𢐠	
𢐸	𱝜	
𢑄	𢑈 𢐬 𢑉 𢐥 𢑂	
𢑆	𢎠	
𢑇	𢏉	
𢑢	䝆	
𢒉	𧴭	
𢒾	𢒽 𢓐	
𢓅	𢕩	
𢓒	𢓏	
𢓜	佫 臵	
𢓯	𧻺 𠍧	
𢓱	𢕝	
𢓳	𢖊	
𢔣	𨔨 𧼶 𢔝 𧼰	
𢔥	𧼫	
𢔱	𢔘	
𢕐	渹 訇	
𢕕	𱝳	
𢕩	𢓅	
𢕬	𲟦	
𢕻	𨗧	
𢖕	𪢈 𱕎	
𢖳	𢗃	
𢖽	志	
𢗓	㦛	
𢗿	怽	
𢘙	𢤱	
𢘝	𢣚	
𢘞	𢣭	
𢘼	𢘁	
𢘽	怈 𢖪	
𢙈	吢 吣	
𢙐	憹	
𢙑	𢠼	
𢙒	憢	
𢙓	懀	
𢙢	恐	
𢙣	悪 惡	
𢙱	㑝	
𢙿	㦗	
𢚅	𢮈	
𢛀	悶 𢛩 闷	
𢛃	㤹 𢜥	
𢛆	𢙰	
𢛉	𢛊	
𢛔	𫹼 𱞫	
𢛯	㦎	
𢛴	𲠲 𤷪	
𢜗	𢗒	
𢜟	𰑂	
𢜩	𠊭	
𢜪	𢢟	
𢜫	惺	
𢜭	𢛠 𪫸	
𢜳	㥉	
𢜴	𢜵	
𢜶	𢠡 𳄳	
𢝁	𢤀	
𢝈	𢘷	
𢝊	㥑 𢞘	
𢝌	𢛡	
𢞁	𮲂	
𢞏	𢛙 𢖸	
𢟊	𢜼	
𢟢	𢥗	
𢟧	𢢛	
𢟯	慹	
𢟼	懜	
𢠰	𰑅	
𢠲	㤱	
𢠳	憋	
𢠵	惝	
𢠼	𢙑	
𢡂	𧑘	
𢡱	悫 愨 慤	
𢢀	𫺒	
𢢞	𢤙	
𢢰	𢤋	
𢣊	𦡗	
𢣏	㦈	
𢣐	𪬚	
𢣒	忶	
𢣗	懡	
𢣙	𢤨	
𢣚	𢘝	
𢣭	𢘞	
𢤂	悡 㥎	
𢤌	𫻇	
𢤐	𢥍	
𢤜	𫺫	
𢤞	𱞠	
𢤧	𰒖	
𢤩	𪫡	
𢤰	𢤕	
𢤱	𢘙	
𢤽	𱞟	
𢤿	𪬯	
𢥄	𢥐	
𢥇	𱟎	
𢥈	𱞋	
𢥘	𢤮	
𢥠	悚 𫹷	
𢥰	𢤉	
𢦅	愩	
𢦚	𢦻	
𢦟	𢧒 𢧆	
𢧐	戰	
𢧢	㦸	
𢧤	𮲍	
𢧴	𢦷	
𢧵	截 𱟠	
𢩘	𢩅 𨑅	
𢪇	摪	
𢪈	抩	
𢪊	技	
𢪋	𢩱	
𢪍	𢷿	
𢪏	抇	
𢪓	擧	
𢪗	𢷏	
𢪼	𢫤	
𢫊	𢷮	
𢫘	攎	
𢫞	𢶫	
𢫬	摋	
𢫮	𢬎	
𢫷	𢬯	
𢫺	𢭒	
𢬍	擫	
𢬎	𢫮	
𢬦	𢹿	
𢬬	巹	
𢬴	挕	
𢬵	拚	
𢬶	𢱥 𢽪	
𢭂	㨓	
𢭄	𢪕	
𢭆	抽	
𢭈	𢰌	
𢭏	擣	
𢭲	𲡝	
𢮛	𢮨	
𢮡	𢱂	
𢮤	𱠁	
𢯦	𫼲	
𢯩	𫼤	
𢯮	㧒 𢶂	
𢯱	搜	
𢯳	乴 𢼺	
𢯷	𪭝	
𢯺	䄔	
𢯻	𢰉	
𢯼	𢫱	
𢯾	㪞	
𢰸	𱟽	
𢰾	摠 總	
𢱇	𢰃	
𢱕	𠳖 𲖝	
𢱡	𫼶	
𢱢	㨞	
𢱣	𢳕 𢰒	
𢱤	𱠥 㩳	
𢱫	𢰌	
𢱬	𥵱	
𢱶	抋	
𢲐	𰓝	
𢲩	𫼾	
𢲫	𫼗	
𢲷	搜	
𢲸	𫼵	
𢲾	𫼫	
𢳂	𫼣	
𢳄	𢭀	
𢳆	摮	
𢳈	𢳇	
𢳚	𫽐	
𢳜	漇	
𢴁	𲦤	
𢴖	𰓸	
𢴢	𱠱	
𢴦	𫽙	
𢴧	𢴠	
𢴩	㧙 𫽳 袐	
𢵣	𭡵	
𢵧	撊 𪭾 𲡵	
𢵱	𮲏	
𢶀	𢶓	
𢶑	𢸣 𫽲	
𢶒	𪭯	
𢶙	㩓	
𢶣	㩹	
𢶫	𢫞	
𢶯	𰒽	
𢷃	𫽔	
𢷍	𢳃	
𢷏	𢪗	
𢷑	𱠚	
𢷖	𢹴	
𢷞	𭢕	
𢷣	𱟩	
𢷮	𢫊	
𢷶	𢷚	
𢷻	𱠸	
𢸁	挙	
𢸔	𭢋	
𢸙	𭡜 𱡉	
𢸣	𢶑 𢷭 𢴶	
𢸧	𧅩 𢸱	
𢸳	𫾃	
𢸴	𫾁	
𢸸	𰓕	
𢸾	𱠎	
𢹍	𢸤 㩬 𢶐	
𢹏	𰔶	
𢹓	𲢠	
𢹥	𰓗	
𢹲	𱡑	
𢹼	𰓟	
𢹿	𢬦	
𢺈	𱡖 𫼬 𱠧	
𢺎	𭢝	
𢺭	𱟺	
𢺯	𲢞	
𢺳	𪮳	
𢺴	捥	
𢻚	𢽞 𢾪 𢻏	
𢻬	𢻲	
𢻮	𢻷 𠬨	
𢻱	𢼉 𢼊	
𢻶	𠓥	
𢻹	𤿎 㩺	
𢼆	𢺷 𢂤 𢻵	
𢼔	㪋	
𢼕	𢺾 𢻽	
𢼛	敋	
𢼟	𢽗	
𢼨	𢼮	
𢼶	𣁊	
𢼸	𣁋 𲨀	
𢽃	𢽗	
𢽟	𱡘	
𢽦	㲁	
𢽳	𢻾	
𢽴	𢧈	
𢽾	斅	
𢾚	𢻕	
𢾛	𣪪	
𢾝	𣪡	
𢿓	𢿡 𫿂	
𢿛	敺 驅	
𢿡	𰕐 𫿂	
𢿳	𣀑 𢿮 𡡗	
𢿴	㩉	
𢿵	𣪿 㲂	
𢿽	𣪼	
𣀉	𢿾	
𣀊	𧰋 搛	
𣀒	𢾸	
𣀔	𣫑 𥳈	
𣀘	𢿟 𫾳	
𣀠	𢻭	
𣀣	𣀨 㪄	
𣀧	𩀼	
𣀮	𥀶 𭤑	
𣀷	𫾲	
𣀻	𫿗	
𣁀	𧥙	
𣁊	𢼶	
𣁗	𢾡	
𣁗	𢾋	
𣁚	𣁟	
𣁜	𢿜	
𣁜	𢿕	
𣁟	𣁚 𢿍	
𣁣	𢿻	
𣁳	𦧌	
𣁷	𣁻	
𣂁	𣂀 𣁿 𣁶 𣂥	
𣂆	𣁼 𣁺	
𣂈	𦮜	
𣂞	剆	
𣃁	斸	
𣃔	斷	
𣃘	斺	
𣃳	𣃷	
𣄈	㫎	
𣄙	𣄐	
𣄠	𣄡	
𣄴	𣄵 𣄶 𡮎 𣄷	
𣄸	𬀥 旤	
𣅺	㶭	
𣆐	曥	
𣆖	𣅇	
𣆗	㬁	
𣇀	晡	
𣇩	𣉩	
𣈣	𣋋	
𣈶	暅	
𣉒	曤	
𣉚	㬕 𣉫	
𣉞	暠	
𣉼	𣋞	
𣊯	𭥓	
𣋋	𣈣	
𣋞	𣉼	
𣋪	𮲨	
𣌂	𬁑	
𣌍	𱢙	
𣌧	𣅾 𣆩	
𣌬	昷	
𣍆	㿦	
𣍐	𫧃 𲓕 𱐹	
𣍨	𦢈	
𣍯	腪	
𣍰	脥	
𣎄	𦞌	
𣎑	臗	
𣎓	𦛔	
𣎗	䐋	
𣎜	𰮭	
𣎟	𫞅	
𣎵	汖	
𣎺	𣐺 𢉫	
𣏑	㭂	
𣏕	𣐈 柹 杮	
𣏢	槫	
𣐈	柹	
𣐑	𣓄 𣖲	
𣐒	𣔲	
𣐕	桱	
𣐤	欍	
𣑂	𣐰	
𣑝	檲	
𣑶	𣠲	
𣒆	𣓘	
𣒌	楇	
𣒗	㮝	
𣓁	栞	
𣓌	槹 桕	
𣓕	㭝	
𣓗	𣒪 𲦌	
𣓿	橯	
𣔵	𣛳	
𣔺	𣓍	
𣔼	竿	
𣔿	𰗘	
𣕂	𢯭	
𣕲	㮓	
𣖡	𱣐	
𣖱	樶	
𣖻	𥁐 𨡬	
𣖼	𣓓 杊	
𣖾	𣓂	
𣗊	樠	
𣗋	欓	
𣗼	𱣞	
𣘐	㯤	
𣘓	𣞻	
𣘠	𣔼	
𣘤	櫒	
𣘴	檭	
𣘷	𣝕	
𣘾	𬛕	
𣙎	㭣	
𣙤	𣚘	
𣙥	㯼	
𣙿	𬃮	
𣚀	𣚁	
𣚘	𣙤	
𣚙	㰄 𬃦	
𣚚	欘	
𣛓	𲦅	
𣛣	𬂻	
𣛹	椯 𣜅	
𣛺	𣒬	
𣜜	杤	
𣜬	𪳗	
𣝁	𥱼 箄	
𣝅	𣝆	
𣝑	𣟰	
𣝓	檿	
𣝕	𣘷 馢	
𣝜	𪓎	
𣝞	𩏙	
𣝡	𮲸	
𣝼	𲧘	
𣞁	㮠	
𣞎	𣠩	
𣞐	𰗚	
𣞙	𣡆	
𣞷	𣚜	
𣞻	𣘓	
𣞽	𱣋	
𣟋	𣟯	
𣟌	𣟍	
𣟵	𣛼 㰕 𱣘	
𣠕	𬄞	
𣠩	𣞎	
𣠲	𣑶	
𣠺	𢺅	
𣡌	𬄬	
𣡩	𲦗	
𣡭	𣜖	
𣡶	𬃳	
𣢁	𣢂	
𣢉	𣢚	
𣢒	𣢧	
𣢜	𣤡 𣢢 𣢄	
𣢣	𣣝	
𣢬	𣢽	
𣢱	𣣦	
𣢺	欦 㰹	
𣣈	敜 𣣣	
𣣋	𪌒	
𣣌	𣣰	
𣣏	𣣤	
𣣕	𣣍	
𣣠	𣣡	
𣣲	𣤥 𣢩	
𣣳	𣤍 𣣵 𣤣	
𣣸	𣤎 𣣧	
𣣹	𣣥	
𣤇	㱋 𲮮	
𣤋	𰙕	
𣤌	𠽶	
𣤬	𧭪	
𣤭	𦆃 䌠	
𣤶	𣤺 𬅲	
𣤹	𥽁	
𣤿	𬶷	
𣥀	𣤁	
𣥂	𣥗	
𣥊	𣥢	
𣥻	踜	
𣥾	𨆰	
𣦵	𡰤 𡰮 歺 歹	
𣦹	𣦸	
𣦻	𣦼	
𣦼	𱑸 𱥌	
𣧂	𣧅	
𣧌	𣧆	
𣧍	𣧰	
𣧖	𣦷 𣧐 㱜	
𣧡	𣧵 𣧌	
𣧧	𦤚	
𣧬	𣧔	
𣧸	𣧋 㰷	
𣨅	𣩗	
𣨐	殂	
𣨡	𣧭	
𣨢	𣧪	
𣨶	㑰 𤸁	
𣨼	殢	
𣩕	𬆙	
𣩱	𣨵 𣩄	
𣩷	𣩕	
𣪊	㱿	
𣫍	𲭩	
𣫐	𣪐 𣪾	
𣫒	𫶲	
𣬎	𣬐	
𣬚	𠓗	
𣬶	𲨅	
𣬽	𱥟	
𣭠	𣭄	
𣭤	𣯴	
𣭴	𣭵	
𣭶	𱥠	
𣭺	𣭽	
𣮃	𣯂	
𣮉	䋱	
𣮊	𣮰	
𣮧	𤷋 𣯓 𣯟 𣯊	
𣯄	𲨑	
𣯏	𣮩 㲨	
𣯛	𱚮	
𣯜	𣮬 𣮯	
𣯣	𣯩	
𣯩	𣯣	
𣯪	𢒩	
𣯴	𣭤	
𣯶	毶	
𣯼	𣰮	
𣰈	𣬠	
𣰊	𱥡	
𣰚	𣰖	
𣰛	𰚱	
𣰨	𬇄	
𣰵	𱥤	
𣱐	𣱒 𣱑	
𣱓	𦦛	
𣱝	氭	
𣲏	㳊	
𣲗	湋	
𣳆	㵗	
𣳤	𣳄	
𣳨	𠂤	
𣴇	𰝜	
𣴖	㳨	
𣴟	𣴼	
𣴣	焋	
𣴷	挱	
𣵷	𣢟	
𣵾	𮳅	
𣶒	𫂱	
𣶞	𣹼 𣵢	
𣶩	澅	
𣶫	𣿉	
𣶯	𰛉	
𣷣	𱥵	
𣷾	𱦈	
𣸀	泋	
𣸃	𦱈	
𣸐	沯	
𣸛	溯	
𣸣	濆	
𣹇	𣸌	
𣹞	溕	
𣹤	𣸏	
𣹲	漽 𣸒	
𣺬	㵁	
𣺼	灙	
𣺽	𤁣	
𣻏	𬇼	
𣻑	𭰒	
𣻓	𣻒	
𣻛	湷	
𣻳	𲩕	
𣼊	𭰗	
𣼚	𣹼 𣶞	
𣼩	𰛺	
𣼳	𱦊	
𣼼	𮳈	
𣽆	𣵸	
𣽏	𪶮	
𣽕	𣿏	
𣽷	瀃	
𣽽	潸	
𣾍	㶌	
𣾠	𱧚	
𣾷	㳢	
𣾺	𱦭	
𣿂	瀡	
𣿉	𣶫	
𣿒	𣿓	
𣿭	𮳃	
𤀄	𣽭	
𤀤	𤂳	
𤀪	𬈱	
𤀲	㵷	
𤁐	𮳍	
𤁝	𱧜	
𤁣	𣺽	
𤁪	𬈾	
𤁰	𤂥 𣻩 潪	
𤃀	𤁼	
𤃡	𱩂	
𤃩	𤅷	
𤃪	𤂴	
𤃭	𤄩	
𤃶	𧰥	
𤃷	𱨿	
𤃸	㴖	
𤄃	𱨸	
𤄖	𭰏	
𤄙	𰝞	
𤄷	𪶒 𱦶	
𤅊	𠶿 𮳖	
𤅙	𬇬	
𤅢	瀹 𤅰	
𤅩	𭰥	
𤅬	灊	
𤅰	瀹 𤅢	
𤅲	𤅠	
𤅳	㳼 𤁭	
𤅶	𣷷	
𤅷	𰛻	
𤆍	赤	
𤆏	𮳚	
𤆝	炇	
𤆡	熓	
𤆢	㷍	
𤆵	𲄛	
𤆼	𮳢	
𤇃	爄	
𤇄	熌	
𤇭	爖	
𤇯	煾 𤐷 𤇷	
𤇻	𭶙	
𤈑	𤈥	
𤈣	𤈒	
𤈥	𮳨	
𤈩	㷢 𤏀	
𤈶	熉	
𤈷	㷿	
𤉹	𤒓 炥 𤒜 𤊸 𤒉	
𤊀	𤒎	
𤊲	𤇱 𤎠	
𤊶	㸊	
𤊾	𤋂	
𤋄	熃	
𤋏	熡	
𤌃	𤌕 𤋨	
𤌌	䨍 𤍧	
𤌎	𨴙	
𤍖	𬊗	
𤍜	𰞷	
𤍠	熱	
𤍤	𱭠	
𤎤	𬝃 𱐽	
𤎥	袩	
𤎭	𠓮	
𤎱	臇 㷷 㷪	
𤎲	𤐀	
𤎶	𱪯	
𤎺	𤓎	
𤎻	𤑳	
𤎽	𱫜	
𤏐	𭴳	
𤏩	𮳯	
𤏪	𱫊	
𤏳	𮳱	
𤏶	𤓏 𤒣	
𤏻	𤍛	
𤏽	㷣	
𤐀	𤒬	
𤐛	𬊢	
𤐧	𥻅 𤌈 𤏛 㷶 𤓜 𤐸 煏 𤏹 𤓞 𤎪	
𤐨	𪸞	
𤐴	𬊭	
𤐶	𲋬	
𤑔	爇	
𤑕	爋 熏	
𤑚	𮳶	
𤑳	𤎻	
𤑷	𱬍	
𤑹	𪹀	
𤑻	爗	
𤑿	𤒤	
𤒎	𤊀	
𤒘	𬊯 𲫱 𲬘	
𤒞	𨐹	
𤒤	𱬏	
𤒦	𬋃 𤒡	
𤒨	𮳸	
𤒻	𪹹	
𤓆	𱬡	
𤓌	𪹠	
𤓎	熸 𤎺	
𤓓	𬊜 𲫼	
𤓖	𭴢	
𤔀	𤓷 𤓶	
𤔂	𤓴	
𤔔	𠭟 𤔬 𤔐 𤔦 𤔒	
𤔱	𠚡 𠥪 𦦪	
𤕟	𤕠	
𤕦	𠵪 𡄉 𤕧 𠽽 𠹣 𱔈	
𤕪	爿	
𤕭	將 将	
𤕯	漿	
𤕷	㸠	
𤕾	𤗂	
𤖖	𤗶	
𤖘	𤗸	
𤗏	𤖯	
𤗛	𤗗	
𤗮	𱭜	
𤗯	𨻵	
𤗲	𱭞	
𤗳	𰠝	
𤘀	𪺣	
𤘑	𱭤	
𤘞	𤘟	
𤘟	𤘼 𤙉	
𤘡	䶖 𦧈	
𤘣	牨	
𤘧	㸵	
𤘫	𤘛	
𤘹	𤘢	
𤘺	𤘻	
𤙯	𤛮	
𤚫	𤛋	
𤚴	𮳺	
𤚼	𤚲	
𤛑	㺎	
𤛠	𬌥	
𤛩	𤛛	
𤛮	𤙯	
𤛱	𫞢	
𤛻	𤜐	
𤜆	𪺪	
𤜡	𨛤	
𤜣	狏 㹝	
𤜵	𤡲 𤝴 犴	
𤜷	𤝃	
𤝛	狏	
𤝢	𤢟	
𤝬	𤞈	
𤝻	狏 𧳁	
𤞁	犱 𤜿 𤜾	
𤞃	獩	
𤞤	玁	
𤞲	𤞙	
𤟃	䝊	
𤟎	𲮕	
𤟠	𤟕	
𤟤	𤟴 𰡋	
𤟭	㚟	
𤠋	㺏	
𤠎	𤟺	
𤠑	𤡼	
𤠔	𰡐	
𤠟	狧 𤟬	
𤠮	𪺸	
𤡂	𤢹 𲯓	
𤡄	𤟸	
𤡢	𤢌	
𤡥	𤡦 𲮷	
𤡪	𤢍 𤢩	
𤡮	𤢅	
𤡲	𤜵	
𤡳	𤡻	
𤡴	𤟩 𤝠	
𤢌	𧴐 𤡢	
𤢕	斁	
𤢟	𤝢	
𤢪	獵	
𤢹	𲂧 𲯓	
𤢻	𢢐	
𤣎	𰡢	
𤣤	𬌴	
𤣥	玄	
𤣲	㺬	
𤤷	𤧫	
𤤺	𤦥 玴	
𤥗	珋	
𤥭	𰡰	
𤥵	𮴑	
𤦀	瓕	
𤦇	𱮴	
𤦎	𮴅	
𤦏	璁	
𤦩	𮴏	
𤦹	𱮺	
𤦼	𤦁 㻨 𤧬	
𤧑	𮴆	
𤧙	㻀	
𤧚	璁	
𤧬	𤦁 㻨 𤦼	
𤧸	𮴒	
𤨕	𤨙 玏	
𤨗	𱯑	
𤨵	𱯆	
𤨹	㻯	
𤩂	𫞧	
𤩃	𤪄	
𤩊	𮴗	
𤩑	𮴥	
𤩝	𮴓	
𤩮	𤩯 𤪢 㻺	
𤩱	琔 𤩴	
𤩽	瓛	
𤪌	璂 𤩒	
𤪍	𤪆	
𤪎	𤩤	
𤪙	珎	
𤪥	𬍜	
𤪧	𮴇	
𤪺	㻘	
𤪿	㻁 璝 𤤨	
𤫎	𮴶	
𤫞	𱯄	
𤫟	𮴠	
𤫩	㻏 𲰐	
𤫱	𤬈	
𤫺	𤬇	
𤬅	𪼴	
𤬏	𱰆 𲻗 𧁾	
𤬖	𤬍 𤫾	
𤬘	𲰘	
𤬛	𤬜	
𤬯	𣘞 𤬰	
𤬷	𤬼 𤭡 𤭗 𤭠 𤭿	
𤭕	㼹	
𤮊	㼹	
𤮋	𤭳	
𤮍	甎	
𤮎	𤮉	
𤮘	㽅	
𤮚	𤮸	
𤮜	𦉕	
𤮦	𬎬	
𤮨	礱	
𤮰	𤬿	
𤮱	𡓳	
𤮼	𨠍 𢎌	
𤯍	𤯌 𤯎	
𤯷	𤰀	
𤰈	𦯞 备 𤰇 𠃰 𤰅	
𤱨	𤲻	
𤱽	畉	
𤲍	𱰱	
𤲓	𭻔	
𤲖	𤲎	
𤲢	𭻍	
𤲬	𤳟 㽭	
𤳄	𤳸	
𤳆	𱰼	
𤳇	𱰺	
𤳈	塲 畼	
𤳉	䎯	
𤳊	𤳫	
𤳖	𤳛	
𤳫	𤳊	
𤳯	𤳼 𤳌 𥷿	
𤳷	𪽝	
𤳸	𤳄	
𤴀	𤳭	
𤴐	雷	
𤴙	㽰 𤱐	
𤴦	𤴥	
𤴨	𤴧	
𤴾	㾙 庍 𤷓 𦢯 𦜓	
𤵀	疙	
𤵒	𱱌	
𤵛	𤷁	
𤵟	𤴻	
𤵨	瘐 𤶉	
𤵻	𤵅	
𤵼	𤹟 𤷛	
𤵽	𤸎	
𤶊	癐	
𤶙	痄	
𤶠	㾻 𤵫	
𤶧	𤸫	
𤷀	𤶶	
𤷃	𪽭	
𤷈	𤸏	
𤷎	痽 䏨	
𤷒	痺	
𤷙	𤹬	
𤷱	𱱊	
𤷻	𤸢 𤺙 𤶆	
𤷽	㾡	
𤸁	㑰	
𤸈	㾞	
𤸑	𤹫 癁	
𤸪	𤸞 痸	
𤸫	𤶧	
𤸬	𤺀	
𤸱	𤷷 𤸙	
𤸵	𤵗 痡	
𤸷	㿏 𤺽	
𤹤	𤼆	
𤹺	𤻜	
𤺄	瘇 尰	
𤺉	𰣦	
𤺓	𤷗	
𤺔	𪽴	
𤻊	㿗	
𤻜	𤹺	
𤻝	𰣩	
𤻱	㿖 𤺿	
𤻲	𬏤	
𤼀	𱱩	
𤼈	𰣫	
𤽁	𤽆	
𤽂	皔	
𤽜	皌	
𤽯	㿧	
𤾀	皟	
𤾉	𰤓	
𤾣	𤾧	
𤾥	㬝	
𤾭	𤾳	
𤿀	𤾶	
𤿎	𱴁	
𤿏	𤿒	
𤿙	𠂱	
𤿚	䏢 𥅗	
𤿲	麬	
𥀃	𥀄	
𥀈	𤿪 𥀉	
𥀏	𥀇	
𥀔	𪊙	
𥀖	𥀋 𥀜 𥀑	
𥀣	𬐓	
𥀫	𥀭 㿵	
𥀬	𪠏	
𥀰	𥀥	
𥀲	𰤫	
𥀹	𣀺	
𥁎	𤬶	
𥁕	昷	
𥁠	𥁸	
𥁢	䀉	
𥂁	鹽	
𥂘	𥁻 𥁺 𥁭	
𥂫	𰤽	
𥂬	𥂶 𥂡 𥃀	
𥂸	𬐠	
𥂹	𥂠	
𥃂	𥃀	
𥃔	𥃜	
𥃤	𥆎 𥄩	
𥃧	䀞	
𥃪	𥄧	
𥃵	𥃶	
𥄉	𥄊	
𥄑	𦔾	
𥄔	昁	
𥄕	𦭾 𦭝 𦤄	
𥄗	䀑	
𥄘	𧵏	
𥄱	䀟	
𥄳	眔	
𥄷	𥈋	
𥅘	𥌃 䑐	
𥅴	䀹	
𥅾	䚎	
𥆋	𥊊	
𥆏	𥊱	
𥆔	㫴	
𥆣	𥈍	
𥆧	瞤	
𥇇	𥆝	
𥇔	𬑇	
𥇛	𠁗 𥈀 𥈜 𥈏	
𥇜	𥌲	
𥇢	䁪	
𥇵	𥇤	
𥇿	𥇙	
𥈉	𥋂	
𥈓	𥄼	
𥈙	䀳	
𥈟	瞍	
𥈩	𧢆 𥆇 𥂅 𧡥	
𥉈	𥈌 𠊹 𥉉 𥊕	
𥉓	𥈕	
𥉖	眭	
𥉛	𥍂	
𥉝	𥆖	
𥉸	𰥣	
𥉹	𥊻 𥍔	
𥉻	䀙	
𥉾	𩖇	
𥊀	䀐 𲹹	
𥊇	𥂄	
𥊝	𥅿	
𥊨	𥌿	
𥊴	𥊁	
𥊸	𦗟 𥌩	
𥋝	𰥭	
𥋞	𥌼	
𥋟	䂀 𮵅	
𥋢	𥌪	
𥌃	𥅘 𥇎 眯	
𥌄	𥈷	
𥌚	𬑙	
𥌛	𥊈	
𥌭	𥌣	
𥌺	矅 𥌉	
𥌾	𥊹	
𥍉	𥆍 𱳅	
𥍟	𥍠	
𥍧	𥍠	
𥍫	𥎇	
𥍮	𥎌	
𥍵	𥎊	
𥍻	䤷	
𥍽	䂌	
𥎂	𥍾	
𥎋	𥍷	
𥎝	䂎	
𥏝	𪿊	
𥏫	𥏲 𥏻	
𥐘	石	
𥐞	硭 𡵀	
𥐟	礒	
𥐪	硡 𥗞 𥕗 𥔀	
𥐯	𥖅	
𥐰	𥕥	
𥐻	碙	
𥑋	𥒒 䃶	
𥑘	砞	
𥑣	𥑽	
𥑰	𥒒 䂯	
𥑺	磀	
𥒪	䃕 磱	
𥓿	鉈 砣	
𥔀	渹 訇	
𥔂	𮀲	
𥔎	埼 陭 﨑 崎 嵜 㟢 碕	
𥔬	𮵊	
𥔭	𥕘	
𥕍	𱴟	
𥕏	𱴏	
𥕐	𲴂	
𥕤	礚	
𥕥	𥐰	
𥕧	𱴙	
𥕲	𥕳	
𥕽	𥖗	
𥖅	𥐯	
𥖇	𱳾	
𥖏	𮀪	
𥖩	𬒊	
𥖫	𥗣	
𥖲	𪿞	
𥗀	𡫱	
𥗇	𪿵	
𥗊	𱴐	
𥗡	𱴉	
𥗭	𥗱 𱳼	
𥗴	𬒓	
𥗹	𰧈	
𥗺	𬒇	
𥗽	𲴘 𬒗	
𥗿	𥘁	
𥘃	𮀡	
𥘯	祙	
𥚋	㞊	
𥚗	𮵙	
𥜌	澳 襖	
𥜐	𫀓	
𥜒	𲟭	
𥜓	𱵥	
𥜰	𫀌	
𥜾	卨 𥜽 𥝁 𠨈 𠨁	
𥝢	利	
𥝬	𥝖	
𥞦	𥞵	
𥞱	䅃	
𥞴	𥟾	
𥞵	𥞦	
𥟂	䅘	
𥠇	穆	
𥠴	𥡔	
𥠷	𥢋	
𥠻	稽	
𥠿	𥞼	
𥡃	𥞙 𦱐	
𥡜	𥢵	
𥡞	稽	
𥡢	𥼁	
𥡪	𥤌	
𥡴	稽	
𥢊	𬓱	
𥢎	𥢞 𥡡	
𥢒	𱶐	
𥢓	𥠢	
𥢢	䅪	
𥢶	糩 𫞷	
𥢷	𫀮	
𥣘	𱶂	
𥣫	𧀅	
𥣬	𥤐 𲷡	
𥣮	𥠈	
𥣰	𥤓	
𥣾	𥤅	
𥤞	𥢴	
𥥅	竉	
𥥍	罙 𥤷	
𥥥	𥦈	
𥥧	𥨔 𥩊 𥨮	
𥦌	𡋱 𡷟 硦	
𥦞	𥧬	
𥧂	𥨐	
𥧐	䆓	
𥧝	𩄭	
𥧲	䆮	
𥧽	𡡃	
𥨍	𥧜 𥦸	
𥨐	𥧂	
𥨢	𥨒	
𥩗	𥩕	
𥩲	䇋	
𥩺	𥪂	
𥪂	𥩺	
𥪋	𥪬	
𥫎	𩕉	
𥫱	囤	
𥬀	䉙	
𥬇	笑	
𥬈	篵	
𥬔	𦳰	
𥬞	籋	
𥬠	篘	
𥬯	𣛖	
𥬲	𥳔 𥬸	
𥬷	𥬹	
𥭉	𥵊	
𥭐	箻	
𥭒	𦯁	
𥭕	𥯘	
𥭖	𥭓 𥯷 𤕝 𩐟	
𥭠	𥲐	
𥭭	𥮭	
𥭮	䈍	
𥮋	𥸠	
𥮒	𥷰 𥮓	
𥮕	笐	
𥮘	𥵮	
𥮚	䈀	
𥮜	䉲 𥭫	
𥮾	篸	
𥯛	䈷	
𥯟	𥯠	
𥯤	𫁳	
𥯩	𥮥 𦳵	
𥯮	𥬽	
𥯶	䇢	
𥰠	𥮦 𥷠 𥱾 𥲬	
𥰡	𢷾	
𥰣	𥰤 𥰷	
𥰦	𥯼	
𥰭	𥭯	
𥰮	𥰯	
𥰹	𥳴	
𥱍	𥰳	
𥱔	𥵃	
𥱷	𥳹 𥳸	
𥱸	𬔯	
𥲅	𢥰	
𥲈	𥵥 𥮩	
𥲚	䉘 𥵹	
𥲥	籢	
𥲨	𥲣	
𥳊	𬔹	
𥳍	𱷽	
𥳏	𬔸	
𥳐	𥴥	
𥳔	𥶴	
𥳘	箽	
𥳞	𥷖	
𥴀	𥱐	
𥴆	𱷾	
𥴗	𱸔	
𥴦	篴	
𥴨	𫂖	
𥴩	𥵰	
𥴫	𥷽 𥳨 𥷝 㩔	
𥴺	䈘	
𥴼	𫁺	
𥵃	𥱔	
𥵊	𥭉	
𥵚	竻	
𥵛	𮅎	
𥵜	䇚	
𥵝	𬕬	
𥶀	𱸤	
𥶇	𱸧	
𥶛	𥳳 䈕	
𥶶	𥽧	
𥶹	𥴰	
𥶽	𫁱	
𥷒	𱷰	
𥷗	𥶾	
𥷙	𥶖 𥵲	
𥷨	𱸗	
𥷼	𥷛 𥳛	
𥸊	䉨	
𥸠	𥮋	
𥸡	𥸜	
𥸣	𲶳	
𥸤	籲	
𥸱	𱸴	
𥹥	𥼽	
𥹻	𥼢 𥻪	
𥹽	䊀	
𥺅	䊭	
𥺇	𥽖	
𥺼	𮇔	
𥻟	糯	
𥻤	𬖖	
𥻦	䊛 𫂿 𥼆	
𥻩	糆	
𥻵	𬖞	
𥼗	𥼡	
𥼡	𥼗	
𥼶	𬖘 𥽉	
𥼼	糐	
𥼽	𥹥	
𥽂	𥼹	
𥽖	𥺇	
𥽘	𥹅	
𥽭	𬖺	
𥽳	𦗶	
𥽸	𲷨 𲷕	
𥽽	𥽱 𫧷	
𥽿	糳 𥹁 𥽦	
𥾂	𥽛 𥹕 𥼸 𥽮 𮇤 𥽣	
𥾇	𱹫 𱺑	
𥾝	𬘔 𦇪	
𥾩	𥿅	
𥾯	𫄝	
𥿃	䋾	
𥿄	𥾬	
𥿉	𬘚	
𥿊	𦈈	
𥿑	𮶁	
𥿠	𱺔	
𥿡	𱺙	
𥿯	𥾭 𬘦	
𥿼	𦃑 𥿪	
𦀇	經	
𦀉	𥿱 𥿰	
𦀎	𮉥	
𦀖	𫄦	
𦀗	𱺝	
𦀘	𦄕	
𦀝	綗	
𦀨	𱺢	
𦀬	𱺡	
𦀺	𲸯	
𦀽	𱺞	
𦁄	𰬙	
𦁉	𦁑	
𦁎	𦅊 䋏	
𦁕	𰬦	
𦁧	𰬨	
𦁺	𱹵	
𦂅	𦈒	
𦂈	紬	
𦂋	𬘸	
𦂔	𱺨	
𦂗	䌃	
𦂳	緊	
𦃄	𦈗	
𦃏	𰫢	
𦃒	𬘼	
𦃓	𦄛	
𦃖	緂 𤎥	
𦃘	𦆣 𬘽	
𦃩	𫄯	
𦃭	𱺟	
𦄋	𬘞	
𦄍	𦆌 𬘾	
𦄑	𦇀	
𦄧	𬘿	
𦄼	𬘳	
𦅀	𱹳	
𦅃	䌭	
𦅇	𫄪	
𦅈	𫄵	
𦅋	𬙃	
𦅘	𰬝	
𦅧	䌤	
𦅯	𱺬	
𦅷	𬙅	
𦅸	繇	
𦆆	𰬾	
𦆈	𰬹	
𦆙	𱺭	
𦆭	𱺖	
𦆲	𫟇	
𦆹	𬗔	
𦆻	𦅶	
𦆾	𦈁	
𦇎	𰭁 緫 繱	
𦇒	𱹻	
𦇗	繏	
𦇘	𡈳	
𦇛	𰬼	
𦇧	𦆢 𦌓 𦆡 𠫈 𣯅	
𦈃	𱺰	
𦈈	𥿊	
𦈉	緷	
𦈋	綇	
𦈌	綀	
𦈎	繟	
𦈏	緍	
𦈐	縺	
𦈑	緸	
𦈒	𦂅	
𦈓	䋿	
𦈔	縎	
𦈕	緰	
𦈖	䌈	
𦈗	𦃄	
𦈘	䌋	
𦈙	䌰	
𦈚	縬	
𦈛	繓	
𦈜	䌖	
𦈝	繏	
𦈞	䌟	
𦈟	䌝	
𦈠	䌥	
𦈡	繻	
𦈣	䍂	
𦉐	𤮫	
𦉢	䍅 𦉣 𨯻	
𦊂	𦊍	
𦊌	𲸾	
𦊔	𦌫	
𦊜	𦊘	
𦊴	𦊪 𦊭	
𦊾	𦋑	
𦋅	𣫴 𡸔	
𦋓	𱻄	
𦋡	䍒 𦊏 𦊎 䍙	
𦌔	䠣 𦌻 𦋭 𨂳 𦋠 𦌮	
𦌬	䍢 𦌳	
𦌵	䍣	
𦌾	𬙪 𦍆 𦍃	
𦍆	𬙫	
𦍋	芈 芉	
𦍕	𲮩 徉 牂	
𦍠	䍽	
𦍩	羖	
𦍹	𦍽	
𦎗	𤖆	
𦎣	䍰 𦏚 𦏍 𦏉	
𦎦	𦏃	
𦎫	𦎧 𠆆	
𦎯	𦎼 𲹏	
𦎱	𦎩	
𦎸	𦏙	
𦎹	𰭚	
𦏆	𦍻	
𦏑	𰭗	
𦐄	䲳 䀪 𨾒	
𦐉	𦐼	
𦐋	𦐍	
𦐕	䎈 𦐪 𦐞	
𦑌	𦑍	
𦑣	𦑪	
𦑲	𦑶 䎓 䳴	
𦒀	𫅥	
𦒎	𦑐 𦒄 䎚	
𦒑	𦒔	
𦒜	𩙼	
𦒟	𦑵 𦐚 䎅	
𦒦	𦒩	
𦒧	𦑱	
𦒮	𱻢	
𦒶	𦒸 𦒲	
𦒺	𠺛 𦓃 𡄒	
𦒻	𦒾	
𦓚	𦓝 𦓙	
𦓯	䅅	
𦓻	𦔥	
𦔌	䅲	
𦔓	𦔟	
𦔔	䅼 𦔨	
𦔖	𫅼	
𦕒	覘 䦓	
𦖉	𦕋	
𦖋	𦗙 𦗊	
𦖞	𲊨	
𦖨	䏀	
𦖩	聗	
𦖬	𦗃	
𦗒	𦘅	
𦗔	䜈	
𦗴	𦡁	
𦘧	𡳒	
𦘴	𦙅 𦚈	
𦙀	𦙹	
𦙫	𨡶 𨢏 𩜎 𤏾	
𦙱	𦚻	
𦙵	腕	
𦙶	股	
𦙼	骴	
𦚓	胓	
𦚦	脀 𦞪	
𦚧	䏛	
𦚹	𣎄	
𦛖	𧶋	
𦛡	𱢃	
𦛥	𥆶	
𦛨	朥	
𦜖	𬁺	
𦝛	𮶔	
𦝠	𦟀	
𦝨	𩩰 𦞉	
𦝫	腰	
𦝲	𣎅	
𦝼	膢	
𦞌	𣎄	
𦞙	𦞱	
𦞚	𦚡	
𦞛	𬁸	
𦞣	臊	
𦞤	䏤	
𦞦	臛 𩟯 𦢽	
𦞪	脀 𦚦	
𦟐	𬁳	
𦟕	䐇	
𦟗	𦣎	
𦟟	𦣆	
𦟠	𦢑	
𦟤	饈	
𦟼	𫆝	
𦠁	脨	
𦠄	𦢍	
𦠅	𫞅	
𦠓	𦠩	
𦠖	𦢭	
𦠜	𱼇	
𦡁	𲺑	
𦡌	𦡭	
𦡏	𰗅	
𦡖	𰗆	
𦡝	𫆫	
𦡧	𮌌	
𦡶	𰯂	
𦡹	𱼎	
𦢈	𣍨	
𦢊	𤿉 𤿈	
𦢌	殰	
𦢧	䑅	
𦢨	爓	
𦣇	𬂂	
𦣍	𦢹	
𦣎	𦟗	
𦣞	𲏘 𦣝	
𦤎	臯	
𦤘	𠆒	
𦤦	𩡔 𦤪	
𦤫	䫁	
𦤶	致 𦤹 𦤺	
𦥐	𧤡 𩋩	
𦥘	𱚞	
𦥝	舀	
𦥭	𦦐 𦥾	
𦥻	𦦇	
𦦗	栄	
𦦝	𦦧 𦦞	
𦦧	𦧁 𦦡 𦦝	
𦦫	𥃖	
𦦾	𦦰 𦦺 擣	
𦧈	䶖 𦧎 𤵞	
𦧉	呚 吱	
𦧟	𦧱 𦧭 𦧥	
𦧡	𤌜	
𦧴	噒 𰰆	
𦧺	𫇘	
𦨇	𦨏	
𦨉	𦨏 䑢	
𦨢	𦨝 𦨠 䑭	
𦨦	𦩪	
𦨩	𦪽	
𦨬	𦨺 𦨤	
𦨲	𣔶 舤 𦨌 舧	
𦩀	𱼹	
𦩉	𦩈	
𦩶	𥰥	
𦪀	𲻤	
𦪈	𣘢 𦪰	
𦪒	𦩝	
𦪙	䑽	
𦪠	𱼺	
𦪪	竼	
𦪬	𦩥	
𦪭	𬜔	
𦪶	𦫈 𱽃	
𦪽	𦨩	
𦫈	𦫆	
𦫶	芁 𦫷 𦬥 穋 𦱭 𦱠 𦰙 𦭺	
𦬄	𦫸	
𦬔	苽	
𦬙	𦿍	
𦬚	𦬤 𦬜	
𦬢	𦬵 𬻋 𱽌	
𦭮	𡷚	
𦭯	𦳭	
𦭿	𦰳 𦯙	
𦮷	𱽎	
𦮹	𢁀 𦰮	
𦮻	𦮌 𦬾	
𦮼	𦯡	
𦮾	𦸖	
𦯈	𦵲	
𦯔	苐	
𦯖	𦶄 𦵐	
𦯨	䒪 𦳕	
𦰘	茋 菧	
𦰥	𱽨	
𦰪	𦳸	
𦰯	𤫳	
𦰲	𦲰	
𦰴	䕳	
𦱄	菇 𦳍 𦻨	
𦱌	𫇪	
𦱧	𡼘	
𦱱	𦱲 萛	
𦲕	𱽛	
𦲯	𦱟 𦱏 𦯘	
𦲷	蒞	
𦳋	𦰵 𦬿 蒯 𠣯 䓒	
𦳝	𰰢	
𦳞	䒔	
𦳡	𦰹	
𦳩	𧅲	
𦳫	𦰻	
𦳹	𦯏	
𦴇	𦾵	
𦴔	𦴁 𦴲	
𦴚	𨔴	
𦴧	𮶞	
𦵕	𬝖	
𦵟	𦳻 𦱰	
𦵦	𧀝 蔋	
𦵩	湭	
𦵯	䒠	
𦵵	𦷿 𦿥	
𦵷	𦾼	
𦶀	𲻲	
𦶆	𬜺	
𦶇	𥧢	
𦶈	䔜	
𦶌	𦸔	
𦶍	𱾊	
𦶙	𣘇	
𦷝	芻	
𦸐	𦽂	
𦸓	𦮇	
𦸙	𦬓	
𦸥	𦼏	
𦸮	𦺘	
𦸰	𱽤	
𦸷	𬝊	
𦸺	䓱	
𦹛	萼 蕚	
𦺉	𧀮	
𦺔	䒝	
𦺞	𦱕	
𦺣	𰱝	
𦺮	茰 萸	
𦺶	𦸠	
𦺸	𧃮	
𦻃	𧂴	
𦻅	𦼩	
𦻕	蘟	
𦻖	𱽾	
𦻜	𦺁	
𦻝	𦺩	
𦼏	𦸥	
𦼪	𧃺	
𦼫	𦸵 𧃢	
𦼰	𦼵	
𦼷	𦿓	
𦽅	𲼒	
𦽊	驊	
𦽎	𦼋	
𦽏	𦳓 𲻺	
𦽒	𬝠	
𦽵	𦽚	
𦾏	𰅻	
𦾮	𦼮 𧁀	
𦾰	䕲	
𦾵	𦴇 𦽓 𦺺	
𦾶	𬞋	
𦾺	銚	
𦾽	𦵺	
𦿁	𦽌	
𦿆	𲼍	
𦿍	𧀸 𦬙	
𦿜	薲	
𦿭	𮶷	
𧀀	𮶩	
𧀄	𦿄	
𧀔	䓼	
𧀠	𦼙	
𧀦	𱾢	
𧀨	𦼤	
𧀬	𦸝	
𧀹	蔗	
𧀺	𲼱	
𧁊	𧂡	
𧁾	𲽚	
𧁿	𮏺	
𧂂	𮶬	
𧂅	𬞣	
𧂐	𲽉	
𧂒	䕴 𧄝	
𧂘	𧅍 𦷠	
𧃐	𧀿	
𧃒	𲽁	
𧃞	𦾲	
𧃽	𰱊	
𧄍	𲼲	
𧄎	蘨	
𧄔	𲽊	
𧄠	𧅟	
𧄾	𥷾	
𧄿	𧆃	
𧅆	𧅇	
𧅖	虉 𧄞 𧄷	
𧅘	𧄨	
𧅤	𬝄	
𧅯	𪅆	
𧅺	𧆔	
𧆄	𬟥	
𧆐	𥽇	
𧆣	𧇕 𲾁	
𧆥	𢈤 䖖	
𧆦	𧆫 䖌	
𧆻	𧇉	
𧆼	𧈆	
𧇠	𡰐	
𧇼	𧰑 㙱	
𧇿	𧇣 𧇈	
𧈑	𧈓 𧈎 𧈗 𧈖	
𧈜	𩦶	
𧈝	虬	
𧈟	𧈞 𧏾 䘌	
𧈴	𫋧	
𧈿	𬠐	
𧉀	𧉘	
𧉁	𧐆	
𧉄	𧉋	
𧉆	𧉍	
𧉈	蚽	
𧉐	𧕟	
𧉞	䗿	
𧉫	𲾑	
𧊶	𧊱	
𧋍	蜇 䱑 𧎴	
𧋐	𧌐 𧊸	
𧌓	蛗	
𧌘	𲾴	
𧍕	䖼	
𧍢	𧊔 𧎘	
𧍰	𧑟	
𧍲	𧍻	
𧍳	𧋑 𧊠	
𧍴	𬟾	
𧍶	𧊐	
𧎢	蟘	
𧎫	𩹳	
𧎯	蚗	
𧎰	𧔡 𧖏	
𧎵	𧏨 𫊨	
𧎾	𧌬 𧐯 𧐑	
𧏂	𧏜 𧏃	
𧏖	蠙	
𧏗	蠀	
𧏺	𮓹	
𧏻	𬠃	
𧐅	蛆	
𧐇	螱 𧕈	
𧐈	𲀆	
𧐐	𰳁	
𧐒	𧋐 𧐁	
𧐔	䗑	
𧐖	𲾭	
𧐞	𧎲	
𧐢	蠔	
𧐯	𤴂 𧕌 𧐋 𧐣	
𧐱	𬟺	
𧐴	𧑲 𧑙	
𧑀	𧑳	
𧑎	𧎹 𳀅	
𧑏	蠾	
𧑓	𧉷 𧒁 𧒑	
𧑗	䗿 𧒫	
𧑚	䗙	
𧒂	𧑉	
𧒄	𱿧	
𧒒	蠭	
𧒖	𰲺	
𧒗	𲀂	
𧒘	𧔽 𧓞	
𧒭	𧔥	
𧒯	𫊹	
𧒽	𧒜	
𧓍	蠙	
𧓐	𲿖	
𧓬	𧓾	
𧓳	𲾳	
𧔂	𧔃 𧔵 𧒡	
𧔝	𱿚	
𧔞	𧕜 𧉗 𧏐	
𧔠	𧕆	
𧔢	𱿾	
𧔣	𲿹	
𧔥	𧒭	
𧔨	𧓿 𧐘	
𧔪	𲿻	
𧔴	𧒨	
𧕄	𲾩	
𧕅	𧖜	
𧕚	𲀀	
𧕛	𧕦	
𧕝	䗿	
𧕟	𧕺 𧉐	
𧕥	蟆	
𧕦	𬠷	
𧕯	𲾢	
𧕰	𧖚	
𧕲	𧔰 𧕣	
𧕶	𲿿	
𧕽	蠶 𧖟	
𧖆	蟽	
𧖟	蠶 𧕽	
𧖦	𬠱	
𧖧	𥀿 𧖨	
𧖺	𧖶 𥁺	
𧗁	𥁞 𧗃 𧗊	
𧗆	䕄	
𧗇	𧗒	
𧗎	𧗘	
𧗿	𧗵	
𧘂	衝	
𧘅	𲀟	
𧘓	𧜕	
𧙀	𧞪	
𧙃	𧙑	
𧙧	𧙒	
𧛒	𧜬	
𧛞	𧛫	
𧛣	毠	
𧛸	𬡎	
𧛾	𧜡	
𧜁	𬡕	
𧜂	𬡔	
𧜅	𧛪 𧞔	
𧜈	𧝻	
𧜗	䘞	
𧜘	𮷁	
𧜡	𧞔	
𧜣	𧚮 𬡍	
𧜥	䘸	
𧜭	䙱	
𧜵	䙊	
𧜶	𮖃	
𧝉	襧 䌤 𧛢 𦁥	
𧝊	𧙢	
𧝋	橔	
𧝏	𧙵 𧘫 𧛿	
𧝑	𧝣 襢	
𧝝	襰	
𧝞	䘛	
𧝮	𳀻	
𧝴	𧛔 𢃝 𧞶	
𧝸	𧜇	
𧞅	𰳻	
𧞐	𧞮 𧞗	
𧞔	𧜡	
𧞕	𧞙	
𧞣	𰳹	
𧞪	𧙀	
𧞫	𫌋	
𧞶	𬡦	
𧟆	𳁋	
𧟌	𬡠	
𧟙	䙥 袊	
𧟨	𧟤	
𧠈	𬢇	
𧠎	𡰾 𧠵	
𧠏	𧠞	
𧠘	𧠙	
𧠠	𧠟	
𧠥	𬢉	
𧠫	眰	
𧠯	𲁕	
𧠳	𮷄	
𧠵	𬢍	
𧡋	𧡖 𧢏	
𧡍	𬢈	
𧡨	𧡭	
𧡪	𬢏	
𧡬	䚀 𧡆 䚁 𥉎	
𧡱	𲁘	
𧡴	𫌫	
𧡸	𰴛 𧡀 𥆖	
𧡹	䚃	
𧡺	𥉙	
𧢃	𰴚	
𧢄	𧢨 𫌬	
𧢆	䚎 𧡥	
𧢍	𬢓	
𧢜	𧢎 𧢣	
𧢝	𲁔	
𧢞	覵 𧡌	
𧢢	𬺟 𥌺	
𧢯	𧢰	
𧢼	𧣉	
𧢾	𧣐	
𧣁	𧣍	
𧣒	𧣻	
𧣚	䚥 𧢺 𧣏	
𧣪	𤙜	
𧣭	𧤷	
𧣴	𬢕	
𧣸	𧤼	
𧣼	𧣱	
𧤏	𧥄	
𧤒	𧤜	
𧤕	𧣮	
𧤗	𧤬	
𧤤	觹	
𧤲	𧤶	
𧤽	𲁞	
𧥅	觽	
𧥖	𧥗	
𧥙	𣁀 𧥚	
𧥣	𬣚	
𧥮	𧥯	
𧥹	𧧽	
𧥺	𬣝	
𧥼	𲂄	
𧦝	𧦻 𫍞	
𧦦	𰵘	
𧦧	𫍟	
𧦭	𬣢	
𧦵	𮷆	
𧧆	𧨮 𧪲	
𧧝	𬣨	
𧧢	𧨆 詤	
𧧭	𬣺	
𧧵	𰵢	
𧧸	𧭀 𰵬	
𧧹	𧨻	
𧧺	𧫔	
𧧻	𧩳	
𧨂	哬	
𧨄	𧥦	
𧨊	𬣶	
𧨝	𰵪	
𧨱	𧧫	
𧨳	𰵳	
𧨾	𬤂	
𧨿	𲂎	
𧩎	𮷉	
𧩕	𫍭	
𧩙	誕 䜥	
𧩣	䜀	
𧩦	𬤅	
𧩧	𬤏	
𧩨	𧩩	
𧩪	𬤋	
𧩮	𧨠	
𧩹	訑 𧦩	
𧩼	𫍶	
𧪍	𲂑	
𧪘	𧬑 𧭨 𧭯 嗟 𧪰 𧨁	
𧪜	𧫋 𧩝	
𧪞	𬤒	
𧪠	愱	
𧪡	𬤓	
𧪦	𬤕 𧮑	
𧪪	𬤔	
𧪮	𰵻	
𧪳	謥	
𧫕	𧭂 詧	
𧫚	𬤈	
𧫝	𫍺	
𧫢	𧩆 𧨉 𧭅	
𧫥	誝	
𧫦	䚷	
𧬁	𰶅	
𧬅	𬤜	
𧬇	𬤞	
𧬊	𧬜 𧪷	
𧬌	𬤠	
𧬤	諥 𫍼	
𧬨	噦 𬣪	
𧬪	謴 𬤖	
𧬮	𬤧 𧭑	
𧬯	𰶋	
𧬻	𬣵	
𧭈	𫍾 𲂇	
𧭞	𧭌 𲂗	
𧭟	𧭋	
𧭤	𡅜 𧮔	
𧭥	𮷇	
𧭹	𫍐	
𧮆	𬤚	
𧮇	𬣴	
𧮈	𬤯	
𧮓	𬤱 𧮊	
𧮪	詀	
𧮫	𠔌 𠶸 谷	
𧮶	𧯂 𧯁	
𧯡	𩚴 𩜌 碗	
𧯦	𧰌	
𧯫	𢹑	
𧯷	卺 𢀿 𧯢 𲼛	
𧰆	𬤷	
𧰊	磌	
𧰎	鿲	
𧰓	𤮵	
𧰠	𤮵	
𧰲	𢑡 𧰺	
𧰻	𧱢	
𧱁	𧳆	
𧱏	豙	
𧱐	㹲	
𧱓	𧱠 狵 𢁁 𧱎 𧳑	
𧱙	𧳛	
𧱝	䝌	
𧱻	𰶨	
𧲌	䝊	
𧲍	𧲎	
𧲕	𫲜	
𧲜	𧲉	
𧲝	𧲞 𢆈 𧲔	
𧲱	㹧	
𧳀	𧴎	
𧳂	𧲶	
𧳄	𧲳	
𧳅	𧲬 㹬 𣬔 𧳡 𣬒	
𧳎	𤕻	
𧳕	𧳟	
𧳙	貄 𤝽 𧱇 㹭	
𧳙	𲮔	
𧳟	𧳕 猍 𧳥	
𧳨	猱 㑱	
𧴂	𧴟	
𧴄	㺎 𧱿	
𧴙	𧴎	
𧴪	𧴲 𭕆	
𧴭	𢒉 𧵏	
𧴯	孭	
𧴲	𲂺	
𧵅	𳂫	
𧵆	𲂼	
𧵊	𬥴	
𧵑	𧵎 𲂾	
𧵛	𲂿	
𧵣	賯	
𧵳	䞌	
𧶄	𬥷	
𧶔	𧹓	
𧶟	𬥹	
𧶠	賣 𧷗	
𧶢	𤼹 𠮆 𤼺 𤼰	
𧶧	䞎	
𧶬	𱕡	
𧶲	𬥼	
𧶵	𧷊	
𧶶	販	
𧶽	𰷟	
𧷎	𪠀	
𧷏	𧷗 𧸇	
𧷗	𧶠	
𧷛	𰷨	
𧷡	𲃅	
𧷧	𧷄	
𧸅	𧹀	
𧸈	覕	
𧸖	贃 𰷬	
𧸘	𫎨	
𧸦	𬥾	
𧸪	𬥿	
𧸫	𫬙	
𧸿	𧸹	
𧹈	𪥠	
𧹑	䞈	
𧹒	買	
𧹓	𧶔	
𧹔	賬	
𧹕	䝻	
𧹖	賟	
𧹗	贃	
𧹞	赧	
𧹲	𧹷 㷤	
𧹶	𧹽	
𧺣	𧽵	
𧺼	𨒤	
𧻀	𧼳 𧻧 䞣	
𧻓	𧼲	
𧻕	趚 𧼕	
𧻘	𨀦	
𧻙	𧼟	
𧻚	𧼉	
𧻶	𧼡 𧻑	
𧻺	𢚯	
𧼏	𧺻	
𧼒	𧽡	
𧼭	𧽏 𨕦	
𧼮	𬦅	
𧽐	䞿	
𧽒	䠗 𲃍	
𧽙	𲃉	
𧽢	𬦆	
𧽤	𧾴 𨅟 𨄏	
𧽯	𫎸	
𧽵	𧺣	
𧽸	𧼞	
𧽾	𧾬	
𧾁	𧾓	
𧾚	𰷱	
𧾢	𧽟 𧽭 𧽳 䟌	
𧾣	𧽻	
𧾥	𰷸	
𧾨	𢖘	
𧾩	𧾝	
𧾱	䞤	
𧾻	𧿀 𧾹	
𧿈	𨇁	
𧿛	蹤	
𧿯	𧿓	
𧿴	跊	
𧿶	跎	
𧿹	拇	
𨀁	躘	
𨀕	𧻺 𧻔	
𨀥	𧿞	
𨀱	𨄣	
𨁁	𢕐	
𨁂	𬦯	
𨁔	跳	
𨁴	𨅍	
𨁸	𨀞 𦜏	
𨂁	痷	
𨂐	𫏌	
𨂜	𨂑	
𨂝	踫	
𨂭	𣥽	
𨂱	𲃡	
𨂺	𨈊	
𨃘	𨂓 𬦩	
𨃚	𨅞	
𨃜	𬦹	
𨃞	𨃟	
𨃟	𨃞	
𨄄	𨈌	
𨄅	𳃇	
𨄉	𰸎	
𨄍	𲃿	
𨄙	𲃜	
𨄚	𤴠	
𨄣	𨀱	
𨄰	𬦵	
𨅊	𨇂	
𨅍	𨁴	
𨅎	𨄒	
𨅔	𨅕	
𨅗	𲃾	
𨅚	𩪋 𨄨	
𨅛	䠱	
𨅫	𨇞	
𨅬	躝	
𨆅	𬦫	
𨆉	𮛗	
𨆊	𨅘	
𨆏	䠔	
𨆝	𲃟	
𨆞	𲃣	
𨆪	𫏕	
𨆱	𬦴	
𨆷	𲃪	
𨇁	𧿈	
𨇍	𬧑	
𨇒	𲃲	
𨇖	𦢛	
𨇗	𬦣	
𨇝	𨇲	
𨇞	𨅫	
𨇣	𬦾	
𨇤	𫏨	
𨇯	𰸇	
𨇰	𫏞	
𨇱	𲃦	
𨇻	𢖥 𪎓	
𨇽	𫏑	
𨈀	𬧚	
𨈆	𬧛	
𨈇	𬦾	
𨈊	𨂺	
𨈌	𨄄	
𨈎	𲄄	
𨈚	𨉉 𨉮 𨉊	
𨉉	𨈚	
𨉖	𰿰	
𨉗	軉	
𨉹	𬧩	
𨉺	𲄥	
𨊍	𨈠 𨊗 𨈔	
𨊛	𲄙	
𨊠	𰹱	
𨊰	䢀	
𨊵	𲅁	
𨊸	䢁	
𨊹	𰹻	
𨊻	𨐆	
𨋁	𬨃	
𨋖	𨌡	
𨋚	𬨅	
𨋛	𨍠	
𨋢	䢂	
𨋪	𥫖	
𨋮	𰺆	
𨌄	𬨋 𮷚	
𨌅	𨍁 𨍃 𨎯 䡨 𨏇	
𨌈	𫐍	
𨌴	𨋱	
𨍈	𰺔	
𨍌	𨌲 𨏵	
𨍏	𰺕	
𨍐	𬨏	
𨍒	𰹾	
𨍩	𨏰 𨎧 䧛	
𨍰	𫐔	
𨍳	軺	
𨍴	𨌩 𨎖 𨎋	
𨍹	𬨐	
𨎀	𨎦	
𨎌	𫐋	
𨎐	𨎌 𨏅	
𨎩	𬨒 輄	
𨎪	𰺚	
𨎫	𳄐	
𨎭	𨎱	
𨎮	𨐉	
𨎹	𨏸	
𨏈	𨍪	
𨏒	𰺢 𨏲	
𨏔	𰺌	
𨏠	𨐇	
𨏥	𨐊	
𨏧	𲄴	
𨏪	𨏓	
𨏵	𨏝 𨐂	
𨐃	𲅃	
𨐅	軗	
𨐆	𨊻	
𨐇	𨏠	
𨐈	輄	
𨐉	𨎮	
𨐊	𨏥	
𨐔	𨐕 𱣭	
𨐨	𨐢	
𨐶	𰺨	
𨑊	𫯒	
𨑒	徒	
𨑠	𱝑	
𨑩	𨒝	
𨑹	䢨	
𨒉	䢡	
𨒛	迩	
𨓁	𨗙 𨕧	
𨓰	𨘉	
𨓲	𨔃 𲃌	
𨔛	𨕑	
𨔣	迦	
𨔴	𦴚	
𨕛	𨕨	
𨕧	𨗙	
𨖇	𲅐	
𨖏	𨗋	
𨖻	遛	
𨖿	𳄙	
𨗣	䢱	
𨗲	薖	
𨗾	𬨫	
𨘀	𮷥	
𨘁	𨔖	
𨘌	𬩎	
𨘏	𮷣	
𨙀	𨖣 𨗟	
𨙂	𨙣 𨙃 邎	
𨙔	𨙦 𩦛 𩣷	
𨙦	𨙔	
𨙬	邔	
𨙵	𨛜	
𨙷	𨚢	
𨙸	𨙾	
𨙹	𨚒	
𨚳	𨛞	
𨚴	邚	
𨚵	𨙰 𨛚	
𨚶	𨛻 𨚽	
𨛋	䧉 𨛎	
𨛤	𨛛	
𨛫	𨞃 𨟀	
𨛳	䣠	
𨛶	𨟢	
𨜒	𨜣	
𨜙	𨛶	
𨜴	𨝕 𨞨 𨜨	
𨜷	𨜃 𨜤	
𨜻	𨛵	
𨜿	𨝡	
𨝋	𨝠	
𨝌	𨝝	
𨝍	𨟦 䢴	
𨝕	𨞨	
𨝘	𨛵	
𨝸	𨟣 𨟬 𨟜	
𨞔	𲆛	
𨞚	𨞞	
𨞨	𨝕	
𨞪	𫜷	
𨞺	𫟫	
𨟃	𨝔	
𨟅	𨟄	
𨟊	𫟬	
𨟑	𨟟 𮷨	
𨟠	䣤	
𨟯	𲆔	
𨟳	𨣞	
𨟴	𨟸	
𨟵	䣥	
𨠍	𨟲	
𨠑	𨠶	
𨠒	𡗹 𨠢 䣲	
𨠗	醠	
𨠦	𨠈 𨟿	
𨠨	𨣧	
𨡎	𨡣	
𨡘	𦜗 𦜋 𨡐 𦜾	
𨡙	𨢿	
𨡲	醔	
𨡸	𨢬	
𨡺	𨣈	
𨢋	𨢤 𨣗	
𨢌	𨣷	
𨢎	䣾	
𨢡	𨡕	
𨢥	䤍	
𨢨	𨣼 𨡮 𨣭	
𨢸	𮡈	
𨢹	𨢏	
𨢿	𨡙	
𨣃	𰼋	
𨣈	𨡺	
𨣉	𬪫	
𨣘	𨡵	
𨣞	𨟳	
𨣦	藇	
𨣧	𨠨	
𨣨	𰼏	
𨣸	𬪯	
𨤋	𬪯	
𨤡	𬪺	
𨤰	𨤻	
𨤻	𨤰	
𨥂	釨	
𨥈	𮷵	
𨥉	𲇯	
𨥕	𮷹	
𨥙	𰽟	
𨥛	𨱀	
𨥜	𬬴	
𨥟	𫓫	
𨥠	𲇶	
𨥤	𮷽	
𨥦	𨥳 𨧬 𬬳	
𨥭	𮸃	
𨥮	𮷿	
𨥺	𬭂	
𨦂	𨰋	
𨦃	䤪	
𨦍	𮸅	
𨦑	𲇺	
𨦙	𲇹	
𨦡	𰽽	
𨦫	䦀	
𨦭	鐒	
𨦱	𰾊	
𨧀	𬭊 𳇮	
𨧐	𰾇	
𨧚	𬭐	
𨧜	䦁	
𨧦	錃	
𨧫	𬭑	
𨧮	䥸	
𨧰	𫟽	
𨧱	𨱊	
𨨄	𲇾	
𨨅	𲈃	
𨨏	𬭛	
𨨛	𫓼	
𨨝	𬭘	
𨨞	𲈇	
𨨠	𲈈	
𨨢	𫓿	
𨨩	𲈅	
𨨮	𨧮 䥸	
𨨯	𬭟	
𨨹	𬭞	
𨩃	𮸔	
𨩎	𮸘	
𨩨	𬭠	
𨩰	𫟾	
𨪃	𲈏	
𨪅	𬇃	
𨪈	𲈔	
𨪉	鍗	
𨪋	𰾨	
𨪐	鈄 鋀 𨮃 𠨣	
𨪕	𫓮	
𨪗	𨬎	
𨪜	𮸚	
𨪦	𮸙	
𨪩	𲈓	
𨪵	𬭧	
𨫀	𬭫	
𨫋	𮸉	
𨫒	𨱐	
𨫔	䥍 𨫦 𨬝	
𨫬	𲈕	
𨫼	𰾧	
𨬂	𬭱	
𨬐	鐝	
𨬒	𰾳	
𨬕	𨬟 𰾵	
𨬖	𫔏	
𨬞	𬬶	
𨬟	𨬕 𰾵	
𨬫	𮸢	
𨭃	𬭷	
𨭆	𬭶	
𨭊	𬭒	
𨭌	𬭵	
𨭎	𬭳	
𨭐	𬭙	
𨭖	𫔑	
𨭗	𬭇	
𨭚	𬭺	
𨭛	𰾿	
𨭥	𬬼	
𨭸	𫔐	
𨮁	𰾺	
𨮂	𨱕	
𨮅	𬭹	
𨮒	𨯠	
𨮔	𲇮	
𨮜	𳆲	
𨮰	𬭾	
𨮳	𫔒	
𨮺	鑙 𬭿	
𨯂	𮸣	
𨯅	䥿	
𨯗	𮸝	
𨯙	𮸆	
𨯟	𫔓	
𨯤	𲈠	
𨯩	鐕	
𨯵	𬮀	
𨯿	𰿀	
𨰃	𫔉	
𨰄	𲈂	
𨰉	䥷	
𨰋	𫓳	
𨰚	𲇵	
𨰠	𰿊	
𨰥	𫔕 𲈐	
𨰦	𫒭	
𨰭	𬮃	
𨰰	𲈉	
𨰲	𫔃	
𨰵	𬬇	
𨰷	𬮂	
𨰹	𰿀	
𨰾	鎷	
𨰿	釳	
𨱀	𨥛	
𨱁	鈠	
𨱂	鈋	
𨱃	鈲	
𨱄	鈯	
𨱅	鉁	
𨱆	龯	
𨱇	銶	
𨱈	鋉	
𨱉	鍄	
𨱊	𨧱	
𨱋	錂	
𨱌	鏆	
𨱍	鎯	
𨱎	鍮	
𨱏	鎝	
𨱐	𨫒	
𨱑	鐄	
𨱒	鏉	
𨱓	鐎	
𨱔	鐏	
𨱕	𨮂	
𨱖	䥩	
𨱥	𰿖 矮	
𨱧	𩬗	
𨱵	𨱶	
𨲋	𩭧 𩔾 𨲥	
𨲭	𬮄	
𨲳	𫔖	
𨳁	𨳅	
𨳌	𨳏 𰿦	
𨳐	𰿧	
𨳑	𨸁	
𨳒	𮤭	
𨳕	𨸀	
𨳙	𮤯	
𨳚	𰿪 𨳜	
𨳝	䦐 𲈻	
𨳞	𲈸	
𨳦	𲈷	
𨳨	𬮜	
𨳳	𢨸	
𨳷	𨴥 𨳻	
𨳸	𰿭	
𨳿	𬮡	
𨴄	𳈓	
𨴑	𨳽 𬮣	
𨴒	䦬	
𨴖	閦 𨳖	
𨴗	𨸅	
𨴙	𤌎	
𨴤	𬮧	
𨴹	𫔲	
𨴼	𲈶	
𨵅	𨵌 閜	
𨵆	𬮩	
𨵌	𬮰	
𨵗	𬮯	
𨵤	𬮮	
𨵦	𰿵	
𨵩	𨸆	
𨵫	𲉃	
𨵬	𬮵	
𨵸	𨸇	
𨶀	𨸉	
𨶈	𲉅	
𨶏	𨸊	
𨶑	𰿸	
𨶛	𳈕	
𨶮	𨸌	
𨶯	𮤸	
𨶰	𰿹	
𨶲	𨸋	
𨶹	関	
𨶻	𬮸	
𨶿	𬮹	
𨷇	𨵷	
𨷈	𬮙 𱾣	
𨷑	𲉇	
𨷓	𨷳	
𨷯	𲈫 𲈳	
𨷰	閝	
𨷱	𨷸	
𨷲	𨸎	
𨷶	𲈴 𲈾	
𨷺	阄 䰗 𨵜 鬮 䦰 𩰘	
𨷻	𫔱	
𨷿	䦳	
𨸀	𨳕	
𨸁	𨳑	
𨸂	閍	
𨸃	閐	
𨸄	䦘	
𨸅	𨴗	
𨸆	𨵩	
𨸇	𨵸	
𨸉	𨶀	
𨸊	𨶏	
𨸋	𨶲	
𨸌	𨶮	
𨸎	𨷲	
𨸔	𨸒	
𨸘	𨽏	
𨸚	級	
𨸝	阺	
𨸟	䧢	
𨸬	陣	
𨸭	陂	
𨸰	㘲 泦	
𨹁	𨸖	
𨹌	𨛇	
𨹜	𨻉	
𨹸	䧂	
𨹺	𨺅 䧞	
𨺟	阷	
𨻈	𨻨	
𨻌	𨻾	
𨻲	罅	
𨻶	隙	
𨻹	𨽈	
𨻼	𨻀	
𨼳	𫔽	
𨽈	𨻹	
𨽌	檃	
𨽍	豄	
𨽏	𨸘	
𨽸	𩭞	
𨾊	䲨	
𨿐	䧽	
𨿠	𩁅 䳠	
𨿢	鶇	
𨿭	𩁌	
𨿿	䳯	
𩀋	𪃉	
𩀨	𪅜 𩀰 䳷 𫕚	
𩀼	𣀧	
𩀿	𩁀 𪅽	
𩂄	霕	
𩂆	雬	
𩂧	䨕	
𩂨	𳉇	
𩃬	陰 霒	
𩃸	𩆦 𠄴 靅 𩂕	
𩃹	𩃡	
𩄛	䨯	
𩄡	䨬	
𩅀	𩆔 𩅱 𲉵	
𩅂	𩃘	
𩅉	𩅧	
𩅙	𫕨	
𩅦	𱁞	
𩅽	𩇀	
𩅾	𫡶	
𩆓	𲊒	
𩆭	霿 𩇋	
𩆷	𩂅 𩁺 𩃔 𩅼 𲊂	
𩆿	𩇈	
𩇉	𮦚	
𩇓	雷	
𩇟	㵾 𩇝	
𩈉	𩈊 𩈌	
𩈣	𩈖 䣻	
𩈥	𩓀	
𩈶	𩈝 𩈫 𩈑	
𩉍	𬰣	
𩉙	𬰡	
𩉥	𨌉 𨊼	
𩉧	𩊩	
𩉹	𩋪	
𩉺	𩉻	
𩊅	𩋶	
𩊜	䩔 𩎫	
𩊝	𩊞	
𩊰	𩉫	
𩋃	𠤸	
𩋄	𩌄	
𩋈	𩊼	
𩋊	𨌧	
𩋌	𱁱	
𩋘	鞋	
𩋠	𩉣 𩊘	
𩋢	𩋫	
𩋨	𩋟	
𩋬	𱁱	
𩋰	𬰤	
𩌄	𩋓	
𩌇	䪚	
𩌏	䪙 𨍭	
𩌑	䩩	
𩌦	𩌳 𩎉 𩋀 𳊥	
𩌨	㹐	
𩌩	𩏘	
𩌮	𩎇	
𩌰	䩔 𩍑 𩋐	
𩌲	𩍳	
𩍅	𩊗	
𩍋	𩍊	
𩍓	𩏨 𩌋 𩏔	
𩍙	𩏫	
𩍜	𱁳	
𩍦	𩉹	
𩍪	𩌭	
𩍿	䪇 𩊬 𩏯 𩏵	
𩎑	𩎈 䡽 𩍴	
𩎒	𬰱	
𩎓	韍	
𩎕	𱂃	
𩎖	𫖑	
𩎛	𩎡	
𩎟	𱂄	
𩎠	𬰴	
𩎢	𩏾	
𩎦	𩉤 𩎔 𩊔	
𩎮	𩏉	
𩎯	𩎩 𩏏	
𩎺	𩎝	
𩎽	𩏒	
𩏂	𫖓	
𩏇	縀 𩎶 緞 䪗 𩋦 𩋥	
𩏌	𬰵	
𩏐	𩳷	
𩏠	𫖖	
𩏡	𩏐	
𩏢	𩏷 𩏶 𥾀 揫 𩏸	
𩏪	𩏽	
𩏲	𩏚	
𩏴	𬰸	
𩏵	𩏮 䪔	
𩏷	𫃗	
𩏼	䪏	
𩏽	𩏪	
𩏾	𩎢	
𩏿	䪘	
𩐀	䪗	
𩐌	𱂍 𨽮 𩐕	
𩐒	䪡	
𩐨	𪔔	
𩐭	諗	
𩐳	𮸷	
𩐵	𩐹	
𩑃	𬰺	
𩑇	𠮒	
𩑊	𩇄	
𩑐	𲊹	
𩑑	𩑗	
𩑒	𱂠	
𩑔	𫖪 𩑨 𩑡	
𩑡	𱂡	
𩑢	䫊 䪹	
𩑣	𬱔 𤴨 疣 𩑲 𩑌	
𩑤	𩒾	
𩑦	𬱕 𩓔	
𩑰	𩒢	
𩑸	𲊻	
𩒎	𫖭	
𩒜	𬱡	
𩒝	𬱝	
𩒯	𩒪 𩔟 𩕅	
𩒱	𩓽	
𩒲	𬱤	
𩒺	𱂩	
𩒼	𬱥	
𩒾	䫓	
𩓠	𩓸 𩓡 𩔩	
𩓣	𩖕	
𩓥	𩓆 𫖵 𳏆	
𩓸	𬱧	
𩓹	𬱨	
𩓿	䫇	
𩔁	𩉖 䩈	
𩔅	𩔙	
𩔇	𱂳	
𩔈	𬱭 奤 𩒕 𩒋	
𩔉	𩑥	
𩔊	𬱛	
𩔐	𮸶	
𩔑	𫖷	
𩔖	類	
𩔗	類	
𩔚	翁	
𩔝	𲋁	
𩔣	𩔛 𱂷 𩕇	
𩔳	𫖴	
𩔴	𩪉	
𩔶	㦄 𩔷	
𩕇	𩔛 𱂷 𩔣	
𩕊	𩕸 𬱱	
𩕔	𩕶 䫰 𩕼	
𩕖	𡈣 𩉃	
𩕗	𲋂	
𩕰	𬱲	
𩕲	䫯 𩔽 𣄫	
𩕳	𩕋	
𩖀	𩕦	
𩖁	𬺂	
𩖆	𩖄	
𩖊	㾉	
𩖕	𩓣	
𩖖	顃	
𩖗	䫴	
𩖛	𩖜	
𩖣	𩖮 𩖰	
𩖬	颫	
𩖰	𫠇	
𩖴	䬟	
𩖶	䫼	
𩖷	𠘼	
𩖹	𩖾	
𩖼	颰	
𩖿	𬱺	
𩗀	𩙦	
𩗅	𩘡	
𩗓	𫗈	
𩗛	𱃛	
𩗞	𩗉	
𩗟	𩘶	
𩗡	𩙧	
𩗢	𩖻	
𩗩	𮷻	
𩗫	𩘙	
𩗬	𩗖 𩘁	
𩗴	𫗉	
𩗺	𮸻	
𩘀	𩙩	
𩘅	𩘗	
𩘋	𩗇	
𩘎	䫹	
𩘑	𩘕	
𩘑	𳋎	
𩘚	𬰲	
𩘝	𩙭	
𩘹	𩙨 𩘰	
𩘺	𩙬	
𩘻	𬲆 𩙅	
𩘽	𩙆	
𩙈	𩙰	
𩙘	𲋐	
𩙚	𩘖	
𩙛	𩙓 𩖢 𩘇 𲋍	
𩙜	𩗳	
𩙥	颰	
𩙦	𩗀	
𩙧	䬞 𩗡	
𩙨	𩘹	
𩙩	𩘀	
𩙪	颷	
𩙫	颾	
𩙬	𩘺	
𩙭	𩘝	
𩙮	䬘	
𩙯	䬝	
𩙰	𩙈	
𩚅	𬲥	
𩚖	𩜷	
𩚚	𬲩	
𩚛	𩟿	
𩚟	𳋩	
𩚤	𩜐 𩛹	
𩚥	𩠀	
𩚩	𫗡	
𩚬	𩛪 飢 𩚚 𩜄	
𩚯	𩛐	
𩚱	𩛯	
𩚵	𩠁 𩚣	
𩛂	𲋖	
𩛆	𩠂	
𩛌	䭄 𫗤	
𩛎	𬲴	
𩛞	𬲺	
𩛡	𫗨	
𩛢	𩝧 𩜔	
𩛨	𣨆	
𩛩	𩠃	
𩛱	𳋪	
𩛲	𬲹 𲋟 𲶸	
𩜇	𩠉	
𩜋	𲋧	
𩜍	𢘐	
𩜠	𬲿	
𩜦	𩠆	
𩜭	𪍎	
𩜯	𱄂	
𩜰	𬳃	
𩜳	𩛤	
𩜵	𩠊	
𩜶	𱄁	
𩝑	𬳇	
𩝔	𩠋	
𩝠	𬳌	
𩝡	𬳈 䭤 𳋲	
𩝣	𬳉	
𩝥	𲋩	
𩝧	𱄅	
𩝯	𳋯	
𩝱	𲋫	
𩝽	𫗳	
𩞃	𬲰 𩞧	
𩞄	𩠎	
𩞆	𩞐 𬲪	
𩞉	𬳐	
𩞘	𬳏	
𩞡	𬲬	
𩞦	𩠏 饓	
𩞧	𱄇	
𩞬	𬳒	
𩞯	䭪	
𩞰	𳋭 𩟐 𩞱 𩠅	
𩟀	𬳓	
𩟂	𬲸	
𩟊	𲋥	
𩟐	𩠅	
𩟗	𫗚	
𩟠	𬳔	
𩟤	𩟣	
𩟨	𩞺	
𩟭	𪎁	
𩟿	𩚛	
𩠀	𩚥	
𩠁	𩚵	
𩠂	𩛆	
𩠃	𩛩	
𩠅	𩟐	
𩠆	𩜦	
𩠇	䭀	
𩠈	䭃	
𩠉	𩜇	
𩠊	𩜵	
𩠋	𩝔	
𩠌	餸	
𩠎	𩞄	
𩠏	𩞦	
𩠑	頂	
𩠠	𩠴	
𩠴	𩠠	
𩡐	𩡌	
𩡓	𦒥	
𩡖	𩡣	
𩡚	𩡤	
𩡣	𩡖	
𩡤	𩡚	
𩡧	䭴	
𩡭	𲌄	
𩡰	𩡵	
𩡺	𩧦	
𩡾	𩣟 𩣠	
𩢀	𮹄	
𩢍	𬳷	
𩢑	𩢭	
𩢖	𮹅	
𩢛	騔	
𩢞	駠	
𩢡	𩧬 𩣀	
𩢮	䮌	
𩢰	𱅎	
𩢲	駛 𬳺	
𩢳	𩣗 𩧚	
𩢴	𩧵	
𩢷	䮮 𩥔 㹮	
𩢸	𩧳	
𩢹	𩣅	
𩢼	𬳻	
𩢾	𩧮	
𩢿	𩣜	
𩣇	𩣈 𩢯 𩥒 𩣐	
𩣊	𱅍 䮅	
𩣋	𬳼	
𩣏	𩧶	
𩣑	䯃	
𩣔	𬳹	
𩣘	䯀	
𩣡	𱅓	
𩣫	𩧸	
𩣵	𩧻	
𩣸	䧞	
𩣹	𩤓	
𩣺	𩧼	
𩤅	𲌉	
𩤊	𩧩	
𩤘	𩣃	
𩤙	𩨆	
𩤲	𩨉	
𩤵	𬴄	
𩤸	𩨅	
𩥂	𩥞	
𩥃	𩦺 𱅥	
𩥄	𩨋	
𩥅	𩥓 𱅣	
𩥇	𩨍	
𩥈	𮹌	
𩥉	𩧱	
𩥎	𱅨	
𩥐	𩡸	
𩥑	𩨌	
𩥫	䮞	
𩥲	𬴇	
𩥼	𬴈	
𩦂	𩦔 𩦃	
𩦃	𱅘	
𩦄	𩦀 𩦅 𩧋 𩧠 𩥴	
𩦌	䮣	
𩦐	𲌊	
𩦓	𲉈	
𩦙	𩥲	
𩦚	𬴉	
𩦠	𫠌	
𩦢	虞	
𩦺	𬴌	
𩧂	䮥	
𩧆	𩨐	
𩧉	𱄾	
𩧍	𲋺	
𩧐	𬴎	
𩧘	𳌏	
𩧢	𱅒	
𩧦	𩡺	
𩧨	駎	
𩧩	𩤊	
𩧪	䮾	
𩧫	駚	
𩧬	𩢡	
𩧭	䭿	
𩧮	𩢾	
𩧯	驋	
𩧰	䮝	
𩧱	𩥉	
𩧲	駧	
𩧳	𩢸	
𩧴	駩	
𩧵	𩢴	
𩧶	𩣏	
𩧸	𩣫	
𩧺	駶	
𩧻	𩣵	
𩧼	𩣺	
𩧿	䮠	
𩨀	騔	
𩨁	䮞	
𩨃	騝	
𩨄	騪	
𩨅	𩤸	
𩨆	𩤙	
𩨇	䮫	
𩨈	騟	
𩨉	𩤲	
𩨊	騚	
𩨋	𩥄	
𩨌	𩥑	
𩨍	𩥇	
𩨎	龭	
𩨏	䮳	
𩨐	𩧆	
𩨘	肐 胳	
𩨠	𩨕	
𩨭	𩨷 𩩆	
𩨳	𩨸	
𩩈	䯤	
𩩦	𩩘 𣄤 𣄘	
𩩳	𩪪	
𩪋	𨅚	
𩪗	𩪜 𦠒 𦠑	
𩪵	𲌔	
𩫠	𩍯	
𩫿	𩬓 𩫹 𩬒	
𩬎	𲌛	
𩬔	𩰂	
𩬛	𩬰	
𩬜	𩫴	
𩬣	𩭙	
𩬤	𩰀	
𩬷	𩫺 𩬢	
𩬽	𩭼 𩭚	
𩬾	𩭯	
𩭙	𩬣	
𩭯	𩬾	
𩭹	鬖	
𩭺	𩯅	
𩭾	髳	
𩮀	䰌 𩮰	
𩮈	𩭓	
𩮜	𩮆	
𩮝	𩮁 𩮂	
𩮰	𩬼	
𩮳	𩯧 顠	
𩮴	𣯧	
𩮵	𩮾	
𩮶	𩮸 𩮃	
𩯁	𫙂	
𩯃	𱆄	
𩯆	𬴨	
𩯏	𩮽	
𩯒	𩯳	
𩯨	𩬘	
𩯭	鬓	
𩯰	䰏 𩰁 𩬄	
𩯳	𩯒	
𩰀	𩬤	
𩰗	𩰝	
𩰞	䦵 𩰐	
𩰟	𩰏 𩰜 𨳚	
𩰪	𩏴	
𩰫	𩰬 𩰮	
𩰰	𩰹	
𩰹	𩰰	
𩰾	𩱎 𩱣 沸	
𩱄	𩱊	
𩱈	𱆍	
𩱍	𩱒 𩰯	
𩱓	㢽 𲺂	
𩱕	鬵	
𩱘	𩱝 䙐	
𩱙	𩱢 𩱱 𩱯	
𩱜	𩱨	
𩱦	𢐺 𢐨 𤑵 𩱈	
𩱳	𩱥	
𩲄	𩱽	
𩲊	㚪	
𩲏	𩲜	
𩲒	𩳤	
𩲳	𩲣	
𩳐	𩴔	
𩳢	𥚫	
𩳤	𩲒	
𩳵	𩳖	
𩴆	𱆖	
𩴌	𩴵	
𩴑	𩴊 𩳑	
𩴓	𩴴	
𩴪	𩴆 魕 𱆖	
𩴱	𩴸	
𩴳	𩳙 𩴇 𩳘	
𩴵	𩴌	
𩵀	䰱 䚖 𧢥 𩵁 𩵂	
𩵚	𬶂	
𩵠	𲍊	
𩵦	𫠏	
𩵩	𩽺	
𩵱	𬶉	
𩵳	𮹓	
𩵶	𲍉	
𩵹	𩽻	
𩵺	𬶈	
𩶀	𬶅	
𩶁	𫚎 𳍏	
𩶅	𩵷 𩶪	
𩶘	䲞	
𩶤	𲍏 𲾚	
𩶧	𩶿	
𩶯	𱇫	
𩶰	𩽿	
𩶱	𩽽	
𩶶	䲛 鯍 𳎙 𩷮	
𩷍	𩵤 䱛	
𩷒	𬶒	
𩷓	鿵	
𩷕	䱶 鿶	
𩷗	𩷬	
𩷙	𳍘	
𩷫	𳎗	
𩷰	𩾄	
𩷶	𱇮	
𩸂	鱝	
𩸃	𩾅	
𩸄	𫚝	
𩸆	䱒 𬶖	
𩸋	𩸇	
𩸍	𳎛	
𩸞	𳎚	
𩸡	𫚟	
𩸣	𬶙	
𩸤	𬶚	
𩸦	𩾆	
𩸩	𬶝	
𩸬	𬶜	
𩸾	𳎝	
𩹂	𱈃	
𩹄	𩼟	
𩹉	鯡	
𩹊	𬶦	
𩹎	鿷	
𩹑	𩸈	
𩹝	𬶡	
𩹡	𬶘	
𩹺	𩽏	
𩹽	𬶩	
𩹾	𱇴	
𩺝	𬶪	
𩺞	𱈎	
𩺲	𩵐	
𩺵	𩷔	
𩺷	𱆬	
𩻃	𳎢	
𩻗	𫚨	
𩻛	䲋 𱈔	
𩻜	𩺾	
𩻟	𳎓	
𩻧	𬶯	
𩻬	𫚩	
𩻮	𫚘	
𩻰	𬶰	
𩻱	𬶱	
𩼋	䲜	
𩼔	𬶶	
𩼝	鱨	
𩼭	𩻊	
𩼳	𳍣	
𩼶	𫚬	
𩼸	𲍍 𱆫	
𩽅	𬶸	
𩽇	𩾎	
𩽈	𬶳	
𩽊	𲌻	
𩽐	𩼇 䱗	
𩽔	𬶹	
𩽛	𩼬	
𩽨	𩽌	
𩽴	𲍓	
𩽷	𬶻	
𩽹	魥	
𩽺	𩵩	
𩽻	𩵹	
𩽼	鯶	
𩽽	𩶱	
𩽾	鮟	
𩽿	𩶰	
𩾁	鯄	
𩾂	䲖	
𩾃	鮸	
𩾄	𩷰	
𩾅	𩸃	
𩾆	𩸦	
𩾇	鯱	
𩾈	䱙	
𩾊	䱬	
𩾋	䱰	
𩾌	鱇	
𩾎	𩽇	
𩾐	𬷻	
𩾒	𬷽	
𩾔	𨾅	
𩾕	𩾔	
𩾗	䳂 𨾆 𲉪	
𩾝	𱉋	
𩾥	鴙	
𩾬	𪀤	
𩾶	䲯	
𩾷	𨾓	
𩾿	𪄇 𨾝	
𩿀	𳐄	
𩿂	𣯑 㲝	
𩿃	𪀽 𩿖	
𩿅	𫠖	
𩿊	𱉒	
𩿝	𪀏	
𩿞	𩿌 𲍱 𳎮	
𩿢	𨾨	
𩿣	𩿲 𳐅	
𩿤	𫛠 𳎧	
𩿧	𱉜 𨾪	
𩿪	𪉄	
𩿱	𬸃	
𩿲	𩿣	
𩿺	𬸁	
𪀉	𬸂	
𪀋	𲰹	
𪀖	𫛧	
𪀗	𨾼 𱉭	
𪀘	𳐈	
𪀚	䲲 𱉣 𪁿	
𪀛	𬸉	
𪀠	𪀽	
𪀢	𲍶	
𪀤	𩾱	
𪀦	𪉅	
𪀻	𬸋	
𪀾	𪉋	
𪁈	𪉉	
𪁎	𲍸	
𪁏	𮭦	
𪁐	𬸎 𳏇	
𪁑	𬸑	
𪁒	𪁪 𨿙	
𪁔	𳎴	
𪁕	𪁾 𲍼	
𪁖	𪉌	
𪁛	𱉷 𨿒	
𪁜	𬸏	
𪁣	𲍹	
𪁱	𬸐	
𪁽	𪅄	
𪁿	𬸔	
𪂀	𪂥	
𪂂	𳐍	
𪂆	𪉎 𨿹 𩀃 𩀔 𪃯 鴖 𨾧 𪃖 𪃔	
𪂇	𲍽	
𪂈	𬸖	
𪂉	𪂵	
𪂍	𪃤	
𪂕	𳐌	
𪂛	𪃖	
𪂞	𪂏 𪁹	
𪂩	𬸗	
𪂪	𪂋	
𪂫	𬸓	
𪂹	𪁈	
𪃀	𪆹	
𪃃	𱊔	
𪃇	𪂍	
𪃈	𪄾 𪅸 𪃇	
𪃍	𪉐 䴁 𩀍	
𪃏	𪉏	
𪃐	𪃧 𪃦 𳏬 𳐎	
𪃒	𫛻	
𪃓	𪂾	
𪃟	鷇	
𪃦	𬸙 𫛹 𳏬	
𪃧	𫛹	
𪃮	𬸟	
𪃶	𪂷 䳧	
𪃼	𪄛	
𪃿	𪀉 𬸠 鴚	
𪄅	𬸌	
𪄆	𪉔	
𪄌	𪅷	
𪄕	𪉒	
𪄠	𱊞	
𪄩	鶽	
𪄮	𪆚	
𪄱	𪆡 𪄲	
𪄲	𱊥	
𪄳	𪍇 鿺	
𪄶	𩀦	
𪄹	𨿰 𩀯	
𪄿	𪇼 𪇠 𪅀 𩀙	
𪅂	𫜂	
𪅃	𬸤	
𪅅	𪀡	
𪅖	𬸥 𪆊 𪄻	
𪅜	𬷿	
𪅮	𪂁 𪄋	
𪅳	鶹	
𪅶	𳐒	
𪅾	𬸨	
𪅿	𩀶 𩁌	
𪆂	𩁋 𪆺	
𪆃	𬸫	
𪆏	𲎆	
𪆟	𲎅	
𪆫	𱊨	
𪆰	𬸭	
𪆱	𳐖	
𪆴	䳫 𩀁 𬸮	
𪆷	𫛾	
𪆹	𪁶	
𪆻	𩁏	
𪇄	𬸬	
𪇍	𲍡	
𪇑	𪈧	
𪇖	𬸡	
𪇗	𩁡	
𪇘	𪆇 𠷎 𬸍	
𪇭	𩁞	
𪇰	𱊲	
𪇲	𳏸	
𪇳	𪉕 𪈁	
𪇴	𩁝 𪈛	
𪇷	𪈟	
𪈏	𱊴	
𪈐	鵣	
𪈔	𱊉	
𪈗	𬸄	
𪈟	𪈙	
𪈠	𳐊	
𪈮	𪁂	
𪈼	𱊜	
𪈿	𪈮	
𪉂	䲰	
𪉃	鳼	
𪉄	𩿪	
𪉅	𪀦	
𪉆	鴲	
𪉈	鴜	
𪉉	𪁈	
𪉊	鷨	
𪉋	𪀾	
𪉌	𪁖	
𪉍	鵚	
𪉎	𪂆	
𪉏	𪃏	
𪉐	𪃍	
𪉑	鷔	
𪉒	𪄕	
𪉔	𪄆	
𪉕	𪇳	
𪉖	𱊺	
𪉘	𪉰	
𪉜	𬸵	
𪉣	𪉙 𱊻	
𪉨	𬸶	
𪉮	𬸷	
𪉱	𬸸	
𪉸	𫜊	
𪉿	𬸹	
𪊄	𨣝	
𪊆	𲎊	
𪊇	𪉧	
𪊉	𪉭 𪊃 䴜 𱊽	
𪊍	𪊤 𳐦	
𪊤	𳐦	
𪊨	𳐹	
𪊫	𪋯 𪋐	
𪋈	𱋂	
𪋉	𩃽	
𪋏	𪋑	
𪋚	𪋳	
𪋡	𪋫	
𪋯	𪋣	
𪋼	𱋅	
𪋽	𱋄	
𪋿	𪎍 𫧮	
𪌈	𪍜	
𪌐	𱋉	
𪌒	𮮅	
𪌗	𱋌	
𪌘	𪍍 𱋍	
𪌜	𪽂	
𪌣	𱋓	
𪌨	𰎴	
𪌬	𱋕	
𪌭	𫜓	
𪌮	𱋘	
𪌯	𬹈	
𪌰	𬹇	
𪌽	𬹋	
𪌾	𱋚	
𪌿	𬹌	
𪍀	𬹊	
𪍅	𲎒	
𪍇	𱋜	
𪍍	𱋠	
𪍑	𱋢	
𪍒	𱋟	
𪍓	𱋥 𪍘	
𪍘	𱋤	
𪍚	𱋣	
𪍛	𪍐 𪌯 𪍕 𪌔 𱋒	
𪍞	𱋦	
𪍠	𫜕 𱋞	
𪍢	𪍥 𪍠	
𪍣	𱋡	
𪍤	𬹍	
𪍦	𲎑	
𪍬	𱋨	
𪍰	𱋩	
𪍲	𳑇	
𪍴	𱋬	
𪍶	𬹎	
𪍷	𱋑	
𪍺	䴷	
𪍿	䵃 𱋈	
𪎂	𱋭	
𪎈	䴬	
𪎉	麲	
𪎊	麨	
𪎋	䴴	
𪎌	麳	
𪎍	𪋿	
𪎕	𠪺	
𪎵	𪎹	
𪎶	𪎴	
𪏆	䵍 𧰄 𪎶 䵊	
𪏓	𪏑	
𪏔	𪏚	
𪏻	𪏹 𪍒 䊀 𪐉 𪏳	
𪏼	𪏾	
𪐀	𪏷	
𪐍	𳑉	
𪐎	𪎭	
𪐲	𪐳	
𪑅	䵳	
𪑖	𪒰	
𪑚	𬹗	
𪑝	𪒃	
𪑧	𪑘 𪑞	
𪑩	𪑣 𤓅 𪑍 𪒮	
𪑭	𪒖	
𪑳	𬹕	
𪒂	𪑥	
𪒄	𪑎 𪒐	
𪒋	𪒀	
𪒏	𪑔	
𪒔	𪑴 𪑚	
𪒛	𪓁 𪒡 𪑫 𪒸	
𪒟	䵴	
𪒠	𮡜	
𪒢	𪐙	
𪒬	𬹖	
𪒹	黬 𪒯	
𪒾	𪓆	
𪒿	𬹘	
𪓃	𪒌	
𪓉	𪓊	
𪓌	𢃒	
𪓛	𱌀	
𪓬	𪓥 𱌅 𪓢 𪓯 𦦁	
𪓰	𫜟	
𪓹	𱌈	
𪓽	𬹤	
𪓿	𳑒 𪓻	
𪔂	鼎	
𪔪	𪔧 𪔤 䵿	
𪔭	𪔵	
𪔳	𪔢 䥢 𥀼 𪔕	
𪔵	𪔭	
𪔿	𪕂	
𪕊	𪕑 䖪	
𪕋	𪕚 䶉	
𪕍	𪕙	
𪕓	𪕗	
𪕣	𬹭	
𪕮	𪕾 𪕉 𪕱	
𪕶	𥂺 貖	
𪕷	𪖃 𪕸	
𪖐	𪖑 鼼 𪖘	
𪖕	𪖾	
𪖙	齁	
𪖣	䶑 䶍	
𪖥	𪖪	
𪖨	𱌕	
𪖪	𪖥	
𪖼	𪖧 𪖽	
𪗋	𱌙 𧞓	
𪗙	𪗛	
𪗜	𬹽	
𪗝	𬹻	
𪗨	𩶌	
𪗪	齝 𬹿	
𪗬	𪗵 𪗭	
𪗭	𬺀	
𪗳	𬹾	
𪗻	𪙜 𬺁 𪗫	
𪗽	𪘢 𬺄	
𪘀	𪚏	
𪘁	𠻙 𲎨	
𪘅	𰳆	
𪘓	𬺇	
𪘜	𠵠 㗍 𪘨	
𪘞	𬺆	
𪘥	𱌸	
𪘧	𬺋	
𪘨	𱌴	
𪘩	𬺊	
𪘬	𱌷	
𪘯	𪚐	
𪘲	𪘬 𪗹 𬺌	
𪘵	𲎣 𲎩	
𪘹	𪙰	
𪘼	𪙷 𪙰	
𪘾	𪙒	
𪙉	𱌼	
𪙊	䶫	
𪙌	𪙑 𪙇 𪙆	
𪙍	𬺏	
𪙎	𪙝	
𪙏	𫜯	
𪙑	𬺑	
𪙕	𬺐	
𪙝	𪘤	
𪙞	𬺅	
𪙤	𪘻 𬺒	
𪙦	𲎪	
𪙩	𪘶	
𪙳	齟	
𪙽	𪙪	
𪚁	𪚀 𪚄	
𪚅	𬺖	
𪚇	𲎫	
𪚏	𪘀	
𪚐	𪘯	
𪚔	𬺛	
𪚣	𬺝	
𪚭	𱍅 𪚵	
𪚮	䶲 𱍄 𪚫 𪚳 𤱋 𪓚 𤱣 𪓘	
𪚰	𱍆 𪚱	
𪚻	𪓛	
𪛊	䇵 𥭦	
𪛕	𱍉	
𪜎	𠿕	
𪜺	𰂠	
𪝖	𫢟	
𪝵	𰂁	
𪝼	𱏆	
𪞝	凙	
𪟎	㔋	
𪟖	𠛾	
𪟝	勣	
𪟲	𫧝	
𪠀	𧷎	
𪠃	𫨑	
𪠏	𥀬	
𪠟	㓄	
𪠡	𠬙	
𪠳	唓	
𪠵	㖮	
𪠸	嚛	
𪠽	噹	
𪡀	嘺	
𪡃	嘪	
𪡋	噞	
𪡏	嗹	
𪡛	㗿	
𪡞	嘳	
𪡺	𡃄	
𪢈	𢖕	
𪢋	𰉀	
𪢌	㘓	
𪢍	𭉗	
𪢎	𠱅	
𪢐	𡃤	
𪢒	𡂡	
𪢕	嚽	
𪢠	囒	
𪢥	𫩸	
𪢧	𱕱	
𪢮	圞	
𪢼	𱖋 𪜐 𲅒 𲳐	
𪣆	埬	
𪣑	𮰮	
𪣒	堚	
𪣷	𮰥	
𪣻	塿	
𪤄	𡓁	
𪤅	𰋆	
𪤇	𱖏	
𪤑	𱖺	
𪤕	𲙆	
𪤚	壣	
𪤧	𲘲	
𪥠	𧹈	
𪥫	孇	
𪥰	嬣	
𪥿	嬻	
𪦯	𮱕	
𪧀	孾	
𪧘	寠	
𪨇	尵 𮱣	
𪨊	㞞	
𪨗	屩	
𪨧	崙	
𪨩	𡸗	
𪨪	𲝌	
𪨶	輋	
𪨷	巗	
𪨹	𡹬	
𪩇	㟺	
𪩎	巊	
𪩘	巘	
𪩛	𡿖	
𪩠	𲞚	
𪩸	幩	
𪪑	㢗	
𪪝	雝 雍 邕	
𪪞	廧	
𪪴	𢍰	
𪫌	徿	
𪫡	𢤩	
𪫷	㦞	
𪫸	𢜭	
𪫺	憸	
𪬚	𢣐	
𪬯	𢤿	
𪭝	𢯷	
𪭢	摐	
𪭧	擟	
𪭯	𢶒	
𪭵	掚	
𪭾	撊	
𪮃	㨻	
𪮋	㩋	
𪮖	撧	
𪮰	𫼽	
𪮳	𢺳	
𪮴	𱡃	
𪮶	攋	
𪯂	𭡆	
𪯋	㪎	
𪰐	𮲞	
𪰶	曊	
𪱥	膹	
𪱩	𲺖	
𪱷	梖	
𪲎	櫅	
𪲔	欐	
𪲛	檵	
𪲮	櫠	
𪳍	欇	
𪳵	𱣄	
𪳷	𬂱	
𪳺	𱣻	
𪴙	欑	
𪴥	𬃏	
𪴯	歞	
𪵇	𰚂	
𪵑	毊	
𪵢	𰚬	
𪵣	霼	
𪵱	濿	
𪶄	溡	
𪶒	𤄷	
𪶮	𣽏	
𪷈	𭱀	
𪷍	㵾	
𪷓	𣶭	
𪷫	𱩊	
𪷽	灒	
𪸕	熂	
𪸩	煇	
𪹀	𤑹	
𪹟	𱫐	
𪹠	𤓌	
𪹪	𱫯	
𪹳	爥	
𪹹	𤒻	
𪺣	𤘀	
𪺪	𤜆	
𪺭	犞	
𪺷	獊	
𪺸	𤠮	
𪺻	㺜	
𪺽	猌	
𪻉	𱮘	
𪻐	瑽	
𪻨	瓄	
𪻲	瑻	
𪻺	璝	
𪼋	㻶	
𪼑	𮴚	
𪼴	𤬅	
𪽂	𪌜	
𪽝	𤳷	
𪽪	痮	
𪽭	𤷃	
𪽮	㿖	
𪽴	𤺔	
𪽷	瘱	
𪾔	盨	
𪾢	睍	
𪾦	矑	
𪾳	𮵆	
𪾸	矉	
𪿊	𥏝	
𪿞	𥖲	
𪿫	礮	
𪿵	𥗇	
𫀌	𥜰	
𫀓	𥜐	
𫀨	䅐	
𫀬	䅳	
𫀮	𥢷	
𫁂	䆉	
𫁟	竱	
𫁡	鴗	
𫁲	䉑	
𫁳	𥯤	
𫁷	䉶	
𫁺	𥴼	
𫂃	簢	
𫂆	簂	
𫂈	䉬	
𫂖	𥴨	
𫂿	𥻦	
𫃐	𬖟	
𫃑	𰪿	
𫃗	𩏷	
𫃚	𱺏	
𫃞	𰫿	
𫃥	𮉩	
𫃷	𮉭	
𫃻	𮶅	
𫄇	𬘹	
𫄎	𫄄	
𫄙	糺	
𫄚	䊺	
𫄛	紟	
𫄜	䋃	
𫄝	𥾯	
𫄞	䋔	
𫄟	絁	
𫄠	絙	
𫄡	絧	
𫄢	絥	
𫄣	繷	
𫄤	繨	
𫄥	纚	
𫄦	𦀖	
𫄧	綖	
𫄨	絺	
𫄩	䋦	
𫄪	𦅇	
𫄫	綟	
𫄬	緤	
𫄭	緮	
𫄮	䋼	
𫄯	𦃩	
𫄰	縍	
𫄱	繬	
𫄲	縸	
𫄳	縰	
𫄴	繂	
𫄵	𦅈	
𫄶	繈	
𫄷	繶	
𫄸	纁	
𫄹	纗	
𫅅	䍤	
𫅗	羵	
𫅥	𦒀	
𫅭	䎙	
𫅼	𦔖	
𫆏	聻	
𫆝	𦟼	
𫆫	𦡝	
𫇘	𦧺	
𫇠	𮎍	
𫇪	𦱌	
𫇭	蒍	
𫇴	蒭	
𫇽	蕽	
𫈉	蕳	
𫈎	葝	
𫈟	蔯	
𫈵	蕝	
𫈹	𰰿	
𫉁	薆	
𫉄	藷	
𫉍	𮏀	
𫊪	䗅	
𫊮	蠦	
𫊱	蠒	
𫊸	蟜	
𫊹	𧒯	
𫊻	蟳	
𫋇	蟂	
𫋌	蟘	
𫋐	𬠈	
𫋧	𧈴	
𫋲	䙔	
𫋷	襗	
𫋹	襓	
𫋻	襘	
𫌀	襀	
𫌇	襵	
𫌋	𧞫	
𫌙	𬡱	
𫌨	覼	
𫌩	𰴏	
𫌪	覛	
𫌫	𧡴	
𫌬	𧢄	
𫌭	覹	
𫌯	䚩	
𫍊	𲂌	
𫍏	𫍘	
𫍐	𧭹	
𫍘	𫍏	
𫍙	訑	
𫍚	訞	
𫍛	訜	
𫍜	詓	
𫍞	𧦝	
𫍟	詑 𧦧	
𫍠	䛄	
𫍡	詑	
𫍢	譊	
𫍣	詷	
𫍤	譑	
𫍥	誂	
𫍦	譨	
𫍧	誺	
𫍨	誫	
𫍩	諣	
𫍪	誋	
𫍫	䛳	
𫍬	誷	
𫍭	𧩕	
𫍮	誳	
𫍯	諴	
𫍰	諰	
𫍱	諯	
𫍲	謏	
𫍳	諥	
𫍴	謱	
𫍵	謸	
𫍶	𧩼	
𫍷	謉	
𫍸	謆	
𫍹	謯	
𫍺	𧫝	
𫍻	譆	
𫍼	𧬤	
𫍽	譞	
𫍾	𧭈	
𫍿	譾	
𫎆	豵	
𫎌	貗	
𫎦	贚	
𫎧	䝭	
𫎨	𧸘	
𫎩	賝	
𫎪	䞋	
𫎫	贉	
𫎬	贑	
𫎭	䞓	
𫎱	䟐	
𫎳	䟆	
𫎸	𧽯	
𫎺	䟃	
𫏃	䠆	
𫏆	蹳	
𫏋	蹻	
𫏌	𨂐	
𫏐	蹔	
𫏑	𨇽	
𫏕	𨆪	
𫏞	𨇰	
𫏨	𨇤	
𫐄	軏	
𫐅	軕	
𫐆	轣	
𫐇	軜	
𫐈	軷	
𫐉	軨	
𫐊	軬	
𫐋	𨎌	
𫐌	軿	
𫐍	𨌈	
𫐎	輢	
𫐏	輖	
𫐐	輗	
𫐑	輨	
𫐒	輷	
𫐓	輮	
𫐔	𨍰	
𫐕	轊	
𫐖	轇	
𫐗	轐	
𫐘	轗	
𫐙	轠	
𫐷	遱	
𫑘	鄟	
𫑡	鄳	
𫑷	醶	
𫒆	𰽙	
𫒊	𮷷	
𫒋	𮷺	
𫒌	𳇩	
𫒞	𬭋	
𫒟	𮸋	
𫒡	𫓷	
𫒢	𰾉	
𫒷	𰾣	
𫓔	𮷶	
𫓥	釟	
𫓦	釨	
𫓧	鈇	
𫓨	鈛	
𫓩	鏦	
𫓪	鈆	
𫓫	𨥟	
𫓬	鉔	
𫓭	鉠	
𫓮	𨪕	
𫓯	銈	
𫓰	銊	
𫓱	鐈	
𫓲	銁	
𫓳	𨰋	
𫓴	鉾	
𫓵	鋠	
𫓶	鋗	
𫓷	𫒡	
𫓸	錽	
𫓹	錤	
𫓺	鐪	
𫓻	錜	
𫓼	𨨛	
𫓽	錝	
𫓾	錥	
𫓿	𨨢	
𫔀	鍊	
𫔁	鐼	
𫔂	鍉	
𫔃	𨰲	
𫔄	鍒	
𫔅	鎍	
𫔆	䥯	
𫔇	鎞	
𫔈	鎙	
𫔉	𨰃	
𫔊	鏥	
𫔋	䥗	
𫔌	鏾	
𫔍	鐇	
𫔎	鐍	
𫔏	𨬖	
𫔐	𨭸	
𫔑	𨭖	
𫔒	𨮳	
𫔓	𨯟	
𫔔	鑴	
𫔕	𨰥	
𫔖	𨲳	
𫔘	𰿥	
𫔡	𰿯	
𫔩	𲉆	
𫔭	開	
𫔯	閗	
𫔰	閞	
𫔱	𨷻	
𫔲	𨴹	
𫔴	閵	
𫔵	䦯	
𫔶	闑	
𫔽	𨼳	
𫕚	𩀨	
𫕥	霣	
𫕨	𩅙	
𫖃	靧	
𫖅	䪊	
𫖇	鞾	
𫖑	𩎖	
𫖒	韠	
𫖓	𩏂	
𫖔	韛	
𫖕	韝	
𫖖	𩏠	
𫖞	𬱘	
𫖪	𩑔	
𫖫	䪴	
𫖬	䪾	
𫖭	𩒎	
𫖮	顗	
𫖯	頫	
𫖰	䫂	
𫖱	䫀	
𫖲	䫟	
𫖳	頵	
𫖴	𩔳	
𫖵	𩓥	
𫖶	顅	
𫖷	𩔑	
𫖸	願	
𫖹	顣	
𫖺	䫶	
𫗇	䫻	
𫗈	𩗓	
𫗉	𩗴	
𫗊	䬓	
𫗋	飋	
𫗑	𬲵	
𫗕	𬳄	
𫗚	𩟗	
𫗝	𲋪	
𫗞	飦	
𫗟	䬧	
𫗠	餦	
𫗡	𩚩	
𫗢	飵	
𫗣	飶	
𫗤	𩛌	
𫗥	餫	
𫗦	餔	
𫗧	餗	
𫗨	𩛡	
𫗩	饠	
𫗪	餧	
𫗫	餬	
𫗬	餪	
𫗭	餵	
𫗮	餭	
𫗯	餱	
𫗰	䭔	
𫗱	䭑	
𫗲	𬲛	
𫗳	𩝽	
𫗴	饘	
𫗵	饟	
𫗻	𬳙	
𫘋	𮹉	
𫘛	馯	
𫘜	馼	
𫘝	駃	
𫘞	駞	
𫘟	駊	
𫘠	駤	
𫘡	駫	
𫘣	駻	
𫘤	騃	
𫘥	騉	
𫘦	騊	
𫘧	騄	
𫘨	騠	
𫘩	騜	
𫘪	騵	
𫘫	騴	
𫘬	騱	
𫘭	騻	
𫘮	䮰	
𫘯	驓	
𫘰	驙	
𫘱	驨	
𫘽	鬠	
𫙂	𩯁	
𫙬	𳎟	
𫙱	𲍘	
𫙽	𱆤	
𫚈	鱮	
𫚉	魟	
𫚊	鰑	
𫚋	鱄	
𫚌	魦	
𫚍	魵	
𫚎	𩶁	
𫚏	䱁	
𫚐	䱀	
𫚑	鮅	
𫚒	鮄	
𫚓	鮤	
𫚔	鮰	
𫚕	鰤	
𫚖	鮆	
𫚗	鮯	
𫚘	𩻮	
𫚙	鯆	
𫚚	鮿	
𫚛	鮵	
𫚜	䲅	
𫚝	𩸄	
𫚞	鯬	
𫚟	𩸡	
𫚠	䱧	
𫚡	鯞	
𫚢	鰋	
𫚣	鯾	
𫚤	鰦	
𫚥	鰕	
𫚦	鰫	
𫚧	鰽	
𫚨	𩻗	
𫚩	𩻬	
𫚪	鱊	
𫚫	鱢	
𫚬	𩼶	
𫚭	鱲	
𫛚	鳽	
𫛛	鳷	
𫛜	鴀	
𫛝	鴅	
𫛞	鴃	
𫛟	鸗	
𫛠	𩿤	
𫛡	鴔	
𫛢	鸋	
𫛣	鴥	
𫛤	鴐	
𫛥	鵊	
𫛦	鴮	
𫛧	𪀖	
𫛨	鵧	
𫛩	鴳	
𫛪	鴽	
𫛫	鶰	
𫛬	䳜	
𫛭	鵟	
𫛮	䳤	
𫛯	鶭	
𫛰	䳢	
𫛱	鵫	
𫛲	鵰	
𫛳	鵩	
𫛴	鷤	
𫛵	鶌	
𫛶	鶒	
𫛷	鶦	
𫛸	鶗	
𫛹	𪃧 𬸙	
𫛺	䳧	
𫛻	𪃒	
𫛼	䳫	
𫛽	鷅	
𫛾	𪆷	
𫜀	鷐	
𫜁	鷩	
𫜂	𪅂	
𫜃	鷣	
𫜄	鷷	
𫜅	䴋	
𫜊	𪉸	
𫜑	麷	
𫜒	䴱	
𫜓	𪌭	
𫜔	䴽	
𫜕	𪍠	
𫜙	䵴	
𫜟	𪓰	
𫜦	𫜫	
𫜨	䶕	
𫜩	齧	
𫜪	齩	
𫜫	𫜦	
𫜬	齰	
𫜭	齭	
𫜮	齴	
𫜯	𪙏	
𫜰	齾	
𫜲	龓	
𫜳	䶲	
𫜷	𨞪	
𫝈	㑮	
𫝋	𠐊	
𫝜	𠱞	
𫝡	𡓗	
𫝦	㛝	
𫝧	㜐	
𫝨	媈	
𫝩	嬦	
𫝪	𡟫	
𫝫	婡	
𫝬	嬇	
𫝭	孆	
𫝮	孄	
𫝵	嶹	
𫝾	𱟹	
𫞅	𦠅	
𫞗	潣	
𫞚	澬	
𫞛	㶆	
𫞝	灍	
𫞠	爧	
𫞡	爃	
𫞢	𤛱	
𫞣	㹽	
𫞥	珼	
𫞦	璾	
𫞧	𤩂	
𫞨	璼	
𫞩	璊	
𫞭	𱱕	
𫞷	𥢶	
𫟃	絍	
𫟄	綋	
𫟅	綡	
𫟆	緟	
𫟇	𦆲	
𫟑	䖅	
𫟕	䕤	
𫟞	訨	
𫟟	詊	
𫟠	譂	
𫟡	誴	
𫟢	䜖	
𫟤	䡐	
𫟥	䡩	
𫟦	䡵	
𫟫	𨞺	
𫟬	𨟊	
𫟲	釚	
𫟳	釲	
𫟴	鈖	
𫟵	鈗	
𫟶	銏	
𫟷	鉝	
𫟸	鉽	
𫟹	鉷	
𫟺	䤤	
𫟻	銂	
𫟼	鐽	
𫟽	𨧰	
𫟾	𨩰	
𫟿	鎈	
𫠀	䥄	
𫠁	鑉	
𫠂	閝	
𫠅	韚	
𫠆	頍	
𫠇	𩖰	
𫠈	䫾	
𫠊	䮄	
𫠋	騼	
𫠌	𩦠	
𫠏	𩵦	
𫠐	魽	
𫠑	䱸	
𫠒	鱆	
𫠖	𩿅	
𫠙	𲎧	
𫠜	齯	
𫡬	𠷏	
𫡶	𩅾	
𫢊	錢	
𫢒	儱	
𫢔	𠐽	
𫢘	𠏮	
𫢙	働	
𫢜	𰂴	
𫢟	𪝖	
𫢨	𠎒	
𫢪	僆	
𫢬	僗	
𫢭	儰	
𫢲	𫣴	
𫢸	僤	
𫢹	𠑙	
𫢺	傪	
𫣉	儖	
𫣊	僾	
𫣛	𠑲	
𫣫	𠐍	
𫣴	𫢲	
𫣻	𱏔	
𫤣	𲑰	
𫤸	㝟	
𫤽	𠖫	
𫥍	𠘥	
𫥔	𫥝	
𫥝	𫥔	
𫥳	𠠝	
𫥵	𠠏	
𫥺	𠟪	
𫥼	𠜲	
𫥽	𫦙	
𫦁	𠝿	
𫦅	㔅	
𫦉	𠞭	
𫦋	𫦔	
𫦌	㔃	
𫦔	𫦋	
𫦙	𫥽	
𫦩	㔝	
𫦰	𫦸	
𫦳	㔢	
𫦸	𫦰	
𫧝	𪟲	
𫧮	𪋿	
𫧯	卨	
𫧷	𥽽	
𫧿	贕	
𫨆	𠩘	
𫨑	𪠃	
𫨥	𲨚	
𫩎	𲔆	
𫩕	嚝	
𫩖	𠵘	
𫩚	𠵹	
𫩛	㗰	
𫩤	㗼	
𫩥	嚿	
𫩩	㗙	
𫩫	嚈	
𫩯	𠹛	
𫩳	𠼮	
𫩸	𪢥	
𫩺	嚍	
𫪀	㗻	
𫪁	唻	
𫪂	㘙	
𫪃	囇	
𫪄	𠼤	
𫪅	𠺮	
𫪑	𰈝	
𫪘	𡂿	
𫪚	𠼗	
𫪛	𭇉	
𫪧	嘄	
𫪪	𡂒	
𫪺	㗣	
𫪽	𠾬	
𫫇	噁	
𫫏	𫬆	
𫫦	嚪	
𫫧	𱒻	
𫫲	𫬛	
𫫵	𡀿	
𫫾	嚬	
𫬆	𫫏	
𫬐	㘔	
𫬙	𧸫	
𫬛	𫫲	
𫬟	𡅥	
𫬧	𲖢	
𫬱	𰇥	
𫭞	塼	
𫭟	塸	
𫭢	埨	
𫭨	墢	
𫭪	墝	
𫭮	𡍫	
𫭯	𡑎	
𫭱	𲥽	
𫭲	壧	
𫭼	𡑍	
𫮃	墠	
𫮅	墋	
𫮑	𲙱	
𫮜	㙬	
𫮼	𱘒	
𫯒	𨑊	
𫯓	𬻮	
𫯥	奯	
𫯴	𮯾	
𫯶	奫	
𫰂	奲	
𫰃	𲛃	
𫰍	媁	
𫰛	娙	
𫰠	㜭	
𫰡	嬅	
𫰢	嬒	
𫰣	𡤠	
𫰨	㜥	
𫰰	嬐	
𫰹	嫢	
𫱕	㜮	
𫱡	㛇	
𫱿	𡤫	
𫲉	𮰻	
𫲗	㜺	
𫲴	𭓀	
𫲸	寷	
𫳃	㝞	
𫴼	𡮤	
𫵵	崵	
𫵶	𡺨	
𫵷	㠣	
𫵸	𡷨	
𫵹	𡽵	
𫶄	𫶦	
𫶅	㠁	
𫶇	嵽	
𫶊	𡽳	
𫶕	巆	
𫶦	𫶄	
𫶲	𣫒	
𫷅	㡓	
𫷈	𢄼	
𫷉	幰	
𫷌	𢅡	
𫷘	𠁔	
𫷬	庲	
𫷮	廕	
𫷷	廞	
𫷹	廔	
𫷾	廮	
𫸩	彄	
𫹮	懙	
𫹴	愇	
𫹷	𢥠	
𫹼	𢛔	
𫹽	慯	
𫺁	㤲	
𫺂	悏	
𫺆	㦊	
𫺊	懠	
𫺌	愩	
𫺒	𢢀	
𫺓	㦖	
𫺘	憦	
𫺤	𮲅	
𫺪	懩	
𫺫	𢤜	
𫺷	戁	
𫺹	𫻑	
𫻁	㦦	
𫻇	𢤌	
𫻑	𫺹	
𫼗	𢲫	
𫼝	搊	
𫼣	𢳂	
𫼤	𢯩	
𫼥	㨟	
𫼧	撶	
𫼫	𢲾	
𫼮	擃	
𫼱	摃	
𫼲	𢯦	
𫼵	𢲸	
𫼶	𢱡	
𫼽	𪮰	
𫼾	𢲩	
𫽀	㨥	
𫽁	摙	
𫽇	㩇	
𫽊	㩭	
𫽋	攞	
𫽐	𢳚	
𫽔	𢷃	
𫽙	𢴦	
𫽢	𰔺	
𫽣	摪	
𫽥	攑	
𫽧	㩌	
𫽨	𫼭	
𫽫	𰔫	
𫽮	攩 擋	
𫽲	𢶑	
𫽳	𢴩	
𫾁	𢸴	
𫾃	𢸳	
𫾉	㩣	
𫾏	𫾡	
𫾡	𫾏	
𫾫	𱠉	
𫾱	𲣴	
𫾲	𣀷	
𫾳	𣀘	
𫿂	𢿓	
𫿗	𣀻	
𬀥	𣄸	
𬀩	暐	
𬀪	晛	
𬀮	㬣	
𬀱	暟	
𬀷	𱐩	
𬁑	𣌂	
𬁘	𰖻	
𬁳	𦟐	
𬁵	膒	
𬁸	𦞛	
𬁺	𦜖	
𬁽	䐣	
𬂀	膶	
𬂂	𦣇	
𬂄	𱟡	
𬂅	䐷	
𬂉	賸	
𬂒	𦙾	
𬂕	𲨞	
𬂠	橅	
𬂩	梜	
𬂮	榝	
𬂰	檂	
𬂱	𪳷	
𬂻	𣛣	
𬃀	槻	
𬃊	櫍	
𬃏	𪴥	
𬃘	樲	
𬃛	𬄝	
𬃦	𣚙	
𬃫	櫶	
𬃮	𣙿	
𬃲	䫐	
𬃳	𣡶	
𬄝	𬃛	
𬄞	𣠕	
𬄩	櫽	
𬄬	𣡌	
𬅁	𮲺	
𬅊	𱣖	
𬅢	㰰	
𬅥	歄	
𬅫	歕	
𬆂	𬆉	
𬆉	𬆂	
𬆙	𣩕	
𬆛	𪵂	
𬆦	毄	
𬆮	鷇	
𬆵	𱍪	
𬆾	覒	
𬇃	𨪅	
𬇄	𣰨	
𬇇	㲲	
𬇕	澫	
𬇘	漙	
𬇙	浿	
𬇬	𤅙	
𬇰	㵍	
𬇹	漍	
𬇼	𣻏	
𬈁	潬	
𬈏	𬉤	
𬈕	㵒	
𬈧	濇	
𬈭	𱦅	
𬈱	𤀪	
𬈾	𤁪	
𬉂	瀵	
𬉇	㵤	
𬉋	瀢	
𬉠	灡	
𬉤	𬈏	
𬉧	鿰	
𬉮	𱩉	
𬉼	熰	
𬊂	煼	
𬊈	燖	
𬊉	燵	
𬊍	燽	
𬊎	熕	
𬊖	燘	
𬊗	𤍖	
𬊜	𤓓	
𬊤	燀	
𬊦	覢	
𬊵	爣	
𬊶	爁	
𬊺	燰	
𬊾	㸐	
𬊿	𮳬	
𬋃	𤒦	
𬋍	㸊	
𬋙	𱫄	
𬌝	犓	
𬌠	𬌦	
𬌦	𬌠	
𬌮	獟	
𬌴	𤣤	
𬌵	𬍁	
𬌷	㺑	
𬍁	𬌵	
𬍙	琖	
𬍛	瓅	
𬍡	璗	
𬍤	璕	
𬎆	㼆	
𬎌	𬍒	
𬎑	瓓	
𬎓	𱯜	
𬎟	𮴌 𮴹	
𬎧	㼻	
𬎬	𤮦	
𬏜	㾺	
𬏟	㾵	
𬏤	𤻲	
𬏦	癈	
𬏫	瘒	
𬏮	瘑	
𬏲	𰣢	
𬏷	㿎	
𬐁	𲱱	
𬐠	𥂸	
𬑆	睔	
𬑇	𥇔	
𬑍	𬑡	
𬑏	䀴	
𬑒	䁱	
𬑓	瞱	
𬑔	衆	
𬑕	睴	
𬑗	瞷	
𬑙	𥌚	
𬑡	瞅 矁 𬑍	
𬑧	矊	
𬒄	𬒒	
𬒆	礏	
𬒇	𥗺	
𬒈	礐	
𬒊	𥖩	
𬒍	磒	
𬒎	䃘	
𬒒	𬒄	
𬒓	𥗴	
𬒕	䃤	
𬒗	𥗽	
𬒪	𥒿	
𬓠	穖	
𬓡	𠂲	
𬓫	龝	
𬓱	𥢊	
𬓸	䵘	
𬓼	穨	
𬔯	𥱸	
𬔹	𥳊	
𬕂	篢	
𬕊	䉍	
𬕍	𲵼	
𬕛	䉐	
𬕜	𮵭	
𬕦	䉱	
𬕬	𥵝	
𬖂	簪	
𬖃	籫	
𬖋	𱹤	
𬖑	粯	
𬖖	𥻤	
𬖘	𥼶	
𬖞	𥻵	
𬖟	𫃐	
𬖠	㪹	
𬖮	糮	
𬖺	𥽭	
𬗂	𱹔	
𬗈	𮶀	
𬗏	𬘣	
𬗮	𱺩	
𬗺	𬙀	
𬘓	紃	
𬘔	𥾝	
𬘕	紌	
𬘖	絸	
𬘗	𰫛	
𬘘	紞	
𬘙	䋐	
𬘚	𥿉	
𬘛	紶	
𬘜	䋎	
𬘝	紾	
𬘞	𦄋	
𬘟	絤	
𬘠	絠	
𬘡	絪	
𬘢	絖	
𬘣	𬗏	
𬘤	絽	
𬘥	絟	
𬘦	𥿯	
𬘧	纃	
𬘨	綕	
𬘩	綎	
𬘪	䌞	
𬘫	綄	
𬘬	綪	
𬘭	綝	
𬘮	䌐	
𬘯	綧	
𬘰	緛	
𬘱	䌁	
𬘲	䋾	
𬘳	𦄼	
𬘴	䋺	
𬘵	緪	
𬘶	緧	
𬘷	縒	
𬘸	𦂋	
𬘹	𫄇	
𬘺	縚	
𬘻	縖	
𬘼	𦃒	
𬘽	𦃘	
𬘾	𦄍	
𬘿	𦄧	
𬙀	𬗺	
𬙁	䌪	
𬙂	縯	
𬙃	𦅋	
𬙄	𰫳	
𬙅	𦅷	
𬙆	繙	
𬙇	繎	
𬙈	繗	
𬙉	繵	
𬙊	纆	
𬙋	纕	
𬙎	罏	
𬙏	𬙔	
𬙔	𬙏	
𬙝	罼	
𬙪	𦌾	
𬙫	𦍆	
𬙭	䍷	
𬚄	䎘	
𬚅	𲹓	
𬛕	𣘾	
𬛹	䑗	
𬛼	轝	
𬜔	𦪭	
𬜥	葻	
𬜧	蕟	
𬜨	薉	
𬜬	蔄	
𬜯	䓣	
𬜸	蘹	
𬜺	𦶆	
𬜾	藖	
𬜿	蔮	
𬝁	䔡	
𬝃	𤎤	
𬝊	𦸷	
𬝋	蠞	
𬝖	𦵕	
𬝠	𦽒	
𬝯	薲	
𬝴	䕼	
𬝵	𲼈	
𬞋	𦾶	
𬞕	蘭	
𬞘	藬	
𬞟	蘋	
𬞣	𧂅	
𬞫	蘫	
𬞼	𮶳	
𬟁	虉	
𬟪	覤	
𬟺	𧐱	
𬟽	蝀	
𬠃	𧏻	
𬠅	蟷	
𬠈	𫋐	
𬠐	𧈿	
𬠠	蠈	
𬠰	蛍	
𬠱	𧖦	
𬠷	𧕦	
𬠻	𲾲	
𬡇	褭	
𬡍	𧜣	
𬡎	𧛸	
𬡒	裌	
𬡓	褺	
𬡔	𧜂	
𬡕	𧜁	
𬡠	𧟌	
𬡦	𧞶	
𬡱	𫌙	
𬡷	襸	
𬡻	䊲	
𬢇	𧠈	
𬢈	𧡍	
𬢉	𧠥	
𬢊	覗	
𬢋	覜	
𬢌	覟	
𬢍	𧠵	
𬢎	覩	
𬢏	𧡪	
𬢐	䚉	
𬢑	䚆	
𬢒	覭	
𬢓	𧢍	
𬢔	覴	
𬢕	𧣴	
𬢩	𳁽	
𬢪	譸	
𬢯	譻	
𬢳	謲	
𬣀	讆	
𬣍	𬣫	
𬣘	𬤗	
𬣙	訏	
𬣚	𧥣	
𬣛	䚳	
𬣜	䚽	
𬣝	𧥺	
𬣞	詝	
𬣟	䚵	
𬣠	詌	
𬣡	諓	
𬣢	𧦭	
𬣣	註	
𬣤	詃	
𬣥	詜	
𬣦	詏	
𬣧	䛍	
𬣨	𧧝	
𬣩	詴	
𬣪	𧬨	
𬣫	𬣍	
𬣬	䛛	
𬣭	譡	
𬣮	詺	
𬣯	䛘	
𬣰	詯	
𬣱	詶	
𬣲	諩	
𬣳	詪	
𬣴	𧮇	
𬣵	𧬻	
𬣶	𧨊	
𬣷	誎	
𬣸	䛞	
𬣹	䛤	
𬣺	𧧭	
𬣻	誔	
𬣼	誏	
𬣽	謰	
𬣾	諎	
𬣿	䜎	
𬤀	諕	
𬤁	䛬	
𬤂	𧨾	
𬤃	𰴽	
𬤄	謲	
𬤅	𧩦	
𬤆	謴	
𬤇	諲	
𬤈	𧫚	
𬤉	䜋	
𬤊	諟	
𬤋	𧩪	
𬤌	䛽	
𬤍	諻	
𬤎	諠	
𬤏	𧩧	
𬤐	謌	
𬤑	䛿	
𬤒	𧪞	
𬤓	𧪡	
𬤔	𧪪	
𬤕	𧪦	
𬤖	𧬪	
𬤗	𬣘	
𬤘	䜉	
𬤙	謼	
𬤚	𧮆	
𬤛	讇	
𬤜	𧬅	
𬤝	譓	
𬤞	𧬇	
𬤟	䜍	
𬤠	𧬌	
𬤡	䜒	
𬤢	譐	
𬤣	譈	
𬤤	譄	
𬤥	譔	
𬤦	讉	
𬤧	𧬮	
𬤨	譟	
𬤩	譺	
𬤪	䜚	
𬤫	譹	
𬤬	䜝	
𬤭	譿	
𬤮	讚	
𬤯	𧮈	
𬤰	讙	
𬤱	𧮓	
𬤷	𧰆	
𬥄	䝕	
𬥈	䫉	
𬥓	𲃁	
𬥲	𬦀	
𬥳	賶	
𬥴	𧵊	
𬥵	䝯	
𬥶	貱	
𬥷	𧶄	
𬥸	賗	
𬥹	𧶟	
𬥺	䞁	
𬥻	䞂	
𬥼	𧶲	
𬥽	䞀	
𬥾	𧸦	
𬥿	𧸪	
𬦀	𬥲	
𬦅	䞶	
𬦆	𧽢	
𬦣	𨇗	
𬦥	䟺	
𬦧	踚	
𬦩	𨃘	
𬦫	𨆅	
𬦯	𨁂	
𬦲	𳃈	
𬦴	𨆱	
𬦵	𨄰	
𬦹	𨃜	
𬦻	躀	
𬦾	𨈇	
𬧀	蹡	
𬧃	䠮	
𬧄	𳃓	
𬧑	𨇍	
𬧔	𬧙	
𬧙	𬧔	
𬧚	𨈀	
𬧛	𨈆	
𬧝	𳃩	
𬧢	䡁	
𬧤	軂	
𬧩	𨉹	
𬧻	𫏻	
𬨁	軞	
𬨂	軝	
𬨃	𨋁	
𬨄	軮	
𬨅	𨋚	
𬨆	䡗	
𬨇	輆	
𬨈	輓	
𬨉	䡘	
𬨋	𨌄	
𬨌	䡟	
𬨍	輵	
𬨎	輶	
𬨏	𨍐	
𬨐	𨍹	
𬨑	䡦	
𬨒	𨎩	
𬨓	轈	
𬨔	䡶	
𬩎	𨘌	
𬩽	鄩	
𬩾	郲	
𬪍	鄮	
𬪡	𱢬	
𬪧	醧	
𬪨	醆	
𬪩	醲	
𬪫	𨣉	
𬪯	𨤋	
𬪺	𨤡	
𬫉	𮸂	
𬫍	𮸄	
𬫿	𲈖	
𬬇	𨰵	
𬬧	釬	
𬬨	釫	
𬬩	釴	
𬬪	釦	
𬬫	鈚	
𬬬	鍏	
𬬭	錀	
𬬮	鋹	
𬬯	鈓	
𬬰	鎗	
𬬱	釿	
𬬲	釽	
𬬳	𨥦	
𬬴	𨥜	
𬬵	鈂	
𬬶	𨬞	
𬬷	鉐	
𬬸	鉥	
𬬹	鉮	
𬬺	鉏	
𬬻	鑪	
𬬼	𨭥	
𬬽	鈼	
𬬾	鑏	
𬬿	鉊	
𬭀	鈶	
𬭁	鉧	
𬭂	𨥺	
𬭃	銔	
𬭄	𲇊 𲇊	
𬭅	銗	
𬭆	䤪	
𬭇	𨭗	
𬭈	䤩	
𬭉	鑇	
𬭊	𨧀	
𬭋	𫒞	
𬭌	鋘	
𬭍	銲	
𬭎	鋐	
𬭏	鐊	
𬭐	𨧚	
𬭑	𨧫	
𬭓	錪	
𬭔	鑡	
𬭕	錭	
𬭖	錋	
𬭗	錗	
𬭘	𨨝	
𬭙	𨭐	
𬭚	錞	
𬭛	𨨏	
𬭜	錑	
𬭝	鏒	
𬭞	𨨹	
𬭟	𨨯	
𬭠	𨩨	
𬭡	鍣	
𬭢	鐀	
𬭣	䤼	
𬭤	鍭	
𬭥	鍯	
𬭦	鎒	
𬭨	鎚	
𬭩	鎓	
𬭪	鎋	
𬭫	𨫀	
𬭬	鏏	
𬭭	鏚	
𬭯	䥕	
𬭰	鏔	
𬭱	𨬂	
𬭲	鏁	
𬭳	𨭎	
𬭴	䥛	
𬭵	𨭌	
𬭶	𨭆	
𬭷	𨭃	
𬭸	鏻	
𬭹	𨮅	
𬭺	𨭚	
𬭻	䥞	
𬭼	鐩	
𬭽	鐴	
𬭾	𨮰	
𬭿	鑙	
𬮀	𨯵	
𬮁	鑮	
𬮂	𨰷	
𬮃	𨰭	
𬮄	𨲭	
𬮅	𱐪	
𬮇	𬮝	
𬮍	𮤷	
𬮘	閄	
𬮙	𨷈	
𬮜	𨳨	
𬮝	𬮇	
𬮟	焛	
𬮠	閜	
𬮡	𨳿	
𬮢	閧	
𬮣	𨴑	
𬮤	閤	
𬮥	閦	
𬮧	𨴤	
𬮨	䦝	
𬮩	𨵆	
𬮪	閯	
𬮬	𮤒	
𬮭	闚	
𬮮	𨵤	
𬮯	𨵗	
𬮰	𨵌	
𬮱	闉	
𬮲	闄	
𬮳	闆	
𬮴	闇	
𬮵	𨵬	
𬮸	𨶻	
𬮹	𨶿	
𬮺	䧞	
𬮻	隖	
𬮿	隑	
𬯀	隮	
𬯅	陿	
𬯊	𬯘	
𬯎	隤	
𬯘	𬯊	
𬰡	𩉙	
𬰣	𩉍	
𬰤	𩋰	
𬰥	䩫	
𬰱	𩎒	
𬰲	𩘚	
𬰳	䪓	
𬰴	𩎠	
𬰵	𩏌	
𬰶	韢	
𬰷	䪜	
𬰸	𩏴	
𬰺	𩑃	
𬱂	𬱚	
𬱇	𲊽	
𬱈	𬱩	
𬱓	頄	
𬱔	𩑣	
𬱕	𩑦	
𬱖	頔	
𬱗	頕	
𬱘	𫖞	
𬱙	頖	
𬱚	𬱂	
𬱛	𩔊	
𬱜	頛	
𬱝	𩒝	
𬱞	𠽸	
𬱟	頠	
𬱠	頢	
𬱡	𩒜	
𬱢	顐	
𬱣	䫈	
𬱤	𩒲	
𬱥	𩒼	
𬱦	䫏	
𬱧	𩓸	
𬱨	𩓹	
𬱩	𬱈	
𬱪	顊	
𬱫	顁	
𬱬	䫩	
𬱭	𩔈	
𬱮	䫜	
𬱯	䭭	
𬱰	䫠	
𬱱	𩕊	
𬱲	𩕰	
𬱳	龥	
𬱵	颹	
𬱷	䫼	
𬱸	䬂	
𬱺	𩖿	
𬱼	颽	
𬱽	颴	
𬱾	𮨭	
𬱿	䬎	
𬲀	䬍	
𬲅	飉	
𬲆	𩘻	
𬲔	𳋫	
𬲕	䭕	
𬲚	𬳎	
𬲛	𫗲	
𬲥	𩚅	
𬲦	飤	
𬲧	𱃢	
𬲨	𱃡	
𬲩	𩚚	
𬲪	𩞆	
𬲫	䬯	
𬲬	𩞡	
𬲭	飷	
𬲮	䬫	
𬲯	䬲	
𬲰	𩞃	
𬲱	𮨻	
𬲲	䭢	
𬲳	䭞	
𬲴	𩛎	
𬲵	𫗑	
𬲶	䭣	
𬲷	䬶	
𬲸	𩟂	
𬲹	𩛲	
𬲺	𩛞	
𬲻	䬾	
𬲼	餣	
𬲽	𱃪	
𬲾	䭅	
𬲿	𩜠	
𬳀	䭇	
𬳁	餚	
𬳂	餟	
𬳃	𩜰	
𬳄	𫗕	
𬳅	䭉	
𬳆	餰	
𬳇	𩝑	
𬳈	𩝡	
𬳉	𩝣	
𬳊	饀	
𬳋	䭒	
𬳌	𩝠	
𬳍	餹	
𬳎	𬲚	
𬳐	𩞉	
𬳑	䭘	
𬳒	𩞬	
𬳓	𩟀	
𬳔	𩟠	
𬳙	𫗻	
𬳟	馩	
𬳮	𲌈	
𬳳	颿	
𬳴	駍	
𬳵	駓	
𬳶	駉	
𬳷	𩢍	
𬳸	䮸	
𬳹	𩣔	
𬳺	𩢲	
𬳻	𩢼	
𬳼	𩣋	
𬳽	駪	
𬳾	䮈	
𬳿	駼	
𬴀	駺	
𬴁	䮗	
𬴂	騑	
𬴃	騞	
𬴄	𩤵	
𬴅	騯	
𬴆	騹	
𬴇	𩥲	
𬴈	𩥼	
𬴉	𩦚	
𬴊	驎	
𬴋	驖	
𬴌	𩦺	
𬴍	䮽	
𬴎	𩧐	
𬴏	䮿	
𬴐	驩	
𬴨	𩯆	
𬴩	鬞	
𬵂	𱇎	
𬵃	𬶃	
𬵜	𳎞	
𬵨	鿹	
𬵮	𬶑	
𬵷	𳎤	
𬶀	魝	
𬶁	魜	
𬶂	𩵚	
𬶃	𬵃	
𬶄	魡	
𬶅	𩶀	
𬶆	䰷	
𬶇	魪	
𬶈	𩵺	
𬶉	𩵱	
𬶊	䱍	
𬶋	鮈	
𬶌	鮘	
𬶍	鮀	
𬶎	䲙	
𬶏	鮠	
𬶐	鮡	
𬶑	𬵮	
𬶒	𩷒	
𬶓	䱓	
𬶔	鯌	
𬶕	鮷	
𬶖	𩸆	
𬶗	䲏	
𬶙	𩸣	
𬶚	𩸤	
𬶛	鱓	
𬶜	𩸬	
𬶝	𩸩	
𬶞	鰗	
𬶟	鯻	
𬶠	鰊	
𬶡	𩹝	
𬶢	鯹	
𬶣	䱹	
𬶤	䱱	
𬶥	𱇋	
𬶦	𩹊	
𬶧	鰇	
𬶨	鱀	
𬶩	𩹽	
𬶪	𩺝	
𬶫	鱑	
𬶬	鱋	
𬶭	鰶	
𬶮	鱚	
𬶯	𩻧	
𬶰	𩻰	
𬶱	𩻱	
𬶲	鱌	
𬶳	𩽈	
𬶴	䲕	
𬶵	鱞	
𬶶	𩼔	
𬶷	𣤿	
𬶸	𩽅	
𬶹	𩽔	
𬶺	鱹	
𬶻	𩽷	
𬶼	𱉉	
𬷈	𮹕	
𬷕	鵏	
𬷚	𲍺	
𬷟	𲍯	
𬷨	𲎁	
𬷻	𩾐	
𬷼	鶂	
𬷽	𩾒 𱟿	
𬷾	䲨	
𬷿	𪅜	
𬸀	鴍	
𬸁	𩿺	
𬸂	𪀉	
𬸃	𩿱	
𬸄	𪈗	
𬸅	鶵	
𬸆	䲼	
𬸈	鵄	
𬸉	𪀛	
𬸊	鵀	
𬸋	𪀻	
𬸌	𪄅	
𬸍	𪇘	
𬸎	𪁐	
𬸏	𪁜	
𬸐	𪁱	
𬸑	𪁑	
𬸒	鶀	
𬸓	𪂫	
𬸔	𪁿	
𬸕	鸎	
𬸖	𪂈	
𬸗	𪂩	
𬸘	鶠	
𬸙	𪃦	
𬸚	鸑	
𬸛	䳨	
𬸜	鶣	
𬸝	鶕	
𬸞	鷜	
𬸟	𪃮	
𬸠	𪃿	
𬸡	𪇖	
𬸢	鷎	
𬸣	鶱	
𬸤	𪅃	
𬸥	𪅖	
𬸦	鷟	
𬸧	鷰	
𬸨	𪅾	
𬸩	䴈	
𬸪	鷭	
𬸫	𪆃	
𬸬	𪇄	
𬸭	𪆰	
𬸮	𪆴	
𬸯	鷿	
𬸰	鸖	
𬸱	鸜	
𬸵	𪉜	
𬸶	𪉨	
𬸷	𪉮	
𬸸	𪉱	
𬸹	𪉿	
𬸾	麡	
𬹂	𬹆	
𬹅	䴭	
𬹆	𬹂	
𬹇	𪌰	
𬹈	𪌯	
𬹉	䴷	
𬹊	𪍀	
𬹋	𪌽	
𬹌	𪌿	
𬹍	𪍤	
𬹎	𪍶	
𬹕	𪑳	
𬹖	𪒬	
𬹗	𪑚	
𬹘	𪒿	
𬹣	鼄	
𬹤	𪓽	
𬹭	𪕣	
𬹶	𳑯	
𬹺	齖	
𬹻	𪗝	
𬹼	齘	
𬹽	𪗜	
𬹾	𪗳	
𬹿	𪗪	
𬺀	𪗭	
𬺁	𪗻	
𬺂	𩖁	
𬺃	䶣	
𬺄	𪗽	
𬺅	𪙞	
𬺆	𪘞	
𬺇	𪘓	
𬺈	齮	
𬺉	䶦	
𬺊	𪘩	
𬺋	𪘧	
𬺌	𪘲	
𬺍	䶢	
𬺎	齹	
𬺏	𪙍	
𬺐	𪙕	
𬺑	𪙑	
𬺒	𪙤	
𬺓	齼	
𬺔	齽	
𬺕	䶪	
𬺖	𪚅	
𬺛	𪚔	
𬺜	㰍	
𬺝	𪚣	
𬺟	𧢢	
𬻮	𫯓	
𬾖	㒣	
𬾣	𠐮	
𭀖	釐 厘	
𭀷	𭀳	
𭂖	𰃶	
𭃀	𭃁	
𭄛	劗	
𭇀	𠿿	
𭇉	𫪛	
𭇙	𡁚	
𭇜	㗶	
𭇡	𡁯	
𭇯	嚠	
𭇴	𠵔	
𭈈	𠺖	
𭈉	𡄖	
𭈜	𡀠	
𭈟	𠽈	
𭈮	𡄤	
𭉗	𪢍	
𭉨	𠿘	
𭉼	𡅧	
𭉾	𰇊	
𭊳	𱒶	
𭊸	𡅘	
𭍌	𱔌	
𭎂	㙡	
𭎜	壔	
𭏦	壒	
𭏸	壝	
𭐁	𱗠	
𭑙	𮤮	
𭑸	𡢿	
𭑹	𡤡	
𭓀	𫲴	
𭕆	𧴪	
𭗡	𡻘	
𭘓	幠	
𭘚	𢅣	
𭚦	彍	
𭜼	𮲀	
𭝋	㦭	
𭝫	𡄩	
𭞄	懓	
𭠙	擈	
𭠽	𰔠	
𭡆	𪯂	
𭡜	𢸙	
𭡵	𢵣	
𭢋	𢸔	
𭢒	𰓤	
𭢕	𢷞	
𭢝	𢺎	
𭣀	𱡅	
𭣇	攧	
𭣧	斁	
𭣳	敓	
𭤎	斄	
𭤰	旟	
𭥓	𣊯	
𭧋	曭	
𭧒	𰖏	
𭧖	𰖚	
𭨚	昝	
𭨡	𰁈	
𭩚	檥	
𭩛	椚	
𭩰	橃	
𭪆	檛	
𭫀	樻	
𭫙	㰅	
𭫝	𠐇	
𭭈	㰳	
𭰎	澢	
𭰒	𣻑	
𭰗	𣼊	
𭰥	𤅩	
𭱀	𪷈	
𭱊	澒	
𭱘	𰛨	
𭲫	灟	
𭴊	㷻	
𭴳	𤏐	
𭶙	𤇻	
𭹜	㼈	
𭹰	𮴊	
𭻍	𤲢	
𭻔	𤲓	
𮀡	𥘃	
𮀤	磱	
𮀪	𥖏	
𮀲	𥔂	
𮅎	𥵛	
𮆏	籣	
𮇔	𥺼	
𮇤	𥾂	
𮉠	䊵	
𮉡	纑	
𮉢	紩	
𮉣	䋏	
𮉤	絓	
𮉥	𦀎	
𮉧	緉	
𮉨	緺	
𮉩	𫃥	
𮉪	緅	
𮉫	緌	
𮉬	綷	
𮉭	𫃷	
𮉮	繀	
𮉯	縩	
𮉽	𱺴	
𮌌	𦡧	
𮎍	𫇠	
𮏀	𫉍	
𮏺	𧁿	
𮐚	薠	
𮐨	蘡	
𮔂	䗻	
𮔅	蝜	
𮔊	蜽	
𮕃	𱿡	
𮖁	裲	
𮖃	𧜶	
𮖱	襭	
𮘷	𰴵	
𮙊	讔	
𮙋	讟	
𮚓	𲃃	
𮚫	𮷍	
𮛗	𨆉	
𮜃	𲃖	
𮜒	𰸙	
𮜗	𰸦	
𮜶	軇	
𮝄	𮝳	
𮝴	軱	
𮝵	輀	
𮝷	轒	
𮝸	輴	
𮝹	轘	
𮝺	轕	
𮟽	𰻨	
𮠞	䤌	
𮠳	醦	
𮡈	𨢸	
𮢅	𮸑	
𮢆	𮸒	
𮢎	𳇬	
𮢛	𲈑	
𮣲	釭	
𮣳	鈜	
𮣴	鋋	
𮣵	錣	
𮣶	鑢	
𮤎	𲈺	
𮤏	𮤳	
𮤒	𬮬	
𮤫	閅	
𮤬	䦌	
𮤭	𨳒	
𮤮	𭑙	
𮤯	𨳙	
𮤲	閟	
𮤳	𮤏	
𮤶	𰿢	
𮤷	𬮍	
𮤸	𨶯	
𮦅	𮦗	
𮦗	𮦅	
𮦚	𩇉	
𮧴	韔	
𮧵	韡	
𮨭	𬱾	
𮨴	檒	
𮨵	飂	
𮨻	𬲱	
𮩌	𲋙	
𮩛	饆	
𮩜	餀	
𮩝	餲	
𮩞	饐	
𮩲	𳌕	
𮪡	駹	
𮪢	駴	
𮪣	騣	
𮪤	騲	
𮪥	驐	
𮫂	鬡	
𮫐	𲌞	
𮬊	𳎠	
𮬛	魣	
𮬜	鮨	
𮬝	鱥	
𮬞	䱗	
𮬟	䱛	
𮬠	䱚	
𮬡	䱻	
𮬢	䱵	
𮬣	䲗	
𮬤	鱵	
𮬨	𲍫	
𮬭	𮭣	
𮭒	𲎂	
𮭡	䲸	
𮭢	鴁	
𮭤	鴓	
𮭥	䳍	
𮭦	𪁏	
𮭨	鷃	
𮭪	鷞	
𮭰	䴚	
𮮅	𪌒	
𮮇	麰	
𮯙	䶗	
𮯱	丹 舟	
𮯲	屯	
𮯴	倪 仉	
𮯾	𫯴	
𮰁	復 傷	
𮰋	兜	
𮰌	削	
𮰍	勅	
𮰎	虓	
𮰒	𡢦	
𮰓	缺	
𮰕	舒	
𮰟	𡊄	
𮰣	岱	
𮰤	坝	
𮰬	場	
𮰮	𪣑	
𮰰	卉	
𮰶	樊	
𮰷	巧	
𮰹	妙	
𮰼	委	
𮱀	翣	
𮱅	娄	
𮱆	𡢄	
𮱈	㜇	
𮱌	婪	
𮱍	卿	
𮱐	𡤶	
𮱑	艳	
𮱒	嬝	
𮱔	𡠪	
𮱕	𪦯	
𮱚	𱙋	
𮱞	宠	
𮱠	隽	
𮱡	少	
𮱣	尵 𪨇	
𮱥	岃	
𮱦	𮱱	
𮱧	岱	
𮱨	岸	
𮱩	㟦	
𮱪	𱎶	
𮱫	宾	
𮱭	岭	
𮱯	㠆	
𮱱	𮱦	
𮱲	𡽉	
𮱵	𢐟	
𮱸	弼	
𮱻	徑	
𮱼	佩	
𮱿	忺	
𮲄	憅	
𮲉	楣	
𮲋	懏	
𮲍	𢧤	
𮲎	盛	
𮲐	㙯 艺	
𮲒	擎	
𮲓	数	
𮲔	敳	
𮲕	亩	
𮲙	旌	
𮲛	㬢	
𮲞	𪰐	
𮲟	暊	
𮲡	異	
𮲦	瞍	
𮲨	𣋪	
𮲫	洗	
𮲯	耜	
𮲰	㮿	
𮲱	桑	
𮲲	櫦	
𮲴	𠔢	
𮳚	𤆏	
𮳢	𤆼	
𮳦	烟	
𮳨	𤈥	
𮴀	玩	
𮴃	地	
𮴅	𤦎	
𮴐	㺿	
𮴜	珢	
𮴠	𤫟	
𮴡	聖	
𮴥	𤩑	
𮴨	璁	
𮴯	瑒	
𮴸	璨	
𮴹	𬎟	
𮴽	乪	
𮵁	畢	
𮵆	𪾳	
𮵉	䂘	
𮵋	研	
𮵎	磊	
𮵐	䂪	
𮵑	碯 硇	
𮵕	并 𮵕 𮵕	
𮵙	𥚗	
𮵛	袖	
𮵠	稦	
𮵣	蓁	
𮵥	𲃘	
𮵨	斌	
𮵫	簝	
𮵬	算	
𮵯	苑	
𮵳	莹	
𮵷	潷	
𮵺	棨	
𮵾	紧	
𮶇	𢌷	
𮶋	翀	
𮶌	翘	
𮶍	翀	
𮶑	旺	
𮶒	莃	
𮶔	𦝛	
𮶕	肸	
𮶖	夏	
𮶙	艦	
𮶚	樴	
𮶜	兰 窄	
𮶝	艾	
𮶞	𦴧	
𮶟	兰	
𮶡	葉	
𮶩	𧀀	
𮶪	蒟	
𮶬	𧂂	
𮶭	蕤	
𮶳	𬞼	
𮶷	𦿭	
𮶺	睿	
𮶻	蜚	
𮶽	蛷	
𮶿	裔	
𮷞	廷	
𮷠	逕	
𮷡	逖	
𮷣	𨘏 远	
𮷥	𨘀	
𮷧	適	
𮷨	𨟑	
𮷩	卵	
𮷪	剑	
𮷯	玺	
𮷲	鏦	
𮷴	德 𰽆	
𮸤	镺	
𮸬	雲	
𮸮	䩤	
𮸲	龙	
𮸳	韶	
𮸶	𩔐	
𮸷	𩐳	
𮸹	顧	
𮸻	𩗺	
𮸼	飊	
𮸽	飝	
𮸾	𲋢	
𮹀	馪	
𮹑	嗣	
𮹓	𩵳	
𮹕	𬷈	
𮹗	䳥	
𮹘	鶯	
𮹙	䳽	
𮹜	䴏	
𮹝	龘	
兤	𰏵	
𰁈	𭨡	
𰁧	傱	
𰁸	儅	
𰁾	偩	
𰂁	𪝵	
𰂃	𠎅	
𰂇	𱎡	
𰂋	僴	
𰂎	僩	
𰂏	儥	
𰂗	僀	
𰂜	僓	
𰂠	𪜺	
𰂤	𬻢	
𰂦	儢	
𰂭	儩	
𰂴	𫢜	
𰂻	𠑇	
𰃆	儹	
𰃳	𰃴	
𰃴	𰃳	
𰃶	𭂖	
𰃷	凔	
𰃻	㓖	
𰃿	凟	
𰄁	𠗿	
𰄞	剸	
𰄭	𠠫	
𰄻	𱐜	
𰅔	勴	
𰅥	匵	
𰅦	匰	
𰅻	𦾏	
𰆕	㕒	
𰆙	𠩬	
𰆚	厱	
𰇀	㕢	
𰇊	𭉾	
𰇎	㖦	
𰇕	唊	
𰇖	㗢	
𰇘	𠷌	
𰇠	嗧	
𰇡	𠶹	
𰇣	嚱	
𰇥	𫬱	
𰇲	嗿	
𰇼	嘇	
𰈆	囕	
𰈇	嚐	
𰈊	嚸	
𰈍	嚫	
𰈓	嚂	
𰈝	𫪑	
𰈮	𡃈	
𰈯	囐	
𰈶	嚩	
𰉀	𪢋	
𰉁	㘖	
𰉄	囋	
𰉘	㙔	
𰉙	堈	
𰉚	垷	
𰉣	墿	
𰉥	埉	
𰉩	墧	
𰉪	墷	
𰉱	𡑯	
𰉽	㙾	
𰊂	墆	
𰊅	𡓦	
𰊈	墏	
𰊑	壏	
𰊛	㙺	
𰊟	㙢	
𰊡	壛	
𰊢	壍	
𰋆	𪤅	
𰋖	𡗆	
𰋸	婸	
𰋹	嫥	
𰋽	嬮	
𰋾	𡠚	
𰌀	嫈	
𰌂	媜	
𰌆	㜞	
𰌇	嫧	
𰌉	𡢘	
𰌋	𱙅	
𰌙	嬾	
𰌦	孲	
𰌷	寪	
𰎌	嵷	
𰎎	巃	
𰎏	崠	
𰎐	㠠	
𰎑	嶪	
𰎔	嶤	
𰎖	崱	
𰎛	𡼾	
𰎝	𡺠	
𰎞	嶩	
𰎠	巖	
𰎢	𡼱	
𰎦	𰎼	
𰎫	嶽	
𰎴	𪌨	
𰎷	𡾆	
𰎹	巚	
𰎼	𰎦	
𰏁	巑	
𰏓	𢄓	
𰏕	帴	
𰏜	㡞	
𰏟	幱	
𰏲	𢉿	
𰏶	廥	
𰏼	廗	
𰏽	𢊃	
𰐚	𢐗	
𰐾	懭	
𰑁	慱	
𰑄	惀	
𰑅	𢠰	
𰑔	慹	
𰑕	懕	
𰑙	懰	
𰑟	慐	
𰑥	憪	
𰑧	慙	
𰑪	憴	
𰑫	㦬	
𰑬	懫	
𰑵	慸	
𰑸	㥷	
𰑿	戃	
𰒆	慲	
𰒒	懘	
𰒖	𢤧	
𰓄	掁	
𰓆	摀	
𰓔	㨛	
𰓕	𢸸	
𰓗	𢹥	
𰓙	擪	
𰓜	擳	
𰓝	𢲐	
𰓟	𢹼	
𰓤	𭢒	
𰓧	搎	
𰓬	攦	
𰓱	摼	
𰓷	撋	
𰓻	摫	
𰓼	摲	
𰔇	摕	
𰔋	撌	
𰔠	𭠽	
𰔫	𫽫	
𰔲	㩷	
𰔶	𢹏	
𰔺	𫽢	
𰕁	攳	
𰕅	敺	
𰕈	敿	
𰕐	𢿡	
𰕭	旝	
𰖈	曮	
𰖏	𭧒	
𰖚	𭧖	
𰖠	㬮	
𰖩	㒿	
𰖻	𬁘	
𰗅	𦡏	
𰗆	𦡖	
𰗓	櫎	
𰗖	棆	
𰗘	𣔿	
𰗙	㮲	
𰗚	𣞐	
𰗛	檡	
𰗜	檿	
𰗡	㯆	
𰗢	楎	
𰗦	㯸	
𰗨	榯	
𰗬	櫏	
𰗵	㰂	
𰗹	橚	
𰗺	橨	
𰘀	㯂	
𰘅	𰘯	
𰘈	檋	
𰘓	檾	
𰘠	櫩	
𰘣	檰	
𰘩	櫹	
𰘯	𰘅	
𰘳	櫴	
𰘶	櫯	
𰘸	櫢	
𰙅	𪲹	
𰙋	歍	
𰙎	歛	
𰙑	歗	
𰙕	𣤋	
𰚂	𪵇	
𰚍	𰚣	
𰚔	㲰	
𰚣	𰚍	
𰚦	氀	
𰚪	㲯	
𰚬	𪵢	
𰚱	𣰛	
𰛉	𣶯	
𰛊	溤	
𰛏	漎	
𰛒	涷	
𰛛	㴸	
𰛡	滭	
𰛣	漐	
𰛤	瀄	
𰛥	溰	
𰛦	濊	
𰛨	𭱘	
𰛩	㶒	
𰛪	灓	
𰛮	滷	
𰛱	𰝢	
𰛲	澰	
𰛵	澖	
𰛺	𣼩	
𰛻	𤅷	
𰛽	㴿	
𰜐	灠	
𰜜	瀙	
𰜝	瀁	
𰜢	㵑	
𰜨	瀳	
𰜳	瀴	
𰝅	瀯	
𰝋	㶏	
𰝍	瀈	
𰝗	㶕	
𰝜	𣴇	
𰝞	𤄙	
𰝟	㶍	
𰝢	𰛱	
𰝤	灦	
𰝾	㷃	
𰞇	燡	
𰞉	㷲	
𰞍	㸅	
𰞤	熞	
𰞲	㷶	
𰞳	龽	
𰞷	𤍜	
𰞻	燌	
𰟄	𰟫	
𰟘	爓	
𰟫	𰟄	
𰠛	牋	
𰠫	犅	
𰠲	牼	
𰠴	㹓	
𰠹	犤	
𰡄	獹	
𰡉	𰡓	
𰡊	獢	
𰡋	𤟤	
𰡎	猍	
𰡏	猧	
𰡐	𤠔	
𰡓	𰡉	
𰡔	獑	
𰡘	𱮜 𱮜	
𰡞	獖	
𰡢	𤣎	
𰡩	玂	
𰡰	𤥭	
𰡵	瓐	
𰡻	瑙	
𰡽	璹	
𰢄	璛	
𰢢	甒	
𰢤	甖	
𰢦	甊	
𰣢	𬏲	
𰣦	𤺉	
𰣩	𤻝	
𰣫	𤼈	
𰣬	癠	
𰣯	癎	
𰣶	㿉	
𰣼	癪	
𰣽	癴	
𰤓	𤾉	
𰤕	皪	
𰤨	㿹	
𰤫	𥀲	
𰤬	皾	
𰤽	𥂫	
𰥊	䀍	
𰥒	瞛	
𰥛	瞓	
𰥞	䁝	
𰥠	矕	
𰥢	矖	
𰥣	𥉸	
𰥨	瞯	
𰥪	瞡	
𰥭	𥋝	
𰥹	矘	
𰦔	䂓	
𰦜	矲	
𰦦	礰	
𰦨	䃣	
𰦭	礲	
𰦰	礋	
𰦴	䃁	
𰦷	䃕	
𰦾	礹	
𰦿	碢	
𰧃	磵	
𰧇	礥	
𰧈	𥗹	
𰧉	礩	
𰧎	䃢	
𰧔	礛	
𰧘	䃴	
𰧝	𮀧	
𰧰	禓	
𰧻	禬	
𰧾	禯	
𰨖	禵	
𰨜	穬	
𰨦	穧	
𰨳	䆅	
𰩅	竉	
𰩏	窱	
𰩓	竀	
𰩧	䇓	
𰩮	篿	
𰩲	籚	
𰩸	簥	
𰩹	簜	
𰩺	箹	
𰩻	簻	
𰪊	籦	
𰪏	簵	
𰪣	籯	
𰪪	𰫆	
𰪫	䊜	
𰪭	粻	
𰪶	糰	
𰪼	𰫏	
𰪿	𫃑	
𰫆	𰪪	
𰫋	䊟	
𰫏	𰪼	
𰫕	𱹁	
𰫖	糷	
𰫗	𱺐	
𰫛	𬘗	
𰫦	𱺠	
𰫳	𬙄	
𰫼	糽	
𰫽	紑	
𰫿	𫃞	
𰬀	紒	
𰬁	䋆	
𰬂	䋍	
𰬃	䋑	
𰬅	紨	
𰬆	絇	
𰬇	紸	
𰬈	絃	
𰬉	紽	
𰬋	紭	
𰬌	絚	
𰬍	綊	
𰬎	縪	
𰬏	絑	
𰬐	繑	
𰬑	䋫	
𰬒	絘	
𰬓	絯	
𰬔	絣	
𰬖	絾	
𰬗	絿	
𰬘	綍	
𰬙	𦁄	
𰬚	縜	
𰬛	絼	
𰬜	絻	
𰬝	𦅘	
𰬞	綅	
𰬟	緎	
𰬠	繣	
𰬡	緁	
𰬢	緀	
𰬣	緆	
𰬤	綼	
𰬥	総	
𰬦	𦁕	
𰬧	緂	
𰬨	𦁧	
𰬩	繡	
𰬪	縿	
𰬫	緻	
𰬬	緢	
𰬭	䋽	
𰬮	縴	
𰬯	緵	
𰬰	緫	
𰬱	䌇	
𰬲	縓	
𰬳	縌	
𰬴	縡	
𰬵	縼	
𰬶	䌌	
𰬷	繖	
𰬸	繐	
𰬹	𦆈	
𰬺	繜	
𰬻	繘	
𰬼	𦇛	
𰬽	繲	
𰬾	𦆆	
𰬿	纀	
𰭀	纋	
𰭁	𦇎	
𰭄	罆	
𰭔	羂	
𰭗	𦏑	
𰭚	𦎹	
𰭢	翜	
𰭣	翿	
𰭹	䏊	
𰮅	膷	
𰮇	膴	
𰮙	䐢	
𰮝	膮	
𰮭	𣎜	
𰮲	䐹	
𰯂	𦡶	
𰯋	臡	
𰯎	䐽	
𰯲	𰀢	
𰰆	𦧴	
𰰋	艭	
𰰌	䑼	
𰰏	艜	
𰰑	艛	
𰰠	藇	
𰰢	𦳝	
𰰤	蓲	
𰰨	菕	
𰰮	蘬	
𰰱	薱	
𰰳	蒒	
𰰴	䔇	
𰰵	蔱	
𰰶	䕹	
𰰷	萯	
𰰹	藰	
𰰺	蔎	
𰰾	薖	
𰰿	𫈹	
𰱀	䔈	
𰱇	蕑	
𰱈	禜	
𰱉	蕄	
𰱊	𧃽	
𰱌	蒳	
𰱍	蒶	
𰱐	藚	
𰱑	蔪	
𰱛	蔠	
𰱝	𦺣	
𰱟	蕡	
𰱦	蕧	
𰱩	䕡	
𰱮	藘	
𰱯	藣	
𰱱	薋	
𰱲	蘵	
𰱾	藾	
𰲁	蘈	
𰲂	虅	
𰲒	蘱	
𰲖	䖀	
𰲟	䖚	
𰲠	虦	
𰲫	蟱	
𰲬	蛼	
𰲮	蜸	
𰲯	䗥	
𰲰	蜦	
𰲲	蟡	
𰲳	䗃	
𰲴	蠪	
𰲵	蠌	
𰲶	蛵	
𰲸	蝁	
𰲹	螘	
𰲺	𧒖	
𰲻	蟽	
𰳁	𧐐	
𰳂	螹	
𰳄	螴	
𰳆	𪘅	
𰳊	蟦	
𰳗	蠳	
𰳚	䗽	
𰳲	襱	
𰳵	襼	
𰳸	襨	
𰳹	𧞣	
𰳺	襛	
𰳻	𧞅	
𰳼	襹	
𰴂	襂	
𰴏	𫌩	
𰴕	覕	
𰴖	䙼	
𰴗	䚕	
𰴘	覸	
𰴙	覠	
𰴚	𧢃	
𰴛	𧡸	
𰴜	覰	
𰴝	覶	
𰴞	覻	
𰴢	觻	
𰴣	觷	
𰴤	䚞	
𰴥	𰴦	
𰴦	𰴥	
𰴯	謍	
𰴽	𬤃	
𰵊	訆	
𰵋	𲁢	
𰵌	諹	
𰵍	訰	
𰵎	訧	
𰵏	訬	
𰵐	䛀	
𰵑	譌	
𰵒	訦	
𰵓	訹	
𰵔	詍	
𰵖	讛	
𰵗	詇	
𰵘	𧦦	
𰵙	詄	
𰵚	詅	
𰵛	訽	
𰵜	䛌	
𰵝	訸	
𰵞	詠	
𰵠	詉	
𰵡	誙	
𰵢	𧧵	
𰵣	詥	
𰵤	詻	
𰵥	誃	
𰵦	詨	
𰵧	誌	
𰵨	讝	
𰵩	誧	
𰵪	𧨝	
𰵫	䛠	
𰵬	𧧸	
𰵭	誗	
𰵮	誐	
𰵯	誜	
𰵰	䛭	
𰵱	諃	
𰵲	諆	
𰵳	𧨳	
𰵴	諔	
𰵵	誽	
𰵶	諈	
𰵷	諁	
𰵸	誻	
𰵹	讘	
𰵺	謜	
𰵻	𧪮	
𰵼	謋	
𰵽	謟	
𰵾	謑	
𰵿	謞	
𰶀	謣	
𰶁	謻	
𰶂	謥	
𰶃	謵	
𰶄	譇	
𰶅	𧬁	
𰶆	譀	
𰶇	䜏	
𰶈	䜄	
𰶉	譠	
𰶊	譩	
𰶋	𧬯	
𰶌	譳	
𰶍	讂	
𰶎	譅	
𰶏	讑	
𰶑	豅	
𰶔	豄	
𰶨	𧱻	
𰶬	䝏	
𰷞	貣	
𰷠	貤	
𰷡	貦	
𰷢	貾	
𰷤	賥	
𰷥	賨	
𰷦	靅	
𰷧	賮	
𰷨	𧷛	
𰷩	䞉	
𰷪	賹	
𰷫	贆	
𰷬	𧸖	
𰷭	贓	
𰷮	贙	
𰷴	䟏	
𰷵	趬	
𰷶	趫	
𰷸	𧾥	
𰸇	𨇯	
𰸈	䠟	
𰸊	䠩	
𰸎	𨄉	
𰸐	躧	
𰸔	蹥	
𰸚	蹛	
𰸛	䠠	
𰸞	蹪	
𰸦	𮜗	
𰹀	軃	
𰹈	𰹯	
𰹯	𰹈	
𰹱	𨊠	
𰹲	軎	
𰹳	䡅	
𰹴	軓	
𰹵	轙	
𰹶	軖	
𰹷	䡇	
𰹸	軘	
𰹺	䡊	
𰹻	𨊹	
𰹼	輚	
𰹽	軯	
𰹾	𨍒	
𰹿	軵	
𰺀	軧	
𰺁	軥	
𰺂	軳	
𰺃	轛	
𰺄	輁	
𰺅	輂	
𰺆	𨋮	
𰺇	輐	
𰺈	輑	
𰺉	輤	
𰺊	輘	
𰺋	輙	
𰺌	𨏔	
𰺍	輠	
𰺎	輫	
𰺏	輣	
𰺐	輡	
𰺑	䡝	
𰺒	輲	
𰺓	輹	
𰺔	𨍈	
𰺕	𨍏	
𰺖	轃	
𰺗	轞	
𰺘	䡰	
𰺙	轖	
𰺚	𨎪	
𰺛	轑	
𰺜	轓	
𰺝	䡴	
𰺞	轏	
𰺟	轚	
𰺠	䡾	
𰺡	䡷	
𰺢	𨏒	
𰺣	轥	
𰺤	䡻	
𰺨	𨐶	
𰺭	䢈	
𰺲	逿	
𰺷	遶	
𰻆	遰	
𰻝	𰻞	
𰻞	𰻝	
𰻡	鄦	
𰻦	鄬	
𰻨	𮟽	
𰻮	鄡	
𰻳	鄪	
𰼅	醳	
𰼋	𨣃	
𰼏	𨣨	
𰼑	䤍	
𰼻	鑋	
𰽆	𮷴	
𰽕	鐖	
𰽖	釛	
𰽗	釪	
𰽘	釱	
𰽚	鑛	
𰽛	釥	
𰽜	鏂	
𰽝	䥶	
𰽞	鈪	
𰽠	䤠	
𰽡	鈤	
𰽢	鋧	
𰽣	鈏	
𰽥	鈵	
𰽦	鑨	
𰽧	鉟	
𰽨	鉙	
𰽩	鉲	
𰽫	鉎	
𰽬	鉌	
𰽭	鉤	
𰽮	鉜	
𰽯	鉒	
𰽰	鉡	
𰽱	鉘	
𰽲	銡	
𰽳	顉	
𰽴	銙	
𰽵	銧	
𰽶	鉵	
𰽷	鐬	
𰽸	䤨	
𰽹	鉹	
𰽺	䤥	
𰽻	銋	
𰽼	鉼	
𰽽	𨦡	
𰽾	鐹	
𰽿	銸	
𰾀	鋍	
𰾁	銾	
𰾃	鋜	
𰾄	鋂	
𰾅	鋡	
𰾆	鋊	
𰾇	𨧐	
𰾈	䤬	
𰾉	𫒢	
𰾊	𨦱	
𰾋	龲	
𰾌	鏩	
𰾍	錶	
𰾎	錍	
𰾏	鋾	
𰾐	䤵	
𰾑	鍂	
𰾒	錧	
𰾓	錔	
𰾕	鍱	
𰾖	䤻	
𰾗	鍼	
𰾘	鍖	
𰾙	鍝	
𰾚	鍡	
𰾛	鎅	
𰾜	鍴	
𰾝	鍟	
𰾞	鍐	
𰾟	鍑	
𰾡	鍧	
𰾢	鍦	
𰾣	𫒷	
𰾤	鍜	
𰾥	鍨	
𰾦	䤸	
𰾧	𨫼	
𰾨	𨪋	
𰾩	鎑	
𰾪	鐚	
𰾫	鑑	
𰾬	鎉	
𰾭	鑀	
𰾮	鎌	
𰾯	鎕	
𰾰	鏙	
𰾱	鏓	
𰾲	鏕	
𰾳	𨬒	
𰾴	鐁	
𰾵	𨬟	
𰾶	鏸	
𰾷	鐕	
𰾸	鐤	
𰾹	鐫	
𰾺	𨮁	
𰾻	䥖	
𰾼	鐉	
𰾽	钃	
𰾾	钀	
𰾿	𨭛	
𰿀	𨰹	
𰿁	䥝	
𰿂	鑐	
𰿃	鑖	
𰿄	鑘	
𰿅	䥴	
𰿆	鑽	
𰿇	䥷	
𰿈	鑯	
𰿉	鑸	
𰿊	𨰠	
𰿖	𨱥	
𰿟	𳈔	
𰿢	𮤶	
𰿣	𲉂	
𰿥	𫔘	
𰿦	𨳌	
𰿧	𨳐	
𰿨	䦎	
𰿩	閕	
𰿪	𨳚	
𰿫	䦱	
𰿬	閛	
𰿭	𨳸	
𰿯	𫔡	
𰿰	𨉖	
𰿳	閷	
𰿴	䦪	
𰿵	𨵦	
𰿸	𨶑	
𰿹	𨶰	
𰿺	闛	
𰿻	闟	
𰿾	闢	
𱀑	隲	
𱀡	隫	
𱁒	䨴	
𱁞	𩅦	
𱁱	𩋌	
𱁳	𩍜	
𱁴	鞸	
𱁶	韆	
𱁷	韇	
𱁹	鞼	
𱁺	鞻	
𱁽	䪍	
𱁾	韊	
𱂃	𩎕	
𱂄	𩎟	
𱂅	䪐	
𱂆	韐	
𱂇	韏	
𱂈	韗	
𱂉	韒	
𱂊	韘	
𱂋	韣	
𱂌	䪝	
𱂍	𩐌	
𱂎	䪥	
𱂐	韻	
𱂠	𩑒	
𱂡	𩑡	
𱂢	䪼	
𱂣	顤	
𱂤	顪	
𱂥	頟	
𱂦	頩	
𱂧	頪	
𱂨	頞	
𱂩	𩒺	
𱂫	顩	
𱂬	頯	
𱂭	顀	
𱂮	䫌	
𱂯	顇	
𱂰	顄	
𱂱	顑	
𱂲	顋	
𱂳	𩔇	
𱂴	顜	
𱂵	顝	
𱂶	顖	
𱂷	𩔣	
𱂸	顮	
𱂺	顠	
𱂻	顦	
𱃔	颩	
𱃕	颬	
𱃖	䬀	
𱃗	颱	
𱃘	颲	
𱃙	䬟	
𱃚	䬅	
𱃛	𩗛	
𱃜	䬐	
𱃝	飍	
𱃞	䬔	
𱃟	飁	
𱃠	飇	
𱃡	𬲨	
𱃢	𬲧	
𱃪	𬲽	
𱃱	䬣	
𱃲	饇	
𱃳	䬪	
𱃴	飰	
𱃵	䬬	
𱃷	䬳	
𱃸	䬹	
𱃹	䭓	
𱃺	餂	
𱃼	餴	
𱃽	餩	
𱃾	餢	
𱃿	餤	
𱄀	饙	
𱄁	𩜶	
𱄂	𩜯	
𱄃	䭈	
𱄄	餯	
𱄅	𩝧	
𱄆	饎	
𱄇	𩞧	
𱄈	饛	
𱄉	䭡	
𱄊	饡	
𱄝	𲌆	
𱄼	馵	
𱄽	馲	
𱄾	𩧉	
𱄿	騳	
𱅀	駂	
𱅁	馽	
𱅂	馺	
𱅃	駏	
𱅄	䮂	
𱅅	驡	
𱅇	駗	
𱅈	駜	
𱅉	駥	
𱅊	騺	
𱅋	駬	
𱅍	𩣊	
𱅎	𩢰	
𱅏	駣	
𱅐	駮	
𱅒	𩧢	
𱅓	𩣡	
𱅔	駷	
𱅕	騋	
𱅖	駽	
𱅗	騀	
𱅘	𩦃	
𱅙	駾	
𱅚	騇	
𱅛	驒	
𱅜	騕	
𱅝	騗	
𱅞	騢	
𱅟	騥	
𱅠	䮧	
𱅡	騩	
𱅢	騬	
𱅣	𩥅	
𱅤	驞	
𱅥	𩥃	
𱅦	䮲	
𱅧	驉	
𱅨	𩥎	
𱅩	騽	
𱅪	驔	
𱅫	驈	
𱅬	驠	
𱅮	髐	
𱆀	鬝	
𱆁	鬜	
𱆃	䰎	
𱆄	𩯃	
𱆅	䰐	
𱆆	鬗	
𱆈	䰖	
𱆌	鬺	
𱆍	𩱈	
𱆖	𩴆	
𱆙	䰫	
𱆚	䫥	
𱆛	魗	
𱆥	鿕	
𱆧	𳎔	
𱆪	𲌳	
𱇋	𬶥	
𱇍	䰲	
𱇎	𬵂	
𱇏	魠	
𱇐	魭	
𱇑	䰽	
𱇒	魮	
𱇓	魱	
𱇔	魶	
𱇕	䰻	
𱇖	魬	
𱇗	鯩	
𱇘	魧	
𱇙	魫	
𱇚	䱅	
𱇛	鮇	
𱇜	魼	
𱇝	魾	
𱇞	䱇	
𱇟	魻	
𱇠	鮂	
𱇡	鮏	
𱇢	鮌	
𱇣	鱍	
𱇤	䱂	
𱇥	䱎	
𱇦	鮬	
𱇧	鮧	
𱇨	鮛	
𱇩	鱎	
𱇪	鮥	
𱇫	𩶯	
𱇬	䱌	
𱇭	鯠	
𱇮	𩷶	
𱇯	鮹	
𱇰	䱒	
𱇱	鯈	
𱇲	䱐	
𱇳	鮻	
𱇴	𩹾	
𱇵	鰿	
𱇶	鯥	
𱇷	䱜	
𱇸	鱦	
𱇹	䱥	
𱇺	鯚	
𱇻	䱤	
𱇼	鯦	
𱇽	䱡	
𱇾	鯮	
𱇿	鱐	
𱈀	䱟	
𱈁	鯅	
𱈂	鰅	
𱈃	𩹂	
𱈄	鯸	
𱈅	鯼	
𱈆	䱾	
𱈇	䱭	
𱈈	䱴	
𱈉	鰬	
𱈊	鰡	
𱈋	鰝	
𱈌	鱃	
𱈍	鰯	
𱈎	𩺞	
𱈏	鱁	
𱈐	鱄	
𱈑	鰴	
𱈒	䲉	
𱈓	鱏	
𱈔	𩻛	
𱈕	鱕	
𱈖	䲚	
𱈗	鱬	
𱈘	鱨	
𱈙	鱴	
𱈚	鱷	
𱈛	䲛	
𱈜	鱻	
𱉇	鳦	
𱉈	鳭	
𱉉	𬶼	
𱉊	鳱	
𱉋	𩾝	
𱉌	鸃	
𱉍	鳿	
𱉎	鳺	
𱉏	鷒	
𱉐	鵙	
𱉑	鳻	
𱉒	𩿊	
𱉓	鳸	
𱉔	鴂	
𱉕	鴚	
𱉖	䲹	
𱉗	鴠	
𱉘	鴡	
𱉙	䳅	
𱉚	鴩	
𱉛	鴙	
𱉜	𩿧	
𱉝	鵖	
𱉞	䳇	
𱉟	鸅	
𱉠	鵛	
𱉡	鴘	
𱉢	鴢	
𱉣	𪀚	
𱉤	䳏	
𱉥	鴶	
𱉦	䳓	
𱉧	䳒	
𱉨	鵶	
𱉩	鴺	
𱉪	鴱	
𱉫	鴸	
𱉬	鷮	
𱉭	𪀗	
𱉮	鵅	
𱉯	鴹	
𱉰	鸒	
𱉱	鶤	
𱉲	鴾	
𱉳	鷶	
𱉴	鸉	
𱉵	鶆	
𱉶	䳚	
𱉷	𪁛	
𱉸	鵌	
𱉹	鵗	
𱉺	䳕	
𱉻	鵎	
𱉼	䳭	
𱉽	鵋	
𱉾	鵕	
𱉿	鵔	
𱊀	鵱	
𱊁	鵸	
𱊂	䳟	
𱊃	鵹	
𱊄	鶃	
𱊅	鵻	
𱊆	鵵	
𱊇	鵴	
𱊈	鶂	
𱊉	𪈔	
𱊊	鵼	
𱊋	鵳	
𱊌	鶋	
𱊍	鵽	
𱊎	鶅	
𱊏	鶝	
𱊐	鶛	
𱊑	鶞	
𱊒	鶢	
𱊓	䳮	
𱊔	𪃃	
𱊕	鶙	
𱊖	鶟	
𱊗	鶔	
𱊘	鶨	
𱊙	䳲	
𱊚	鷏	
𱊛	鶽	
𱊜	𪈼	
𱊝	鶶	
𱊞	𪄠	
𱊟	鶷	
𱊠	鷋	
𱊡	鷕	
𱊢	鷑	
𱊣	䳺	
𱊤	鷛	
𱊥	𪄲	
𱊦	鷧	
𱊧	鷢	
𱊨	𪆫	
𱊩	鷵	
𱊪	䴇	
𱊫	鸆	
𱊬	鸀	
𱊭	鸒	
𱊮	鸁	
𱊯	鸄	
𱊰	鷾	
𱊱	鸐	
𱊲	𪇰	
𱊳	鸓	
𱊴	𪈏	
𱊵	鸙	
𱊺	𪉖	
𱊻	𪉣	
𱊼	䴝	
𱊽	𪊉	
𱋂	𪋈	
𱋄	𪋽	
𱋅	𪋼	
𱋆	䴮	
𱋇	麧	
𱋈	𪍿	
𱋉	𪌐	
𱋊	䴲	
𱋋	麮	
𱋌	𪌗	
𱋍	𪌘	
𱋎	䴳	
𱋐	麯	
𱋑	𪍷	
𱋓	𪌣	
𱋔	䴵	
𱋕	𪌬	
𱋖	麱	
𱋗	䴸	
𱋘	𪌮	
𱋙	䴹	
𱋚	𪌾	
𱋜	𪍇	
𱋝	䴺	
𱋟	𪍒	
𱋠	𪍍	
𱋡	𪍣	
𱋢	𪍑	
𱋣	𪍚	
𱋤	𪍘	
𱋥	𪍓	
𱋦	𪍞	
𱋨	𪍬	
𱋪	䵂	
𱋫	䵃	
𱋬	𪍴	
𱋭	𪎂	
𱋮	䵆	
𱋱	黂	
𱋴	䵐	
𱋶	黸	
𱋾	鼀	
𱋿	鼁	
𱌀	𪓛	
𱌁	䵶	
𱌃	䵷	
𱌄	鼅	
𱌅	𪓬	
𱌆	鼆	
𱌇	鼈	
𱌈	𪓹	
𱌉	鼊	
𱌊	鼚	
𱌏	鼲	
𱌕	𪖨	
𱌖	齈	
𱌗	齌	
𱌘	齍	
𱌙	𪗋	
𱌛	𱌪	
𱌫	齞	
𱌬	齚	
𱌭	齺	
𱌮	齣	
𱌯	齝	
𱌰	䶧	
𱌱	齥	
𱌲	齤	
𱌳	齳	
𱌴	𪘨	
𱌵	䶨	
𱌶	齱	
𱌷	𪘬	
𱌸	𪘥	
𱌹	齵	
𱌺	齻	
𱌼	𪙉	
𱌽	齸	
𱍁	龏	
𱍂	龖	
𱍄	𪚮	
𱍅	𪚭	
𱍆	𪚰	
𱍇	䶱	
𱍈	龞	
𱍉	𪛕	
𱍐	永	
𱍓	廷	
𱍥	燕	
𱍨	噽	
𱍪	𬆵	
𱍫	曲	
𱍹	乃	
𱎂	麓 𡉽	
𱎄	氹	
𱎒	再	
𱎘	弃	
𱎚	仁	
𱎜	今	
𱎞	卫 但	
𱎟	偒	
𱎠	死 葬	
𱎡	𰂇	
𱎣	衣	
𱎦	伶	
𱎧	倥	
𱎩	伤	
𱎫	俹	
𱎬	抱	
𱎮	匣	
𱎯	傊	
𱎲	𱏗	
𱎶	侉	
𱎷	訾	
𱎻	舒	
𱎾	儯	
𱏀	僫	
𱏂	𠐒	
𱏅	𠑃	
𱏆	𪝼	
𱏇	背	
𱏌	备	
𱏐	償	
𱏔	𫣻	
𱏕	㒟	
𱏗	𱎲	
𱏚	傑	
𱏛	𱏟	
𱏞	追	
𱏟	𱏛	
𱏠	濮	
𱏧	兜	
𱏩	㒯	
𱏪	期	
𱏫	兜	
𱏬	共	
𱏮	𠓇	
𱏵	興	
𱏼	觱	
𱏽	寇	
𱐀	𱐅	
𱐂	冰	
𱐃	𱐇	
𱐅	𱐀	
𱐇	𱐃	
𱐍	幽	
𱐑	窟	
𱐕	州	
𱐘	刻	
𱐙	剷	
𱐜	𰄻	
𱐝	劂	
𱐞	𠜷	
𱐠	剼	
𱐢	剟	
𱐤	𠝐	
𱐥	胶	
𱐦	磨	
𱐩	𬀷	
𱐪	𬮅	
𱐯	佗	
𱐳	㔤	
𱐼	𱰸	
𱐽	𤎤	
𱑀	𱑂	
𱑂	𱑀	
𱑄	腦	
𱑆	奊	
𱑉	㔶	
𱑊	𠥴	
𱑋	吟 涵	
𱑌	慝	
𱑎	率	
𱑏	舉	
𱑑	𲂶	
𱑓	享	
𱑔	擘	
𱑘	邲	
𱑝	厦	
𱑧	𱢈	
𱑨	𱢈	
𱑯	㓄	
𱑱	巠 圣	
𱑲	且	
𱑴	取	
𱑵	寻	
𱑷	予 馀	
𱑸	𣦼	
𱑺	燮	
𱒀	噧	
𱒁	𠾡	
𱒂	啺	
𱒄	巳	
𱒅	子	
𱒐	𱓒 𱓩	
𱒑	丙	
𱒙	啈	
𱒞	啥	
𱒠	了	
𱒢	㘘	
𱒤	咂	
𱒦	嚋	
𱒨	𡄵	
𱒪	夸	
𱒭	哥	
𱒱	余	
𱒶	𭊳	
𱒸	𠽫	
𱒻	𫫧	
𱓀	嗌	
𱓁	囌	
𱓍	吻	
𱓎	喜	
𱓐	𡁃	
𱓒	𱒐	
𱓔	𱔔	
𱓚	𡄃	
𱓛	𡆘 嗢	
𱓢	𱔟	
𱓣	𡂸	
𱓥	𡅭	
𱓧	𡂺	
𱓩	𱒐	
𱓬	𡃴	
𱓲	㘇	
𱓵	啣	
𱓻	唼	
𱓽	𡆕	
𱔇	𱔞	
𱔈	𤕦	
𱔊	㘋	
𱔌	𭍌	
𱔏	𠼪	
𱔔	𱓔	
𱔛	燧	
𱔞	𱔇	
𱔟	𱓢	
𱔡	衔	
𱔩	𡃹	
𱔪	𡅧	
𱔱	量	
𱕀	噍	
𱕌	囖	
𱕎	𢖕	
𱕐	寥	
𱕘	噍	
𱕞	𡄒	
𱕡	𧶬	
𱕢	兼	
𱕤	险	
𱕦	嚡	
𱕱	𪢧	
𱕴	舒	
𱕸	圕	
𱕻	㘠	
𱖁	葬	
𱖄	匾	
𱖅	𡈯	
𱖆	用	
𱖇	圲 圱 釬 圩	
𱖉	尘	
𱖋	𪢼	
𱖌	㺱	
𱖎	坳 岙 凹 垇 懊	
𱖏	𪤇 沧	
𱖐	壆	
𱖒	𡍌	
𱖔	徵	
𱖕	跩	
𱖘	𱗮 𱗮	
𱖚	壐	
𱖞	寨	
𱖦	尘	
𱖨	坏 堰	
𱖬	𱖹	
𱖭	𡎴	
𱖯	𡍬	
𱖲	墹	
𱖴	塓	
𱖵	召	
𱖶	缺	
𱖷	𡒸	
𱖸	坟	
𱖹	𱖬	
𱖺	𪤑	
𱖻	堵	
𱖼	𡏯	
𱗁	愆	
𱗃	碈	
𱗅	坳	
𱗏	壏	
𱗐	墨	
𱗗	坼	
𱗘	降	
𱗝	𡓳	
𱗟	𱰮	
𱗠	𭐁	
𱗥	𡑩	
𱗧	洍	
𱗫	罅	
𱗭	践	
𱗮	𱖘 𱖘	
𱗵	㻹	
𱗷	星	
𱘁	塾	
𱘂	堕	
𱘈	豁	
𱘒	𫮼	
𱘚	𲙼	
𱘡	嚭	
𱘤	憂	
𱘥	𡕢	
𱘦	悼	
𱘬	夢 梦	
𱘳	倐	
𱘹	幹	
𱘿	輿	
𱙁	焉	
𱙂	婗	
𱙄	嬩	
𱙅	𰌋	
𱙇	婨	
𱙊	肗	
𱙋	𮱚	
𱙍	𡢨 怪	
𱙏	囡	
𱙑	𡣙	
𱙓	妤	
𱙔	孍	
𱙗	嫺	
𱙚	谀	
𱙠	娐 傅	
𱙥	㜻	
𱙩	𡞧	
𱙯	癞	
𱙲	兼	
𱙴	孉	
𱙶	李	
𱙷	孭	
𱙻	耔	
𱙼	孛	
𱚃	家	
𱚅	家 𡶥	
𱚆	宛	
𱚇	冥 寘	
𱚈	曠	
𱚋	卑	
𱚌	录	
𱚍	宄	
𱚎	宰	
𱚏	𡧁	
𱚔	竄	
𱚘	聞	
𱚙	密	
𱚚	疮	
𱚛	𡬘	
𱚜	算	
𱚞	𦥘	
𱚠	耐	
𱚡	奪	
𱚢	乱	
𱚣	趙	
𱚥	𡮥	
𱚩	渚	
𱚭	龙	
𱚮	𣯛	
𱚰	斥	
𱚳	徙	
𱚵	屎	
𱚸	扆	
𱚹	昼	
𱚻	靴	
𱚽	屐	
𱛃	羼	
𱛇	㠘	
𱛈	阴	
𱛊	𡷹	
𱛍	崘	
𱛎	岉	
𱛏	岃	
𱛐	岃	
𱛑	缺 峡	
𱛓	巄	
𱛖	邦	
𱛗	凹	
𱛘	屲	
𱛙	𡾒	
𱛚	𡺱	
𱛜	寨	
𱛝	𡹄	
𱛟	𡽣	
𱛠	炭	
𱛢	岩	
𱛣	封	
𱛨	𡺭	
𱛪	步	
𱛬	嵵	
𱛯	㟋	
𱛰	𡿡	
𱛲	枉	
𱛳	巖	
𱛴	𱜊	
𱛼	嵂	
𱛾	𡿞	
𱜁	岁	
𱜃	邹	
𱜆	崤	
𱜇	嶺	
𱜈	悉	
𱜊	𱛴	
𱜏	𡼸	
𱜐	峣	
𱜑	獯	
𱜒	嶰	
𱜓	岙	
𱜔	巋	
𱜕	纛	
𱜞	𢁋	
𱜢	视	
𱜤	𢂿	
𱜥	帆	
𱜧	㭰	
𱜪	绵	
𱜯	褊	
𱜳	幌	
𱜴	缡	
𱜶	㭰	
𱜸	檺	
𱜹	歸	
𱜻	旃	
𱜾	殷	
𱝀	𠁟	
𱝅	庶	
𱝉	痛	
𱝊	疗	
𱝌	麒	
𱝍	廕	
𱝎	法	
𱝏	麟	
𱝐	法	
𱝑	𨑠	
𱝔	奉	
𱝕	凭	
𱝗	共	
𱝘	彝	
𱝜	𢐸	
𱝝	理	
𱝞	𢐚	
𱝟	丞	
𱝠	㣇	
𱝡	彘	
𱝪	廴	
𱝫	上	
𱝭	沛	
𱝮	德	
𱝯	派	
𱝲	戾	
𱝳	𢕕	
𱝴	衚	
𱝶	峙	
𱝷	搶	
𱝹	遽	
𱝺	𠐽 歸	
𱝼	姒	
𱝽	㤉	
𱞀	忬	
𱞁	忋	
𱞄	態	
𱞇	怮	
𱞈	帆	
𱞊	拤	
𱞋	𢥈	
𱞍	思	
𱞎	憑	
𱞒	恢	
𱞔	𱞺	
𱞕	憳	
𱞖	愆	
𱞘	閔	
𱞙	㥢	
𱞛	愕	
𱞜	狷	
𱞝	㥦	
𱞟	𢤽	
𱞠	𢤞	
𱞢	陶	
𱞨	归	
𱞩	㥆	
𱞫	𢛔	
𱞱	训 顺	
𱞲	憌	
𱞷	謫	
𱞺	𱞔	
𱞽	憍	
𱞿	懞	
𱟀	欣	
𱟁	条 樤	
𱟂	茕	
𱟈	恼	
𱟉	惫	
𱟊	愕	
𱟋	悱	
𱟍	竦	
𱟎	𢥇	
𱟓	僽	
𱟗	懔	
𱟘	隳	
𱟛	恋	
𱟜	侵	
𱟝	仇	
𱟞	止	
𱟠	𢧵	
𱟡	𬂄	
𱟩	𢷣	
𱟫	杉	
𱟬	摺	
𱟭	搣	
𱟰	抉	
𱟳	抚	
𱟴	忱	
𱟶	抛	
𱟸	揁	
𱟹	𫝾	
𱟺	𢺭	
𱟽	𢰸	
𱟿	𬷽	
𱠁	𢮤	
𱠄	捍	
𱠆	攑	
𱠉	𫾫	
𱠎	𢸾	
𱠏	㝩	
𱠐	拼	
𱠑	捻	
𱠖	扰	
𱠙	擺	
𱠚	𢷑	
𱠞	揞	
𱠢	想	
𱠥	𢱤	
𱠧	𱡖	
𱠨	揎	
𱠫	妪	
𱠱	𢴢	
𱠶	擰	
𱠷	攤	
𱠸	𢷻	
𱠹	拜	
𱠾	撕 厮	
𱡃	𪮴	
𱡅	𭣀	
𱡆	攄	
𱡉	𢸙	
𱡋	捋	
𱡌	擽	
𱡍	拥	
𱡏	揽	
𱡐	磕	
𱡑	捃 𢹲	
𱡔	擅	
𱡖	𢺈 𱠧	
𱡘	𢽟	
𱡚	夺	
𱡜	畀	
𱡟	援	
𱡠	奮	
𱡡	竊	
𱡧	亹	
𱡩	郢	
𱡪	断	
𱡫	哲	
𱡮	断	
𱡲	旌	
𱡶	旌	
𱡸	縿	
𱡹	间	
𱡼	㬙	
𱡽	旺	
𱡾	昏	
𱢃	𦛡	
𱢈	𱑨 𱑧	
𱢐	𱢥	
𱢒	曩	
𱢕	冒	
𱢙	𣌍	
𱢚	閃 闪	
𱢡	貆	
𱢥	𱢐	
𱢦	早	
𱢬	𬪡 许	
𱢰	昏	
𱢲	昏	
𱢳	蚊	
𱢸	翎	
𱢿	榌	
𱣀	枝	
𱣂	㮧	
𱣃	枫	
𱣄	𪳵	
𱣅	举	
𱣇	檏	
𱣉	欉	
𱣋	𣞽	
𱣎	桀	
𱣐	𣖡	
𱣔	栴	
𱣖	𬅊	
𱣘	𣟵	
𱣚	槓	
𱣛	桃	
𱣝	挹	
𱣞	𣗼	
𱣟	东 厉	
𱣠	㮧	
𱣡	㯗	
𱣣	杗	
𱣤	橺	
𱣧	掛	
𱣨	檒	
𱣫	栟	
𱣭	𨐔	
𱣯	朻	
𱣱	樌	
𱣲	荷	
𱣵	極	
𱣻	𪳺	
𱣾	树	
𱤂	欗	
𱤄	椅	
𱤅	䵘	
𱤇	桫	
𱤈	爵	
𱤉	氂	
𱤏	森	
𱤑	归	
𱤚	欄 栏	
𱤛	悬 县	
𱤜	㬟	
𱤞	櫨	
𱤟	楬	
𱤦	卵	
𱤬	揽	
𱤳	橿	
𱤵	龕	
𱤶	爨	
𱤻	蹋	
𱤽	历	
𱤾	龁	
𱥀	歧	
𱥁	龆	
𱥂	貞	
𱥃	殄	
𱥅	道 郭	
𱥆	徙	
𱥇	遷	
𱥈	遁	
𱥊	衛	
𱥋	蛇	
𱥌	𣦼	
𱥍	㱙	
𱥏	悼	
𱥑	凋	
𱥒	殂	
𱥓	肂	
𱥕	墓	
𱥖	㱿	
𱥗	㝅	
𱥙	散	
𱥜	婆 乸 𲑸	
𱥟	𣬽	
𱥠	𣭶	
𱥡	𣰊	
𱥤	𣰵	
𱥥	㲥	
𱥦	㲲	
𱥨	民	
𱥩	氓	
𱥭	靔	
𱥮	求	
𱥳	淇	
𱥵	𣷣	
𱥸	濮	
𱥹	沨	
𱥻	㲽 梁	
𱥽	康	
𱥾	滔	
𱥿	江	
𱦂	游	
𱦅	𬈭	
𱦇	滄	
𱦈	𣷾	
𱦉	沥	
𱦊	𣼳	
𱦌	汰	
𱦍	没	
𱦎	淵	
𱦏	潨	
𱦐	御	
𱦑	塗	
𱦒	浮	
𱦓	浮	
𱦗	沃	
𱦘	浚	
𱦙	漆	
𱦚	济	
𱦛	濟	
𱦞	没	
𱦟	渊	
𱦠	沒	
𱦡	茫	
𱦢	姿	
𱦣	浴	
𱦤	淵	
𱦥	渊	
𱦦	滔	
𱦩	派	
𱦪	液	
𱦫	漆	
𱦬	沱	
𱦭	𣾺	
𱦮	讯	
𱦯	浸	
𱦰	漢	
𱦱	漆	
𱦴	深	
𱦵	浿	
𱦶	𤄷	
𱦸	泉	
𱦹	淑	
𱦺	淵	
𱦻	洪	
𱦾	泪	
𱦿	渤	
𱧂	梁	
𱧃	津	
𱧄	湛	
𱧅	滄	
𱧆	涎	
𱧈	溥	
𱧉	渤	
𱧊	源	
𱧋	溝	
𱧌	漆	
𱧍	潔	
𱧏	港	
𱧐	深	
𱧑	深	
𱧒	滿	
𱧓	澤	
𱧕	塗	
𱧖	泡	
𱧗	淵	
𱧘	澡	
𱧙	洪	
𱧚	𣾠	
𱧜	𤁝	
𱧝	粥	
𱧡	深	
𱧢	姿	
𱧣	渡	
𱧤	溢	
𱧥	滴	
𱧨	涩	
𱧩	泥	
𱧪	浸	
𱧫	濟	
𱧬	涩	
𱧰	漆	
𱧱	源	
𱧲	隶	
𱧴	脉	
𱧷	泡	
𱧸	淑	
𱧹	淄	
𱧺	港	
𱧻	漢	
𱧼	滿	
𱧽	滿	
𱧾	澄	
𱧿	瀉	
𱨀	涎	
𱨁	懷	
𱨂	漯	
𱨃	湔	
𱨄	渍	
𱨆	源	
𱨇	濟	
𱨈	游	
𱨉	溯	
𱨊	涵	
𱨋	漂	
𱨌	淒	
𱨍	滅	
𱨎	演	
𱨏	潸	
𱨑	泽	
𱨒	渭	
𱨓	漢	
𱨔	澤	
𱨕	滌	
𱨖	涣	
𱨗	溜	
𱨘	濛	
𱨚	濭	
𱨛	淳	
𱨜	淹	
𱨝	渡	
𱨞	溢	
𱨟	滂	
𱨠	濟	
𱨡	瀛	
𱨢	涵	
𱨣	溉	
𱨤	滲	
𱨥	济	
𱨨	演	
𱨩	濫	
𱨪	濾	
𱨫	漂	
𱨬	淌	
𱨭	圖	
𱨮	漫	
𱨯	潭	
𱨰	澤	
𱨱	激	
𱨲	泽	
𱨴	湭	
𱨵	澹	
𱨶	滌	
𱨷	潤	
𱨸	𤄃	
𱨹	湊	
𱨺	滨	
𱨻	灌	
𱨼	灌	
𱨽	演	
𱨾	漫	
𱨿	𤃷	
𱩀	津	
𱩁	澄	
𱩂	𤃡	
𱩃	潦	
𱩄	潸	
𱩅	濤	
𱩆	凝	
𱩇	洁	
𱩈	潔	
𱩉	𬉮	
𱩊	𪷫	
𱩍	澡	
𱩎	泽	
𱩏	瀑	
𱩐	淵	
𱩑	淄	
𱩒	渭	
𱩕	濬	
𱩙	濟	
𱩚	淳	
𱩛	潔	
𱩜	濟	
𱩝	濟	
𱩞	渊	
𱩟	濛	
𱩠	澈	
𱩡	瀚	
𱩢	凝	
𱩣	漆	
𱩤	穎	
𱩥	溼	
𱩦	濬	
𱩧	瀑	
𱩨	凝	
𱩩	漢	
𱩪	灆	
𱩬	法	
𱩭	漢	
𱩮	法	
𱩰	漬	
𱩱	瀛	
𱩲	灑	
𱩳	濬	
𱩴	灌	
𱩷	澹	
𱩸	湎	
𱩹	湔	
𱩾	瀑	
𱪀	瀑	
𱪂	澹	
𱪃	澹	
𱪄	法	
𱪅	瀛	
𱪆	灣	
𱪉	法	
𱪊	瀛	
𱪋	瀛	
𱪌	潘	
𱪍	灤	
𱪏	济	
𱪐	壑	
𱪑	溺	
𱪒	澹	
𱪓	潘	
𱪔	灑	
𱪕	凜	
𱪖	瀚	
𱪗	瀚	
𱪙	瀛	
𱪛	瀛	
𱪜	瀛	
𱪝	灨	
𱪞	瀛	
𱪟	瀛	
𱪠	瀛	
𱪨	炐	
𱪩	㶣	
𱪪	爏	
𱪬	然	
𱪭	燠	
𱪯	𤎶	
𱪰	炒	
𱪵	爐	
𱪶	弈	
𱪷	焉	
𱪸	炒	
𱪺	災	
𱪻	然	
𱪼	烈	
𱪽	焉	
𱪿	勲	
𱫀	赤	
𱫃	焉	
𱫄	𬋙	
𱫅	㸄	
𱫆	熙	
𱫇	烏	
𱫉	焯	
𱫊	𤏪	
𱫌	奂	
𱫎	燖	
𱫏	烽	
𱫐	𪹟	
𱫔	票	
𱫕	炒	
𱫘	锤	
𱫙	然	
𱫚	熱	
𱫜	𤎽	
𱫝	烈	
𱫞	熨	
𱫡	熱	
𱫢	感	
𱫣	煙	
𱫤	助	
𱫥	照	
𱫦	烽	
𱫧	然	
𱫫	凭	
𱫮	烬	
𱫯	𪹪	
𱫰	極	
𱫱	熹	
𱫲	燎	
𱫴	燭	
𱫵	播	
𱫶	煥	
𱫹	熟	
𱫼	癸	
𱫽	燎	
𱫾	炒	
𱫿	照	
𱬁	燖	
𱬄	炽	
𱬅	烂	
𱬆	殺	
𱬇	焕	
𱬈	煥	
𱬋	焕	
𱬌	焕	
𱬍	𤑷	
𱬏	𤒤	
𱬐	炒	
𱬔	照	
𱬖	炱	
𱬗	焚	
𱬚	煥	
𱬛	炽	
𱬠	业	
𱬡	𤓆	
𱬢	烽	
𱬣	𢅇	
𱬤	焚	
𱬦	蔚	
𱬧	票	
𱬨	懿	
𱬩	爨	
𱬬	焰	
𱬭	燐	
𱬯	熊	
𱬰	燧	
𱬱	爨	
𱬲	爨	
𱬳	焦	
𱬴	爪	
𱬵	氏	
𱬷	杷 印	
𱬸	神	
𱬹	舀	
𱬺	惧	
𱬻	孚	
𱬼	爰	
𱬾	爵	
𱭀	逿	
𱭂	爵	
𱭃	爱	
𱭅	福	
𱭆	爵	
𱭇	爵	
𱭋	爾	
𱭍	止	
𱭏	昧 床	
𱭐	轻	
𱭑	挺	
𱭒	抶	
𱭓	轮	
𱭔	牆	
𱭕	牆	
𱭖	擬	
𱭗	將	
𱭘	渊	
𱭛	案	
𱭜	𤗮	
𱭞	𤗲	
𱭠	𤍤	
𱭤	𤘑	
𱭩	牧	
𱭰	㹚	
𱭱	拟	
𱭲	牿	
𱭴	忌	
𱭸	弗	
𱭻	族	
𱭼	狸	
𱭽	毅	
𱮁	猷	
𱮂	犺	
𱮃	兕	
𱮇	猿	
𱮈	猾	
𱮉	左	
𱮋	猩	
𱮍	獀	
𱮎	猛	
𱮓	猶	
𱮖	猛	
𱮘	𪻉	
𱮙	狱	
𱮚	猾	
𱮜	𰡘 𰡘	
𱮝	犷	
𱮞	猛	
𱮟	猛	
𱮠	禽	
𱮡	戲	
𱮤	獸	
𱮥	獗	
𱮦	獨	
𱮧	獲	
𱮨	獲	
𱮩	獸	
𱮪	献	
𱮫	献	
𱮭	獲	
𱮴	𤦇	
𱮹	珍	
𱮺	𤦹	
𱮻	望	
𱮼	望	
𱮾	琜	
𱯀	望	
𱯁	望	
𱯃	瑤	
𱯄	𤫞	
𱯅	璃	
𱯆	𤨵	
𱯈	瑤	
𱯉	琢	
𱯊	琥	
𱯌	瑶	
𱯐	柬	
𱯑	𤨗	
𱯒	岡	
𱯓	琅	
𱯔	環	
𱯕	宝	
𱯖	瑤	
𱯗	瑤	
𱯘	璣	
𱯛	瑣	
𱯜	𬎓	
𱯠	璣	
𱯡	璣	
𱯢	璧	
𱯣	瑕	
𱯫	瓊	
𱯬	瓊	
𱯭	玺	
𱯮	㼆	
𱯯	瑰	
𱯰	瓊	
𱯱	瓊	
𱯳	璧	
𱯶	琼	
𱯷	煥	
𱯸	瓊	
𱯹	㻌	
𱯺	瓊	
𱯻	璧	
𱯾	瓊	
𱯿	瓊	
𱰀	瓊	
𱰂	瓊	
𱰃	琼	
𱰄	璧	
𱰅	瓠	
𱰆	𤬏	
𱰇	瓢	
𱰉	瓻	
𱰋	㼡	
𱰍	㼭	
𱰎	声	
𱰒	甔	
𱰓	籥 龠	
𱰔	氍	
𱰕	甗	
𱰖	弇	
𱰘	甥	
𱰛	嬲	
𱰢	庸	
𱰤	乪	
𱰥	畺	
𱰧	毗	
𱰨	威	
𱰪	𱰮	
𱰬	毗	
𱰭	葘	
𱰮	𱗟 𱰪	
𱰯	留	
𱰰	毕	
𱰱	𤲍	
𱰲	當	
𱰴	留	
𱰵	留	
𱰶	異	
𱰸	𱐼	
𱰺	𤳇	
𱰼	𤳆	
𱰾	奴	
𱰿	疇	
𱱁	震	
𱱄	睽	
𱱆	申	
𱱈	踖	
𱱉	病	
𱱊	𤷱	
𱱌	𤵒	
𱱎	怳	
𱱏	斥	
𱱐	瘌	
𱱒	啞	
𱱔	㽳	
𱱕	𫞭	
𱱖	痾	
𱱗	癥	
𱱙	牆	
𱱛	痯	
𱱜	瘗	
𱱠	㾭	
𱱡	虐	
𱱢	厭	
𱱨	厭	
𱱩	𤼀	
𱱭	懕	
𱱯	瘰	
𱱰	㿜	
𱱱	瘚	
𱱲	廬	
𱱵	登	
𱱶	發	
𱱷	發	
𱱸	發	
𱱼	磅	
𱲈	鼗	
𱲋	盘	
𱲌	孟	
𱲎	𡎠	
𱲏	孟	
𱲐	盈	
𱲑	盈	
𱲒	盪	
𱲓	螫	
𱲔	疣	
𱲕	氛	
𱲖	氲	
𱲗	氛	
𱲘	藹	
𱲙	氳	
𱲚	監	
𱲛	盥	
𱲝	氳	
𱲞	俱	
𱲟	盨	
𱲠	鹽	
𱲡	享	
𱲣	省	
𱲥	䁑	
𱲦	瞴	
𱲧	春	
𱲨	眾	
𱲩	是	
𱲭	盼	
𱲮	䁺	
𱲯	眉	
𱲲	睿	
𱲴	眺	
𱲵	睟	
𱲸	督	
𱲻	衆	
𱳁	看	
𱳅	𥍉	
𱳆	魅	
𱳉	睦	
𱳊	瞽	
𱳌	照	
𱳎	瞻	
𱳏	瞻	
𱳐	瞻	
𱳑	瞻	
𱳒	䁨	
𱳓	戴	
𱳔	矚	
𱳕	嚴	
𱳖	瞻	
𱳙	瞻	
𱳛	柔	
𱳜	務	
𱳠	起	
𱳡	智	
𱳤	智	
𱳥	模	
𱳫	砌	
𱳯	碖	
𱳱	䂻	
𱳳	䃖	
𱳶	碎	
𱳷	砥	
𱳸	碎	
𱳹	礑	
𱳺	峋	
𱳼	𥗭	
𱳽	碎	
𱳾	𥖇 浔	
𱳿	砥	
𱴁	𤿎	
𱴄	䂾 来	
𱴅	壑	
𱴉	𥗡	
𱴊	瑙	
𱴌	靡	
𱴏	𥕏	
𱴐	𥗊	
𱴓	硑	
𱴕	壺	
𱴖	硫	
𱴗	𠑘 敁	
𱴘	塂	
𱴙	𥕧	
𱴝	磐	
𱴟	𥕍	
𱴠	礢	
𱴢	粼 璘	
𱴣	碗	
𱴦	桥	
𱴧	磬	
𱴫	磐	
𱴭	罅	
𱴮	墜	
𱴯	蟂	
𱴰	蹠	
𱴲	磬	
𱴴	厭	
𱴵	騞	
𱴶	䃧	
𱴺	礫	
𱴻	磛	
𱴼	荦	
𱴽	壕	
𱴿	炮	
𱵂	礙	
𱵃	礰	
𱵆	私	
𱵇	祚	
𱵈	移	
𱵉	族	
𱵊	氣	
𱵋	恤	
𱵌	族	
𱵍	旌	
𱵏	神	
𱵐	神	
𱵑	旋	
𱵒	禳	
𱵓	裗	
𱵔	祸	
𱵕	柴	
𱵗	盟	
𱵘	穆	
𱵚	神	
𱵛	祗	
𱵜	穎	
𱵝	授	
𱵞	旌	
𱵟	禷	
𱵠	社	
𱵡	复	
𱵢	穡	
𱵣	祸	
𱵤	祸	
𱵥	𥜓	
𱵦	福	
𱵧	祷	
𱵩	權	
𱵪	禱	
𱵫	登	
𱵬	業	
𱵮	導	
𱵯	导	
𱵰	隶	
𱵱	禮	
𱵲	祀	
𱵳	祟	
𱵴	擅	
𱵵	禱	
𱵷	禮	
𱵸	禱	
𱵹	禹	
𱵺	禽	
𱵻	腊	
𱵽	私	
𱶁	枅	
𱶂	𥣘	
𱶃	移	
𱶄	稠	
𱶇	秦	
𱶈	稱	
𱶉	梟	
𱶊	荒	
𱶋	稽	
𱶌	積	
𱶍	稱	
𱶏	程	
𱶐	𥢒	
𱶑	稻	
𱶓	稽	
𱶔	稽	
𱶕	積	
𱶖	稷	
𱶘	椒	
𱶙	授	
𱶛	稱	
𱶟	拜	
𱶢	穀	
𱶣	稟	
𱶤	積	
𱶥	穎	
𱶧	秽	
𱶨	廪	
𱶩	秋	
𱶪	秋	
𱶫	稟	
𱶮	秋	
𱶰	定	
𱶲	穹	
𱶴	窈	
𱶶	𲝓	
𱶷	阱	
𱶹	寧	
𱶺	寅	
𱶼	寢	
𱶽	寐	
𱶾	旷	
𱶿	穿	
𱷁	寐	
𱷇	㝢	
𱷉	窈	
𱷊	寢	
𱷌	竄	
𱷍	寐	
𱷎	窊	
𱷏	最	
𱷐	寐	
𱷒	冥	
𱷓	寢	
𱷔	寢	
𱷕	寢	
𱷖	寢	
𱷘	寢	
𱷚	幀	
𱷛	竊	
𱷝	竊	
𱷞	竊	
𱷟	竊	
𱷠	竊	
𱷡	竊	
𱷢	竊	
𱷣	𡍂	
𱷤	望	
𱷥	龙	
𱷦	竣	
𱷧	竭	
𱷩	端	
𱷪	端	
𱷫	智	
𱷬	废	
𱷭	商	
𱷰	𥷒	
𱷱	岳	
𱷲	箸	
𱷳	笪	
𱷶	箧	
𱷷	䉅	
𱷸	䈟	
𱷹	笫	
𱷺	管	
𱷼	箒	
𱷽	𥳍	
𱷾	𥴆	
𱸂	䉩	
𱸇	簩	
𱸉	笼	
𱸌	符	
𱸐	䉔	
𱸔	𥴗	
𱸗	𥷨	
𱸢	笼	
𱸤	𥶀	
𱸥	艞	
𱸧	𥶇	
𱸩	席	
𱸪	簙	
𱸫	簳	
𱸮	槳	
𱸱	籘	
𱸳	氣	
𱸴	𥸱	
𱸵	𱹄	
𱸸	播	
𱸼	𱹞	
𱸾	糩	
𱸿	氣	
𱹁	𰫕	
𱹂	氣	
𱹄	𱸵	
𱹅	稟	
𱹆	妆	
𱹇	徙	
𱹈	氣	
𱹊	粞	
𱹌	禀	
𱹍	糜	
𱹏	腥	
𱹓	禀	
𱹔	𬗂	
𱹖	暴	
𱹗	饩	
𱹘	糕	
𱹙	禀	
𱹛	糞	
𱹜	康	
𱹝	禀	
𱹞	𱸼	
𱹟	稟	
𱹠	禀	
𱹡	稟	
𱹣	穀	
𱹤	𬖋	
𱹧	糠 穬	
𱹨	稟	
𱹫	𥾇 𠄏	
𱹬	幸	
𱹭	紊	
𱹰	𱺚	
𱹳	𦅀	
𱹴	䋱	
𱹵	𦁺	
𱹸	乌	
𱹹	絣	
𱹺	击	
𱹻	𦇒	
𱹼	缁	
𱹽	絷	
𱹾	彝	
𱺃	𱺪	
𱺄	脱	
𱺆	绚	
𱺉	緟 申	
𱺊	绩	
𱺋	彝	
𱺌	彝	
𱺍	轡	
𱺏	𫃚	
𱺐	𰫗	
𱺑	缭 𥾇	
𱺓	紤	
𱺔	𥿠	
𱺕	䌬	
𱺖	𦆭	
𱺘	䋋	
𱺙	𥿡 泥	
𱺚	𱹰	
𱺛	䋘	
𱺜	䋱	
𱺝	𦀗	
𱺞	𦀽	
𱺟	𦃭	
𱺠	𰫦	
𱺡	𦀬	
𱺢	𦀨	
𱺦	緾	
𱺧	練	
𱺨	𦂔	
𱺩	𬗮	
𱺪	𱺃	
𱺫	䌏	
𱺬	𦅯	
𱺭	𦆙	
𱺯	䌨	
𱺰	𦈃	
𱺱	罎	
𱺲	湴	
𱺴	𮉽	
𱺷	尤	
𱺸	罷	
𱺹	罚	
𱺼	冠	
𱺽	冠	
𱺾	冕	
𱺿	冠	
𱻀	曼	
𱻁	冕	
𱻂	最	
𱻄	𦋓	
𱻅	罝	
𱻆	网	
𱻈	羁	
𱻉	洋	
𱻋	咩	
𱻌	羕	
𱻎	羗	
𱻑	欽	
𱻒	嫌	
𱻓	嬴	
𱻕	嬴	
𱻗	戮	
𱻘	翅	
𱻚	友	
𱻝	戮	
𱻞	翸	
𱻡	羾	
𱻢	𦒮	
𱻣	毵	
𱻦	鹴	
𱻩	壽	
𱻪	耆	
𱻫	壽	
𱻬	壽	
𱻭	耆 耈	
𱻮	壽	
𱻱	耑	
𱻴	耫	
𱻶	穡	
𱻸	卯	
𱻹	婿	
𱻺	卯	
𱻽	孚	
𱻾	聪	
𱻿	肇	
𱼀	肉	
𱼃	服	
𱼇	𦠜	
𱼈	脂	
𱼊	胁	
𱼋	朖	
𱼎	𦡹	
𱼏	膭	
𱼑	能	
𱼔	臟	
𱼕	朒	
𱼚	膥	
𱼛	腭	
𱼜	䑀	
𱼝	脏	
𱼡	臛	
𱼤	臃	
𱼧	颐	
𱼫	台	
𱼭	埋	
𱼰	婁	
𱼱	壤	
𱼲	塵	
𱼳	含	
𱼶	郍	
𱼸	䑺	
𱼹	𦩀	
𱼺	𦪠	
𱼻	筏	
𱼾	凌	
𱼿	朝	
𱽀	朝	
𱽁	槳	
𱽃	𦪶	
𱽄	棹	
𱽅	履	
𱽆	彝	
𱽇	艰	
𱽈	氓	
𱽍	等	
𱽎	𦮷	
𱽓	恭	
𱽔	兔	
𱽗	蘆	
𱽘	䕺	
𱽚	藥	
𱽛	𦲕	
𱽜	蓻	
𱽞	恭	
𱽤	𦸰	
𱽧	芻	
𱽨	𦰥	
𱽪	薗	
𱽭	恭	
𱽰	紛	
𱽱	䕠	
𱽲	䕥	
𱽴	前	
𱽹	䓲	
𱽺	義	
𱽻	蒥	
𱽾	𦻖	
𱾀	葀	
𱾁	業	
𱾃	花	
𱾅	獲	
𱾉	薱	
𱾊	𦶍	
𱾎	䕵	
𱾐	簕	
𱾒	園	
𱾓	園	
𱾔	園	
𱾕	慕	
𱾙	睿	
𱾜	叢	
𱾟	蔓	
𱾢	𧀦	
𱾣	𨷈	
𱾤	蓐	
𱾧	蘴	
𱾩	割	
𱾬	叢	
𱾭	薹 蒿	
𱾯	葠	
𱾰	秸	
𱾱	夔	
𱾲	子	
𱾳	苕	
𱾴	蕤	
𱾶	薰	
𱾹	榛	
𱾺	寐	
𱾻	靃	
𱿀	欢	
𱿅	𱤺 𲼶	
𱿇	夔	
𱿎	盧	
𱿏	虓	
𱿒	号	
𱿓	亏	
𱿔	甲	
𱿕	號	
𱿖	獻	
𱿚	𧔝	
𱿝	蚑	
𱿟	蝡	
𱿡	𮕃	
𱿢	蟘	
𱿧	𧒄	
𱿨	柮	
𱿩	䗯	
𱿯	𲀊	
𱿴	蝲	
𱿵	蚼	
𱿸	暆	
𱿹	䘆	
𱿺	蝱	
𱿼	满	
𱿾	𧔢	
𲀀	𧕚	
𲀂	𧒗	
𲀆	𧐈	
𲀈	蟘	
𲀊	𱿯	
𲀋	狖	
𲀑	滋	
𲀒	蛙	
𲀔	螽	
𲀕	蜨	
𲀘	眾	
𲀛	衛	
𲀜	率	
𲀝	䡓	
𲀞	率	
𲀟	𧘅	
𲀡	禦	
𲀢	乱	
𲀣	导 道	
𲀧	衺	
𲀫	族	
𲀬	旌	
𲀭	袭	
𲀮	祤	
𲀯	衺	
𲀰	烈	
𲀲	裛	
𲀳	旋	
𲀶	帙	
𲀹	䄔	
𲀾	套	
𲁀	缉	
𲁃	槖	
𲁄	毳	
𲁅	饔	
𲁈	殮	
𲁉	甄	
𲁊	甄	
𲁋	甄	
𲁌	霸	
𲁍	覈	
𲁎	寬	
𲁏	睠	
𲁑	覔	
𲁔	𧢝	
𲁕	𧠯	
𲁖	覮	
𲁗	親	
𲁘	𧡱	
𲁙	覫	
𲁛	觝	
𲁞	𧤽	
𲁟	觱	
𲁠	觸	
𲁢	信 𰵋	
𲁣	望 恍	
𲁤	訍 议	
𲁦	辭	
𲁩	註	
𲁫	徵	
𲁮	愆	
𲁯	教	
𲁰	谗	
𲁱	攣	
𲁳	衰	
𲁴	懇	
𲁶	歌	
𲁷	讒	
𲁹	攣	
𲁺	濄	
𲁻	謿	
𲁼	讔	
𲁾	讒	
𲁿	謄	
𲂀	囈	
𲂁	譍	
𲂂	訉	
𲂃	訍	
𲂄	𧥼	
𲂅	訯	
𲂆	䛅	
𲂇	𧭈	
𲂈	䛔	
𲂉	䛩	
𲂊	譁	
𲂌	𫍊	
𲂍	誩	
𲂎	𧨿	
𲂏	諘	
𲂐	諵	
𲂑	𧪍	
𲂒	䜙	
𲂓	䜊	
𲂔	謶	
𲂕	譧	
𲂖	譢	
𲂗	𧭞	
𲂘	谽	
𲂙	谹	
𲂛	壑	
𲂜	壑	
𲂞	懿	
𲂟	懿	
𲂠	懿	
𲂡	悟	
𲂣	驺	
𲂥	狏	
𲂦	猛	
𲂧	𤢹	
𲂨	贿	
𲂩	肩	
𲂫	锁	
𲂭	贸	
𲂯	貯	
𲂱	榜	
𲂲	發	
𲂴	𲃆	
𲂶	𱑑	
𲂺	𧴲	
𲂻	賏	
𲂼	𧵆	
𲂾	𧵑	
𲂿	𧵛	
𲃀	锁	
𲃁	𬥓	
𲃃	𮚓	
𲃄	賲	
𲃅	𧷡	
𲃆	𲂴	
𲃉	𧽙	
𲃊	越	
𲃌	𨓲	
𲃍	𧽒	
𲃏	䟄	
𲃒	嗽	
𲃖	𮜃	
𲃘	踸	
𲃜	𨄙	
𲃟	𨆝	
𲃡	𨂱	
𲃢	蹒	
𲃣	𨆞	
𲃦	𨇱	
𲃪	𨆷	
𲃫	蹟	
𲃮	空	
𲃯	躝	
𲃰	堙	
𲃱	街	
𲃲	𨇒	
𲃽	蹉	
𲃾	𨅗	
𲃿	𨄍	
𲄄	𨈎	
𲄈	躔	
𲄉	缩	
𲄊	餍	
𲄑	躃	
𲄕	躞	
𲄗	㧟	
𲄙	𨊛	
𲄚	躼	
𲄛	𤆵	
𲄞	射	
𲄟	射	
𲄥	𨉺	
𲄦	肱	
𲄧	軁	
𲄪	𲄲	
𲄭	髓	
𲄮	嬪	
𲄯	舣	
𲄲	躺 𲄪	
𲄳	軑	
𲄴	𨏧	
𲄵	斡	
𲄶	轎	
𲄷	睫	
𲄸	擊	
𲄹	軿	
𲄺	皲	
𲄻	辔	
𲅁	𨊵	
𲅃	𨐃	
𲅅	广	
𲅇	璧	
𲅈	辜	
𲅉	礰	
𲅋	匹	
𲅍	撫	
𲅎	遤	
𲅏	匹	
𲅐	𨖇	
𲅑	䢙	
𲅒	过 過	
𲅔	廷	
𲅕	延	
𲅖	罷	
𲅗	遉	
𲅘	自	
𲅚	匣	
𲅜	径	
𲅝	庭	
𲅞	庭	
𲅟	壽	
𲅡	迸	
𲅥	遽	
𲅦	選	
𲅨	惻	
𲅩	迸	
𲅫	断	
𲅬	奁	
𲅭	鲁	
𲅮	撻	
𲅯	德	
𲅱	及	
𲅲	徙	
𲅳	將	
𲅴	汇	
𲅵	夏	
𲅶	逸	
𲅹	徙	
𲅺	及	
𲅻	须	
𲅽	𲆅	
𲅾	導	
𲅿	迵	
𲆀	匱	
𲆃	徙	
𲆅	𲅽	
𲆆	汇	
𲆇	送	
𲆊	動	
𲆏	趙	
𲆐	陋	
𲆔	𨟯	
𲆕	卻	
𲆖	蔡	
𲆗	葉	
𲆘	巷	
𲆙	䣄	
𲆛	𨞔	
𲆜	鄦	
𲆝	鄮	
𲆞	随	
𲆡	巷	
𲆢	蔑	
𲆣	虢	
𲆤	欒 栾	
𲆫	醺	
𲆬	炒	
𲆭	醻	
𲆲	渍	
𲆵	䢆	
𲆶	篘	
𲆷	醯	
𲆹	醕	
𲆼	濁	
𲆽	厲	
𲇂	髀	
𲇅	斜	
𲇆	欽	
𲇈	寻	
𲇉	欽	
𲇊	𬭄 𬭄	
𲇋	𲇼	
𲇍	凿	
𲇏	鐧	
𲇑	鑍	
𲇔	凿	
𲇕	鑑	
𲇗	鋩	
𲇘	智	
𲇚	鎞	
𲇢	锷	
𲇦	饕	
𲇧	緡	
𲇩	校	
𲇬	罎	
𲈢	愛	
𲈣	琴	
𲈨	閔	
𲈩	縣	
𲈪	关	
𲈫	𨷯	
𲈬	鬥	
𲈮	阑	
𲈯	阈	
𲈰	阖	
𲈱	闼	
𲈲	阈	
𲈳	𨷯	
𲈴	𨷶	
𲉌	阼	
𲉐	归	
𲉑	堕	
𲉒	歸	
𲉔	崩	
𲉕	歸	
𲉖	歸	
𲉘	恻	
𲉙	歸	
𲉚	歸	
𲉛	归	
𲉜	随	
𲉞	隁	
𲉟	鄢	
𲉠	墮	
𲉡	歸	
𲉣	缴	
𲉥	壟	
𲉧	雕	
𲉩	雥	
𲉪	𩾗	
𲉫	𡮿	
𲉬	歡	
𲉭	獲	
𲉮	推	
𲉱	宵	
𲉵	𩅀	
𲉸	䆗	
𲉼	窠	
𲉾	霆	
𲊁	爵	
𲊂	𩆷	
𲊃	寢	
𲊅	窱	
𲊋	撻	
𲊌	霍	
𲊎	臨	
𲊐	潸	
𲊒	𩆓	
𲊖	静	
𲊛	靸	
𲊜	冑	
𲊝	朔	
𲊞	鞚	
𲊟	韬	
𲊡	籣	
𲊢	靴	
𲊤	鞬	
𲊦	虀	
𲊧	响	
𲊨	𦖞	
𲊩	斂	
𲊪	頙	
𲊬	疱	
𲊭	頠	
𲊮	髑	
𲊱	夏	
𲊳	顗	
𲊴	奢	
𲊵	鷃	
𲊷	履	
𲋄	風	
𲋅	颴	
𲋉	飐	
𲋍	𩙛	
𲋎	䫺	
𲋏	䫽	
𲋐	𩙘	
𲋔	籸	
𲋕	𲋣	
𲋖	𩛂	
𲋗	餮	
𲋘	饒	
𲋙	𮩌	
𲋛	饲	
𲋜	𲋨	
𲋝	馔	
𲋟	𩛲	
𲋡	廪	
𲋢	𮸾	
𲋭	題	
𲋱	溢	
𲋳	牝	
𲋴	馺	
𲋵	焉	
𲋷	池	
𲋸	錽	
𲋺	𩧍	
𲋻	服	
𲋼	驄	
𲋽	騞	
𲋾	犁	
𲌂	驂	
𲌐	腧	
𲌒	颤	
𲌓	髓	
𲌔	𩪵	
𲌖	驕	
𲌘	樓	
𲌚	髫	
𲌛	𩬎	
𲌝	剃	
𲌞	𮫐	
𲌢	鬗	
𲌤	爵	
𲌥	爵	
𲌦	爵	
𲌧	畏	
𲌨	魑	
𲌩	馈	
𲌫	魍	
𲌮	魉	
𲌲	𲍋	
𲌳	𱆪	
𲌶	䱷	
𲌹	肴	
𲌻	𩽊	
𲍛	𲍭	
𲍞	鸨	
𲍟	𲍷	
𲍠	鹁	
𲍡	𪇍	
𲍣	鹦	
𲍥	凰	
𲍨	鸥	
𲍩	鸓	
𲎋	麃	
𲎌	鹿	
𲎍	麖	
𲎏	麦	
𲎑	𪍦	
𲎒	𪍅	
𲎓	熬	
𲎔	麕 麇	
𲎖	縓	
𲎙	員	
𲎜	鼙	
𲎞	鼪	
𲎟	猱	
𲎠	鼴	
𲎡	嗅	
𲎢	豁	
𲎣	𪘵	
𲎤	齧	
𲎥	䶥	
𲎮	魁	
𲎯	吹	
𲎿	他	
𲑈	㑠	
𲓖	𱐿	
𲗷	𲖹	
𲚔	㙌	
𲚕	𱖡	
𲜦	𲟛	
𲠃	㐾 阮	
𲠿	𫻍	
𲡂	𲟿	
𲡄	𲠴	
𲣏	𲡡	
𲣗	𲡬	
𲣘	𲡻	
𲣧	𢳚 𢶑	
𲣻	𲣶	
𲤋	𲤊	
𲥂	𮲚	
𲥃	𰖂	
𲨯	𲨟	
𲩼	𲩚	
𲪼	𮳄	
𲫆	𱩔	
𲮹	𲮑	
𲰼	他	
𲱧	𲱓	
𲱨	𲱚	
𲳱	𬒃	
𲴊	𲳶	
𲴗	𱴩	
𲴠	𲳺	
𲷨	𥽸 𲷕	
𳅝	𳅘	
𳆱	𳇱	
𳊵	𳊿	
𳋣	𳋰	
𳎻	𳏡	
