a	
pa⁵⁵	巴爸疤芭
pa³¹	把
pa⁵²	霸欛壩坝
pʰa³⁵	钯耙爬杷琶
pʰa⁵²	怕帕罢
ma⁵⁵	马妈码蚂
ma³⁵	麻痳
ma⁵²	骂
fa⁵⁵	花
fa³⁵	华铧桦
fa³¹	画
fa⁵²	化
va⁵⁵	划蛙漥
va³¹	话
ta³¹	打
tʰa⁵⁵	他
na³⁵	拿
na³¹	哪那{~个}
la⁵⁵	喇啦
la⁵²	罅
tsa⁵⁵	渣抓
tsa⁵²	炸诈榨乍䖳
tsʰa⁵⁵	叉杈差岔
tsʰa³⁵	茶搽查
sa⁵⁵	沙纱
sa³¹	洒耍
tʂa⁵⁵	遮
tʂa³¹	者
tʂa⁵²	蔗
tʂʰa⁵⁵	车奢
tʂʰa³¹	扯
ʂa⁵⁵	社赊
ʂa³⁵	佘蛇
ʂa³¹	射捨麝
ʂa⁵²	舍
ka⁵⁵	家加痂嘉傢佳
ka³¹	假贾假{~期}
ka⁵²	架驾嫁稼价
kʰa⁵⁵	卡{~车}
kʰa³¹	卡{关~}
ŋa⁵⁵	雅伢
ŋa³⁵	砑芽衙牙
ŋa³¹	瓦
ha⁵⁵	蝦哈
ha³⁵	霞瑕遐暇
ha³¹	夏厦下
a⁵⁵	鸦丫桠阿
a³¹	哑
a⁵²	亚
ia	
ȵia⁵⁵	惹
ia⁵⁵	也野
ia³⁵	爷
ia³¹	耶夜
ua	
kua⁵⁵	瓜
kua³¹	寡剐
kua⁵²	挂卦
kʰua⁵⁵	誇侉垮跨
ai	
pai³¹	摆敝
pai⁵²	拜
pʰai³⁵	排牌徘
pʰai³¹	稗败
pʰai⁵²	派
mai⁵⁵	买
mai³⁵	埋
mai³¹	卖迈
fai³⁵	怀槐淮
fai³¹	坏
tai⁵²	戴带
tʰai³¹	大驮
tʰai⁵²	太泰贷态
nai⁵⁵	乃奶
nai³¹	那{~些}
lai⁵⁵	拉
lai⁵²	赖癞孻
tsai⁵⁵	齐
tsai⁵²	债
tsʰai⁵⁵	钗差出猜
tsʰai³⁵	豺柴
tsʰai³¹	寨踩
sai³¹	玺徙
sai⁵²	晒
kai⁵⁵	阶皆楷稭佳街
kai³¹	解
kai⁵²	介界芥尬戒疥届
kʰai⁵²	傀
ŋai⁵⁵	𠊎
ŋai³¹	艾涯捱崖刈
hai⁵⁵	揩
hai³⁵	孩骇谐懈
hai³¹	械蟹解{姓}
ai⁵⁵	挨埃
uai	
kuai⁵⁵	乖
kuai³¹	拐
kuai⁵²	怪
kʰuai³¹	蒯
kʰuai⁵²	块快筷
uai⁵⁵	歪
au	
pau⁵⁵	包胞鲍
pau³¹	饱
pau⁵²	豹爆
pʰau⁵⁵	泡抛
pʰau³⁵	袍饱刨麅跑
pʰau⁵²	炮礮泡{~浸}
mau⁵⁵	卯矛
mau³⁵	茅锚
mau³¹	貌
nau³⁵	铙挠
nau³¹	闹
lau³⁵	捞唠
tsau³¹	抓爪肘帚笊
tsau⁵²	罩
tsʰau⁵⁵	抄钞
tsʰau³⁵	巢
tsʰau³¹	炒吵骤
sau⁵⁵	梢捎稍
sau⁵²	消哨
tʂau⁵⁵	昭招朝{今~}
tʂau⁵²	照诏
tʂ'au⁵⁵	超
tʂʰau³⁵	潮朝{~代}
tʂʰau³¹	赵兆召
ʂau⁵⁵	烧
ʂau³⁵	韶绍邵
ʂau³¹	少{多~}
ʂau⁵²	少{~年}
kau⁵⁵	交郊教
kau³¹	绞狡铰搞饺搅
kau⁵²	教校较觉窖
kʰau³¹	巧
kʰau⁵²	靠犒
ŋau⁵⁵	咬
ŋau³⁵	熬
ŋau³¹	肴淆
hau⁵⁵	烤敲酵
hau³¹	考
hau⁵²	孝效校{学~}
au⁵²	凹坳
iau	
piau⁵⁵	标表彪
piau³¹	表裱
pʰiau⁵⁵	飘漂
pʰiau³⁵	瓢嫖鳔
pʰiau⁵²	票漂{~亮}
miau³⁵	苗藐渺秒杳{~无音信}
miau³¹	描庙妙
miau⁵²	猫
tiau⁵⁵	刁貂雕鸟
tiau⁵²	钓弔
tʰiau⁵⁵	挑
tʰiau³⁵	条调{~和}
tʰiau³¹	掉调{音~}
tʰiau⁵²	跳粜越
liau³⁵	聊辽廖疗燎撩{~事}
liau³¹	廖瞭料了{~结}燎{火~目眉}
tsiau⁵⁵	焦椒蕉{香~}
tsiau³¹	沼{气~}
tsiau⁵²	醮{打~}
tsʰiau⁵⁵	锹
tsʰiau³⁵	樵瞧
tsʰiau³¹	瞧{牛倒~}
tsʰiau⁵²	俏悄{静~}
siau⁵⁵	消宵霄硝销萧箫
siau³¹	小
siau⁵²	笑鞘{刀~}
ȵiau³⁵	饶桡扰尧绕{围~、~线}
ȵiau³¹	尿
kiau⁵⁵	骄娇
kiau³¹	缴{上~}矫{~正}
kiau⁵²	叫
kʰiau³⁵	乔侨桥荞
kʰiau³¹	轿
kʰiau⁵²	窍
hiau⁵⁵	嚣枵浇侥{~幸}
hiau³¹	晓
iau⁵⁵	妖邀腰要{~求}么{~二三}吆{~喝}
iau³⁵	摇谣窑姚
iau³¹	耀鹞舀{~水}
iau⁵²	要{重~}
e	
se³¹	洗
se⁵²	细婿
ke⁵²	计继
kʰe⁵²	契
he⁵²	系係繫
ie	
tie⁵⁵	爹
tsie⁵⁵	邹
tsie³¹	姐
tsie⁵²	借
tsʰie³⁵	邪斜
tsʰie³¹	且谢
tsʰie⁵²	笪
sie⁵⁵	些
sie³¹	写
sie⁵²	泻卸赦
ȵie⁵⁵	勾钩沟
ȵie³⁵	牛
ȵie³¹	偶藕
ȵie⁵²	毅
kʰie³⁵	茄瘸
ei	
pei⁵⁵	杯悲
pei³¹	弊币毙
pei⁵²	贝辈
pʰei⁵⁵	胚坯披批
pʰei³⁵	培陪赔倍
pʰei⁵²	沛配佩背{~诵}
mei⁵⁵	亩尾某畝
mei³⁵	谋
mei³¹	昧寐味茂贸
mei⁵²	谬
fei⁵⁵	非飞妃挥辉徽
fei³⁵	回茴肥翡浮否剖
fei³¹	汇吠匪榧阜
fei⁵²	疿费贿悔
vei⁵⁵	威煨喂
vei³⁵	违围伟苇讳
vei³¹	纬胃谓蝟未
vei⁵²	畏慰
tei⁵⁵	兜低
tei³¹	底抵递斗抖陡纠
tei⁵²	斗{~争}
tʰei⁵⁵	梯娣偷
tʰei³⁵	蹄啼头投
tʰei⁵²	替涕剃屉透逗豆
nei³⁵	泥尼
nei³¹	纽腻
lei³⁵	黎犁搂楼耧
lei³¹	漏陋
tsei⁵⁵	剂挤
tsei³¹	滞走
tsei⁵²	奏
tsʰei³⁵	齐荠
tsʰei⁵²	砌凑
sei⁵⁵	筛馊搜
sei³⁵	愁
sei³¹	洗
sei⁵²	细壻婿嗽瘦
tʂei⁵²	制製
ʂei³¹	逝誓
ʂei⁵²	世势
kei⁵⁵	鸡鸠
kei³¹	狗苟
kei⁵²	够构购
kʰei⁵⁵	稽溪枢抠
kʰei³¹	启俱具
kʰei⁵²	吼叩寇
ŋei³⁵	危
ŋei³¹	艺倪
ŋei⁵²	蚁
hei⁵⁵	靴厚
hei³⁵	侯喉猴瘊
hei³¹	奚候兮口后
ei⁵⁵	欧瓯
ei³¹	呕殴矮
ei⁵²	沤{~肥}怄{~气}
ʅ	
tʂʅ⁵⁵	蜘支枝肢脂之芝辎
tʂʅ³¹	匙纸只旨指痔止趾扯
tʂʅ⁵²	智致至置志誌痣
tʂʰʅ⁵⁵	癡嗤
tʂʰʅ³⁵	池驰雉持侍
tʂʰʅ³¹	耻治齿始刺侈稚矢
tʂʰʅ⁵²	翅
ʂʅ⁵⁵	诗尸屍
ʂʅ³⁵	时鲥
ʂʅ³¹	是氏豉屎示视
ʂʅ⁵²	嗜肄市试
i	
pi⁵⁵	蓖碑卑
pi³¹	比陛被{~打}
pi⁵²	蔽闭臂秘泌辔庇痺
pʰi⁵⁵	被
pʰi³⁵	皮疲脾婢彼俾枇琵
pʰi³¹	算避鄙秕备鼻篦
pʰi⁵²	屁譬
mi⁵⁵	美
mi³⁵	谜迷靡眉楣微媚
mi³¹	米
ti⁵⁵	知
ti⁵²	帝
tʰi³⁵	题堤提
tʰi³¹	体弟隶
li⁵⁵	礼理鲤浬
li³⁵	离篱璃梨厘狸里
li³¹	利痢吏李
tsi³¹	豕子紫
tsi⁵²	祭际济
tsʰi⁵⁵	妻棲雌痴
tsʰi³⁵	脐迟
tsʰi⁵²	鳍
si⁵⁵	西犀斯撕
si³¹	死
si⁵²	肆四柿
ȵi³⁵	儿宜仪疑拟
ȵi³¹	二尔贰你耳义议谊饵
ki⁵⁵	机饥肌基几{茶~}讥{~笑}
ki³¹	技妓忌几{~多}纪{~念}
ki⁵²	髻寄己记既
kʰi³⁵	沂奇骑歧祁其棋琪期旗祈
kʰi⁵²	冀企
hi⁵⁵	牺欺熙嬉希稀
hi³¹	起杞喜豈
hi⁵²	戏器弃气汽
i⁵⁵	医伊衣依缢
i³⁵	侈移夷姨而饴
i³¹	绮倚椅矣已以易异
i⁵²	意
iu	
tiu⁵⁵	丢
tʰiu⁵²	□{脱掉的意思}
niu³⁵	朽
niu³¹	扭
liu⁵⁵	溜
liu³⁵	刘流留琉榴硫馏瘤
liu³¹	柳
liu⁵²	□{滑去的意思}
tsiu⁵⁵	周舟洲州
tsiu⁵²	酒皱昼绉咒
tsʰiu⁵⁵	秋鞦抽
tsʰiu³⁵	仇酬绸筹稠售
tsʰiu³¹	就袖宙醜丑纣
tsʰiu⁵²	臭兽嗅
siu⁵⁵	修羞收
siu³⁵	囚
siu³¹	手守受寿授
siu⁵²	秀绣锈莠
ȵiu³¹	乳
kiu³¹	纠{~正}
kiu⁵²	九久韭灸咎柩救究
kʰiu⁵⁵	臼舅
kʰiu³⁵	求球
kʰiu⁵²	旧
iu⁵⁵	丘休忧优有友酉幽
iu³⁵	泅柔揉尤邮由油游猶悠釉
iu³¹	又佑右柚鼬
iu⁵²	诱幼
y	
ly⁵⁵	吕旅
ly³¹	虑滤
tsy⁵⁵	猪诸诛朱硃珠蛛株
tsy³¹	拄主煮
tsy⁵²	著驻註注蛀铸
tsʰy⁵⁵	柱褚苎蛆
tsʰy³⁵	徐除储厨
tsʰy³¹	住箸取娶处{相~}
tsʰy⁵²	趣处{住~}
sy⁵⁵	书舒输
sy³⁵	鼠薯
sy³¹	署暑序绪絮树殊竖
sy⁵²	庶恕戍嗉
ȵy⁵⁵	语
ȵy³⁵	鱼渔
ȵy³¹	女御
ky⁵⁵	居车{象棋棋子的一种}
ky³¹	矩举
ky⁵²	锯句据
kʰy⁵⁵	枸驱俱区躯
kʰy³¹	巨拒距瞿渠具惧
kʰy⁵²	去
hy⁵⁵	墟虚嘘
hy³¹	许
hy⁵²	去{白}
y⁵⁵	於于吁迂
y³⁵	如汝淤与盂儒
y³¹	余馀与预豫娱愚虞榆愈逾埨喻遇寓雨宇禹羽裕
y⁵²	芋
o	
po⁵⁵	波玻菠坡
po⁵²	播
pʰo⁵⁵	棵
pʰo³⁵	婆
pʰo³¹	颇
pʰo⁵²	破
mo⁵⁵	摸摩馍蟆
mo³⁵	魔
mo³¹	磨{石~}
mo⁵²	磨
vo⁵⁵	离倭锅踒
vo³⁵	禾祸
to⁵⁵	多
to³⁵	妥椭
to³¹	惰
to⁵²	妬
tʰo⁵⁵	拖
tʰo³⁵	驼驮舵
tʰo³¹	唾
no³⁵	挪
no³¹	糯
no⁵²	□{用脚擦去东西}
lo⁵⁵	啰{~嗦}
lo³⁵	罗锣箩螺裸
lo³¹	卤
lo⁵²	□{一种味道}
tso³¹	左阻助
tso⁵²	做佐
tsʰo⁵⁵	初坐搓雏
tsʰo³⁵	锄
tsʰo³¹	座
tsʰo⁵²	锉错
so⁵⁵	梭㧧疏蔬唆蓑
so³¹	傻所锁琐
ko⁵⁵	哥歌戈
ko³¹	果裹{包~}
ko⁵²	个过
kʰo³¹	可
ŋo⁵⁵	我
ŋo³⁵	蛾鹅俄讹
ŋo³¹	饿卧
ho³⁵	河何荷
ho³¹	贺
ho⁵²	耗
oi	
poi⁵²	背簸
pʰoi⁵⁵	裴
pʰoi³⁵	陪
pʰoi³¹	焙
moi³⁵	梅媒煤枚糜
moi⁵²	妹
foi⁵⁵	灰恢魁奎
voi⁵⁵	煨
voi⁵²	秽会{~不~}
toi⁵²	碓
tʰoi⁵⁵	胎
tʰoi³⁵	台抬苔怠殆
tʰoi³¹	代待袋
noi⁵⁵	乃
noi³¹	耐奈
loi³⁵	来
loi³¹	缕
tsoi⁵⁵	灾栽
tsoi³⁵	滓
tsoi³¹	宰
tsoi⁵²	再载
tsʰoi³⁵	才材财裁
tsʰoi³¹	彩采
tsʰoi⁵²	赛莱蔡
soi⁵⁵	腮鳃
soi⁵²	岁
tʂoi⁵²	嘴{白}
ʂoi³¹	睡
ʂoi⁵²	税帅
koi⁵⁵	该赅
koi³¹	改
koi⁵²	盖
kʰoi⁵²	概慨溉丐刽桧绘
ŋoi³⁵	呆
ŋoi³¹	碍外伪
hoi⁵⁵	开
hoi³¹	海亥害
oi⁵⁵	哀
oi³¹	凯蔼
oi⁵²	爱
ou	
pou⁵⁵	褒
pou³¹	保堡宝
pou⁵²	报
pʰou³⁵	抱
pʰou³¹	暴菢
pʰou⁵²	瀑
mou⁵⁵	毛
mou³¹	冒帽
tou⁵⁵	刀
tou³¹	岛倒
tou⁵²	到
tʰou⁵⁵	滔韬叨
tʰou³⁵	桃逃陶淘涛
tʰou³¹	导盗道稻
tʰou⁵²	套
nou³¹	脑恼
lou³⁵	劳牢涝
lou³¹	老
tsou⁵⁵	遭糟
tsou³¹	早枣蚤
tsou⁵²	灶{炉~}
tsʰou⁵⁵	操
tsʰou³⁵	曹槽
tsʰou³¹	草皂造
tsʰou⁵²	澡躁燥糙
sou⁵⁵	臊骚
sou³¹	嫂叟
sou⁵²	扫
kou⁵⁵	高膏篙羔糕
hou³¹	好
hou⁵²	好{喜~}
ou⁵²	奥懊襖
u	
pu⁵⁵	埔{草~}
pu³¹	补斧
pu⁵²	布怖{恐~}
pʰu⁵⁵	簿铺{床~}
pʰu³⁵	脯菩蒲
pʰu³¹	谱普浦部薄甫脯
pʰu⁵²	步铺{店~}
mu⁵⁵	母
mu³⁵	巫诬模侮摹
mu³¹	舞鹉务
mu⁵²	暮慕墓募雾
fu⁵⁵	呼夫肤敷俘{~虏}孵{~小鸡}
fu³⁵	扶符互胡湖乎狐壶胡芙{~蓉}
fu³¹	父虎浒户护釜腐傅抚沪府腑俯赴妇讣附
fu⁵²	副付富赋戽
vu⁵⁵	乌污坞
vu³⁵	无
vu³¹	武
vu⁵²	恶{好~}
tu⁵⁵	都
tu³⁵	□{~门,一种动作}
tu³¹	堵肚赌
tʰu³⁵	徒屠途涂图
tʰu³¹	土杜度渡镀
tʰu⁵²	吐兔
nu³⁵	奴怒
nu³¹	努
lu⁵⁵	鲁橹虏庐驴
lu³⁵	卢炉芦{~草}鹭{~鸶}
lu³¹	路
lu⁵²	露赂
tsu⁵⁵	租资姿咨兹滋
tsu³¹	祖组此子梓
tsʰu⁵⁵	粗
tsʰu³⁵	慈磁寺饲词祠辞嗣瓷
tsʰu³¹	楚础赐自
tsʰu⁵²	次似厕
su⁵⁵	思苏酥私伺师司须狮丝
su³¹	字牸巳仕祀事士驶俟侍史使
su⁵²	素诉塑数漱
ku⁵⁵	姑孤枯
ku³¹	古估股鼓牯
ku⁵²	故固锢顾
kʰu⁵⁵	箍
kʰu³¹	苦
kʰu⁵²	库裤
ui	
fui³¹	会{开~}
fui⁵²	废肺晦
vui⁵⁵	委
vui³⁵	唯萎维惟遗桅
vui³¹	惠卫毁为位
vui⁵²	慧
tui⁵⁵	堆
tui³¹	队
tui⁵²	对
tʰui⁵⁵	推
tʰui³⁵	腿
tʰui³¹	褪兑
tʰui⁵²	退税
nui³¹	内
lui³⁵	雷儡{傀~}
lui³¹	累瘘垒类泪
tsui³¹	嘴叙
tsui⁵²	最醉
tsʰui⁵⁵	趋催崔吹炊
tsʰui³⁵	随
tsʰui³¹	罪聚
tsʰui⁵²	翠脆
sui⁵⁵	须需虽绥衰{白}
sui³⁵	髓
sui³¹	瑞垂粹遂坠穗
sui⁵²	碎
tʂui⁵⁵	追锥
kui⁵⁵	龟圭闺归
kui³¹	溃诡轨鬼
kʰui⁵⁵	亏规窥
kʰui³⁵	畦逵葵
kʰui³¹	柜跪
kʰui⁵²	愧
am	
tam⁵⁵	担耽
tam³¹	胆
tam⁵²	担{挑~}
tʰam⁵⁵	贪淡{白}
tʰam³⁵	潭谭痰
tʰam³¹	淡谈
tʰam⁵²	探
nam³⁵	南男
nam³¹	腩□{抱的意思}
lam³⁵	蓝篮
lam³¹	览缆揽榄滥檩舰
tsam⁵⁵	簪
tsam³¹	斩眨
tsam⁵²	蘸
tsʰam⁵⁵	参
tsʰam³⁵	蚕谗馋搀
tsʰam³¹	惨惭暂站
tsʰam⁵²	杉
sam⁵⁵	三衫森参
sam³¹	渗
tʂam⁵⁵	沾黏占瞻
tʂam⁵²	占佔
ʂam³⁵	蟾
ʂam³¹	陕闪
kam⁵⁵	甘柑泔监{国子~}
kam³¹	感敢橄减
kam⁵²	鉴尴监{~视}
kʰam⁵²	坎
ŋam³⁵	岩
ham⁵⁵	堪龛
ham³⁵	函砍咸衔
ham³¹	含撼憾陷馅
ham⁵²	勘喊嵌
am⁵⁵	庵
am³¹	揞
am⁵²	暗
iam	
tiam³¹	点
tiam⁵²	掂店垫
tʰiam⁵⁵	添
tʰiam³⁵	甜
tʰiam³¹	舔{用舌舔食物}
niam⁵⁵	粘拈{~东西}
liam³⁵	廉镰簾
liam³¹	脸殓敛殓
tsiam⁵⁵	尖
tsʰiam⁵⁵	签歼{~灭}
tsʰiam³⁵	潜
tsʰiam³¹	渐
ȵiam³⁵	严
ȵiam³¹	染念冉验俨
kiam⁵⁵	兼
kiam³¹	捡
kiam⁵²	剑
kʰiam³⁵	钳
kʰiam³¹	俭
hiam⁵⁵	谦
hiam³⁵	嫌
hiam³¹	险
iam⁵⁵	淹阉掩醃
iam³⁵	盐焰
iam³¹	艳炎阎
iam⁵²	厌
an	
pan⁵⁵	班斑般颁搬崩扳
pan³¹	板版
pan⁵²	半绊
pʰan⁵⁵	潘攀
pʰan³⁵	盘伴拌朋鹏
pʰan³¹	扮办
pʰan⁵²	盼拼判叛胖襻
man⁵⁵	满晚
man³⁵	瞒蛮
man³¹	慢馒漫幔万蔓
fan⁵⁵	番翻藩幡
fan³⁵	桓凡梵
fan³¹	帆范犯饭瓣反烦繁樊
fan⁵²	泛贬
van⁵⁵	弯湾
van³⁵	挽幻还环
van³¹	患宦
tan⁵⁵	丹单登灯
tan⁵²	旦坦诞
tʰan⁵⁵	滩摊
tʰan³⁵	毯檀弹掸腾疼胆
tʰan³¹	但蛋但
tʰan⁵²	炭叹
nan³⁵	难{困~}
nan³¹	难{灾~}
lan⁵⁵	懒
lan³⁵	兰栏拦
lan³¹	烂
tsan⁵⁵	曾增憎僧
tsan³¹	绽盏栈
tsan⁵²	赞灒撰
tsʰan⁵⁵	餐
tsʰan³⁵	层残曾{~经}
tsʰan³¹	铲产
tsʰan⁵²	灿篡
san⁵⁵	山删珊闩拴
san³¹	散{药~}
san⁵²	伞疝散{~开}
tʂan⁵⁵	毡
tʂan³¹	展
tʂan⁵²	战颤
tʂʰan³⁵	缠
ʂan³⁵	蝉禅
ʂan³¹	善羡膳单{姓}
ʂan⁵²	扇搧羶
ʐan³⁵	然燃
kan⁵⁵	艰间奸
kan³¹	简橺柬楝涧锏茧笕
kan⁵²	谏间{离~}
ŋan³⁵	颜顽
ŋan³¹	眼雁研
han³⁵	闲恒
han³¹	限苋
an⁵²	晏
ian	
pian⁵⁵	边编鞭辫
pian³¹	贬扁匾
pian⁵²	变
pʰian⁵⁵	篇偏蝙
pʰian³⁵	便{~宜}
pʰian³¹	辨辩汴便{方~}
pʰian⁵²	骗遍片
mian⁵⁵	免勉渑
mian³⁵	棉绵眠
mian³¹	娩缅
mian⁵²	面
tian⁵⁵	颠癫
tian³¹	典腆
tʰian⁵⁵	天
tʰian³⁵	田填
tʰian³¹	电殿奠佃
nian³¹	辇
lian³⁵	连莲怜联
lian³¹	练炼楝
tsian⁵⁵	煎链笺
tsian³¹	剪溅贱
tsian⁵²	箭饯薦
tsʰian⁵⁵	迁千
tsʰian³⁵	钱
tsʰian³¹	前浅践
sian⁵⁵	仙鲜先
sian³¹	癣
sian⁵²	线
ȵian³⁵	年元原源
ȵian³¹	愿
kian⁵⁵	坚跟肩掮捐
kian⁵²	见犬
kʰian³⁵	乾权虔拳观
kʰian³¹	件犍键
hian⁵⁵	牵
hian³⁵	贤弦玄絃悬
hian³¹	演遣现显
ian⁵⁵	烟冤渊
ian³⁵	涎焉延彦谚完圆员沿铅椽缘袁园阮辕
ian³¹	砚远眩宛燃
ian⁵²	燕嚥宴怨县
uan	
kuan⁵⁵	关
kuan⁵²	惯
yan	
lyan³⁵	恋
syan⁵⁵	宣
syan³¹	选旋锭篆
ȵyan⁵⁵	软
kyan⁵⁵	绢
kyan³¹	卷
kyan⁵²	眷券
kʰyan³¹	倦
hyan⁵⁵	喧圈
hyan⁵²	劝楦
yan³⁵	院
aŋ	
pʰaŋ⁵⁵	烹
pʰaŋ³⁵	彭膨棚
pʰaŋ³¹	棒
maŋ³⁵	盲虻萌盟
maŋ³¹	猛孟
laŋ⁵⁵	冷
tsaŋ⁵⁵	争筝
tsʰaŋ⁵⁵	撑
tsʰaŋ³⁵	橙澄
tsʰaŋ⁵²	睁挣
saŋ⁵⁵	生牲甥笙
saŋ³¹	省{节~}
tʂaŋ⁵⁵	正{~月}
tʂʰaŋ³¹	郑
ʂaŋ⁵⁵	声
ʂaŋ³⁵	成城
kaŋ⁵⁵	粳庚耕羹更{~换}
kaŋ³t	耿更{~加}
kʰaŋ³¹	埂{田~}哽{~骨}梗
ŋaŋ³¹	硬
haŋ⁵⁵	坑亨
haŋ³⁵	衡行{~为}
haŋ³¹	行{品~}
aŋ⁵⁵	莺
iaŋ	
piaŋ³¹	丙饼炳
piaŋ⁵²	柄
pʰiaŋ³⁵	坪
pʰiaŋ³¹	病
miaŋ³⁵	铭名明{清~}
miaŋ³¹	命
tiaŋ⁵⁵	钉
tiaŋ³¹	顶
tʰiaŋ⁵⁵	厅听汀
tʰiaŋ³¹	艇
liaŋ⁵⁵	岭领{~导}
liaŋ³⁵	零{~头}
tsiaŋ³¹	井
tsʰiaŋ⁵⁵	青蜻
tsʰiaŋ³⁵	晴
tsʰiaŋ³¹	请净
siaŋ⁵⁵	腥
siaŋ³¹	醒
siaŋ⁵²	姓
ȵiaŋ³⁵	迎
kiaŋ⁵⁵	惊
kiaŋ³¹	颈
kiaŋ⁵²	镜
kʰiaŋ³¹	□{节约的意思}
hiaŋ⁵⁵	轻
iaŋ³⁵	营萤型赢茔
iaŋ³¹	影映
uaŋ	
kuaŋ⁵⁵	轰
kuaŋ³¹	迥
uaŋ³⁵	弘横宏
en	
pen⁵⁵	彬宾槟冰兵滨
pen³¹	秉
pen⁵²	殡鬓
pʰen³⁵	贫频凭平评
pʰen⁵²	迸
men⁵⁵	敏悯
men³⁵	闽抿明鸣
ten⁵⁵	瞪{~眼}
ten³¹	等
ten⁵²	凳订
tʰen³¹	定锭铤
tʰen⁵²	邓听{~任}
nen³¹	佞宁{~可}
len³⁵	邻磷鳞
len⁵²	吝{~惜}
tsʰen³¹	蹭赠{~送}
sen⁵⁵	星
sen³¹	省{~长}
tʂen⁵⁵	珍真征蒸榛臻贞侦
tʂen⁵²	镇振震证症正政
tʂʰen⁵⁵	称{~呼}
tʂʰen³⁵	陈尘澄呈现程逞
tʂʰen³¹	阵诊疹整拯{~救}
tʂʰen⁵²	趁称{相~}
ʂen⁵⁵	身申伸升胜升
ʂen³⁵	神辰晨臣娠绳承乘蝇文塍{田~}
ʂen³¹	肾慎剩盛{兴~}
ʂen⁵²	圣胜{~败}
ken⁵⁵	跟根
ken³¹	仅紧谨劲
ken⁵²	茎
kʰen³⁵	澄{~清}
kʰen³¹	恳近
ŋen³⁵	银
hen⁵⁵	馨
hen³⁵	很形痕
hen³¹	垦恨肯杏幸
en⁵⁵	恩
ən	
tʂəm⁵⁵	针斟
tʂəm³¹	枕
tʂʰəm⁵⁵	深
ʂəm³¹	甚沈审婶葚
im	
lim³⁵	林淋琳临
tsim⁵⁵	斟{~酒}
tsim⁵²	浸
tsʰim⁵⁵	侵
tsʰim³⁵	寻沈
tsʰim³¹	寝
sim⁵⁵	心
ȵim³⁵	壬吟任{姓}
ȵim³¹	饮{~酒}任{责~}赁{租~}㳝
kim⁵⁵	今金
kim³¹	锦
kim⁵²	禁
kʰim⁵⁵	软襟
kʰim³⁵	琴禽吟岑
kʰim³¹	擒揿
im⁵⁵	音阴荫窨
im³¹	淫
in	
pin⁵²	并
pʰin⁵⁵	聘{~请}
pʰin³⁵	瓶屏萍
pʰin⁵²	姘拼
tin⁵⁵	丁钉
tʰin³⁵	亭停婷廷庭蜓
tʰin³¹	挺
nin³⁵	宁{安~}
lin⁵⁵	灵玲伶拎翎
lin³⁵	陵凌菱
lin³¹	令
tsin⁵⁵	精津晶睛
tsin⁵²	进晋
tsʰin⁵⁵	亲清
tsʰin³⁵	秦情
tsʰin³¹	尽侭静靖婧
tsʰin⁵²	亲{~家}
sin⁵⁵	辛新薪
sin⁵²	信讯性
ȵin³⁵	人
ȵin³¹	认勒
kin⁵⁵	巾斤筋荆经
kin³¹	境景警竞竟
kin⁵²	敬径劲
kʰin⁵⁵	芹卿倾
kʰin³⁵	鲸琼勤
kʰin³¹	擎顷
hin⁵⁵	兴{~旺}
hin⁵²	庆{~祝}兴{高~}
in⁵⁵	因姻欣殷扔鹰鹦樱婴缨英应{~当}绳{白}
in³⁵	寅仍凝盈仁
in³¹	引隐孕衅
in⁵²	印应{响~}
yn	
yn³⁵	云
yn³¹	慰韵运晕
on	
fon⁵⁵	欢
fon³¹	款
von³¹	碗剜豌援腕缓畹玩唤焕换
ton⁵⁵	端
ton³¹	短
ton⁵²	锻{~炼}断{决~}
tʰon⁵⁵	断{~绝}
tʰon³⁵	团
tʰon³¹	段缎椴
non⁵⁵	暖
lon³¹	卵乱
tson³¹	篡{编~}攒{积~}
tson⁵²	钻
tsʰon³⁵	泉
tsʰon³³¹	窜
son⁵⁵	酸
son⁵²	算
tʂon⁵⁵	专砖
tʂon³¹	转
tʂʰon⁵⁵	川穿
tʂʰon³⁵	传
tʂʰon³¹	喘传{~记}
tʂʰon⁵²	串
ʂon³⁵	船
kon⁵⁵	肝竿{竹~}干{~涉}
kon³¹	赶杆擀秆{稻~}
kon⁵²	斡{~部}
kʰon⁵²	看{~见}
ŋon³¹	岸
hon⁵⁵	旱
hon³⁵	寒刊韩
hon³¹	汗罕悍翰鼾{鼻~}
hon⁵²	汉
on⁵⁵	安鞍
on⁵²	按案
uon	
kuon⁵⁵	官棺观鳏冠{衣~}
kuon³¹	管馆
kuon⁵²	贯灌罐冠{~军}观{姓}
kʰuon⁵⁵	宽
oŋ	
poŋ⁵⁵	帮邦
poŋ³¹	榜谤滂{~沱}
pʰoŋ³⁵	傍旁螃{~蟹}庞{~大}
pʰoŋ³¹	蚌
moŋ³⁵	亡莽蟒芒{~草}
moŋ³¹	茫忘妄望忙{~碌}
foŋ⁵⁵	荒谎慌方芳肪
foŋ³⁵	妨防房访
foŋ³¹	仿倣彷纺晃桄
foŋ⁵²	放
voŋ⁵⁵	汪往
voŋ³⁵	黄王皇蝗簧
voŋ³¹	枉旺
toŋ⁵⁵	当
toŋ³¹	党挡
toŋ⁵²	当{~作}
tʰoŋ⁵⁵	汤
tʰoŋ³⁵	堂棠唐螳塘糖
tʰoŋ³¹	荡躺倘
tʰoŋ⁵²	趟烫
noŋ³⁵	囊曩瓤穰
loŋ³⁵	郎廊狼朗
loŋ³¹	浪
tsoŋ⁵⁵	庄脏装夯
tsoŋ³¹	状
tsoŋ⁵²	壮葬
tsʰoy⁵⁵	仓苍疮
tsʰoŋ³⁵	床
tsʰoŋ³¹	藏闯撞脏{心~}
tsʰoŋ⁵²	创
soŋ⁵⁵	桑丧嗓磉霜孀
soŋ³¹	爽
soŋ⁵²	丧{~失}
tʂoŋ⁵⁵	张章樟
tʂoŋ³¹	掌长{生~}
tʂoŋ⁵²	障涨仗帐账胀瘴{~气}
tʂʰoy⁵⁵	昌倡
tʂʰoŋ³⁵	肠场长{~短}
tʂʰoŋ³¹	厂丈杖
tʂʰoŋ⁵²	唱畅
ʂoŋ⁵⁵	商伤上{~山}
ʂoŋ³⁵	常尝裳偿
ʂoŋ³¹	赏尚上{~面}
koŋ⁵⁵	冈岗刚纲缸江豇
koŋ³¹	讲港
koŋ⁵²	钢降{下~}
kʰoŋ⁵⁵	扛
kʰoŋ³⁵	狂逛
kʰoŋ⁵²	抗炕旷况矿骯
ŋoŋ³¹	昂
hoŋ⁵⁵	康糠慷匡筐眶腔
hoŋ³⁵	航杭行{银~}
hoŋ³¹	项巷晌降{~火}
ioŋ	
lioŋ⁵⁵	两{斤~}
lioŋ³⁵	良凉粮梁粱量{~米}
lioŋ³¹	亮谅辆两{~个}量{数~}
tsioŋ⁵⁵	将浆
tsioŋ⁵²	奖桨蒋
lioŋ⁵²	酱将{大~}
tsʰioŋ⁵⁵	枪
tsʰioŋ³⁵	墙详祥
tsʰioŋ³¹	抢象像橡匠
sioŋ⁵⁵	相箱厢襄镶湘
sioŋ³¹	想
sioŋ⁵²	相{~貌}
ȵioŋ⁵⁵	仰
ȵioŋ³⁵	娘
ȵioŋ³¹	壤攘嚷釀让镶
kioŋ⁵⁵	羌疆僵礓姜
kʰioŋ³⁵	强
kʰioŋ³¹	强{勉~}
hioŋ⁵⁵	香乡
hioŋ³¹	享响饷
hioŋ⁵²	向
ioŋ⁵⁵	养癢秧央殃
ioŋ³⁵	羊洋烊杨扬阳疡荣
ioŋ³¹	永样泳
uoŋ	
kuoŋ⁵⁵	光胱
kuoŋ³¹	广
un	
pun⁵⁵	奔锛
pun³¹	本禀
pun⁵²	笨粪
pʰun³⁵	盆
pʰun³¹	品
pʰun⁵²	喷{香~~}
mun⁵⁵	蚊
mun³⁵	门吻刎
mun³¹	闷
mun⁵²	问
fun⁵⁵	分芬纷汾昏婚熏薰荤
fun³⁵	焚
fun³¹	粉坟愤忿奋份
fun⁵²	训
vun⁵⁵	温瘟
vun³⁵	魂文纹闻浑允尹
vun³¹	混稳匀{均~}
vun⁵²	□{关住的意思}
tun⁵⁵	敦墩蹲
tun³¹	沌囤顿扽
tʰun⁵⁵	吞
tʰun³⁵	屯豚饨
tʰun³¹	盾钝遁
nun³¹	嫩
lun³⁵	轮苍伦沦论{~语}
lun³¹	论{议~}
tsun⁵⁵	尊樽遵鳟
tsun⁵²	俊浚竣峻骏
tsʰun⁵⁵	村椿春
tsʰun³⁵	存旬循巡
tsʰun³¹	揣
tsʰun⁵²	寸忖
sun⁵⁵	孙荀殉
sun³¹	损笋榫
sun⁵²	逊迅
tʂun³¹	准
tʂun⁵²	圳
tʂʰun³¹	蠢
ʂun³⁵	唇纯醇
ʂun³¹	顺
ʂun⁵²	舜
ʐun³¹	润闰
ȵun⁵⁵	忍
ȵun⁵²	刃
kun⁵⁵	均钧君军
kun³¹	滚郡
kun⁵²	棍
kʰun⁵⁵	昆崑坤
kʰun³⁵	菌群裙
kʰun³¹	继稇
kʰun⁵²	困窘
uŋ	
pʰuŋ³⁵	蓬篷
muŋ³⁵	蒙濛朦
muŋ³¹	梦懵
fuŋ⁵⁵	风枫疯丰峰蜂锋讽封
fuŋ³⁵	红虹洪鸿冯逢缝
fuŋ³¹	凤奉
fuŋ⁵²	俸缝{裂~}
vuŋ⁵⁵	翁
vuŋ⁵²	瓮
tuŋ⁵⁵	东冬
tuŋ³¹	董懂
tuŋ⁵²	冻栋
tʰuŋ⁵⁵	通
tʰuŋ³⁵	同铜侗筒童瞳捅
tʰuŋ³¹	动桶洞统
tʰuŋ⁵²	痛
nuŋ³⁵	农脓侬浓
luŋ⁵⁵	笼聋
luŋ³⁵	隆龙陇垅
luŋ³¹	拢弄
tsuŋ⁵⁵	宗综椿鬃骏棕踪{跟~}纵{~横}
tsuŋ³¹	总
tsuŋ⁵²	粽纵{放~}
tsʰuŋ⁵⁵	窗聪葱囱怱
tsʰuŋ³⁵	丛松从
suŋ⁵⁵	双松
suŋ³⁵	嵩
suŋ³¹	崇诵頌讼怂{~恿}
suŋ⁵²	送宋
tʂuŋ⁵⁵	中忠钟终盅舂{~米}
tʂuŋ³¹	肿种{~类}
tʂuŋ⁵²	众中{射~}种{~树}
tʂʰuŋ⁵⁵	充冲重{轻~}
tʂʰuŋ³⁵	虫重{~复}
tʂʰuŋ³¹	仲铳冢宠
ʂuŋ⁵⁵	冗
ʂuŋ³⁵	戎绒茸
kuŋ⁵⁵	公工蚣功攻弓躬宫恭供{~给}
kuŋ³¹	拱{~手}巩{~固}
kuŋ⁵²	贡
kʰuŋ⁵⁵	空
kʰuŋ³⁵	穷
kʰuŋ³¹	共恐孔
kʰuŋ⁵²	空{亏~}
huŋ⁵⁵	胸凶{吉~}
huŋ³⁵	雄红
huŋ⁵²	閧哄汞控{~告}烘{~干}
iug	
hiuŋ⁵⁵	兄
iuŋ⁵⁵	雍擁臃
iuŋ³⁵	融熊容镕庸蓉{芙~}
iuŋ³¹	用涌勇{~敢}
ap	
tap²¹	答搭嗒溻
tʰap²¹	坍塔榻拓{~本}
tʰap⁴	踏塌沓
nap⁴	纳粒
lap²¹	笠
lap⁴	腊蜡镴邋
tsʰap²¹	插
tsʰap⁴	杂闸缉辑铡
sap⁴	□{用水煮东西}
tʂap²¹	摺褶
kap²¹	甲
kap⁴	蛤鸽合夹裌
k'ap⁴	磕
hap²¹	狭洽
hap⁴	合盒恰峡匣
ap²¹	押鸭压
iap	
tʰiap²¹	帖贴
tʰiap⁴	叠碟牒蝶谍
niap²¹	聂镊蹑摄
liap⁴	猎{打~}
tsiap²¹	接
tsʰiap²¹	妾
tsʰiap⁴	捷
siap⁴	涉
ȵiap²¹	业
kiap²¹	劫怯挟
kʰiap⁴	狭{~窄}峡{~谷}
hiap²¹	协歉胁
iap²¹	泣腌
iap⁴	叶页
at	
pat²¹	八钹弼
pat⁴	钵拨
pʰat⁴	泼扒
mat²¹	抹袜
mat⁴	末沫
fat²¹	法发
fat⁴	乏伐筏罚
vat²¹	挖
tʰat⁴	达
nat⁴	捺
lat²¹	癞
lat⁴	辣
tsat²¹	札轧
tsʰat²¹	刷涮察擦撒獭
tsʰat⁴	萨
sat²¹	杀
ȵat⁴	月
ŋat⁴	讫乞
hat²¹	瞎辖
at²¹	□{发怒}
uat	
kuat²¹	刮
kʰuat⁴	括阔聒
uat²¹	掘
uat⁴	活豁滑猾
ak	
pak⁴	百伯
pʰak²¹	栢拍魄擘
pʰak’	白帛
mak²¹	陌胍
mak⁴	麦
vak⁴	划
tsak²¹	窄摘责
tsʰak²¹	拆策册栅
tsʰak⁴	泽择宅
sak²¹	鹊
tʂak²¹	只炙
tʂʰak⁴	尺赤
ʂak⁴	石
kak²¹	格革隔
ŋak²¹	额
hak²¹	客赫嚇核{审~}
hak⁴	克刻{石~}
ak²¹	扼轭
ak⁴	握{~手}
iak	
piak²¹	壁璧
pʰiak²¹	劈霹
tʰiak²¹	踢
tʰiak⁴	笛
liak⁴	□{聪明}
tsiak²¹	跡脊
siak⁴	锡
ȵiak⁴	逆
kiak²¹	□{挑开}
kʰiak²¹	剧
kʰiak⁴	屐
ep	
tʂep²¹	执汁
ʂep²¹	湿
ʂep⁴	十什拾
et	
pet²¹	北迫碧笔毕逼
pʰet²¹	匹
met²¹	觅
met⁴	密蜜墨默
fet⁴	或
vet²¹	域
vet⁴	惑
tet²¹	得德
tʰet⁴	秩特
net²¹	匿
let⁴	历肋勒
tset²¹	则侧
tsʰet²¹	测七漆膝贼
tsʰet⁴	疾姪侄
set²¹	塞色啬悉
tʂet²¹	质哲蜇折浙织职
tʂet⁴	彻撤辙
ʂet²¹	设蚀
ʂet⁴	舌
ket²¹	吉
kʰet²¹	橛厥鳜
het²¹	黑刻{~东西}
het⁴	刻{时~}
iet	
piet²¹	鳖蹩憋
pʰiet²¹	别撇
miet²¹	灭篾
tʰiet²¹	铁
niet²¹	捏孽
liet⁴	列烈裂
tsiet²¹	节
tsʰiet²¹	切
tsʰiet⁴	绝截
siet²¹	泄薛楔雪
siet⁴	屑
pbiet⁴	热
kiet²¹	结洁
kʰiet²¹	杰揭决诀缺
hiet²¹	歇血
iet²¹	穴
iet⁴	乙越曰粤噔
ip	
lip⁴	立
tsʰip²¹	集袭习
ȵip²¹	入
kip²¹	急
kʰiep²¹	级汲给吸
kʰiep⁴	及
ip²¹	揖
it	
pʰit²¹	僻辟
tit²¹	的滴嫡
tʰit⁴	敌狄
nit⁴	溺
lit²¹	力
tsit²¹	即鲫积绩
tsʰit²¹	直值植殖戚斥
tsʰit⁴	寂
sit²¹	瑟息熄媳惜昔席夕释析
sit⁴	籍藉食
ʂit²¹	实饰式识失室适
ȵit²¹	日
kit²¹	吉戟击激
kʰit²¹	极
it²¹	逸益译液腋
it⁴	忆亿抑翼亦易疫役
ot	
pot²¹	勃悖饽渤
tʰot²¹	脱
tʰot⁴	夺
lot²¹	劣
lot⁴	捋
tsot²¹	撮
tʂot²¹	拙缀掇
ʂot²¹	说{说话}
kot²¹	割葛
hot²¹	喝渴
ok	
pok²¹	博驳
pok⁴	□{用棍打}
pʰok²¹	缚朴扑箔博{~古}膊{赤~}
pʰok⁴	薄雹泊{梁山~}
mok²¹	剥
mok⁴	莫膜寞幕
fok²¹	霍藿
vok⁴	锅镬获
tok²¹	铎踱跺
tok⁴	剁
tʰok²¹	讬托拓{开~}
nok²¹	诺
lok²¹	烙骆酪洛络
lok⁴	落乐胳荦
tsok²¹	捉作{工~}
tsʰok²¹	昨桌卓柞错
tsʰok⁴	戳凿
sok²¹	朔索{绳~}
tʂok²¹	酌绰焯着{~衣服}
tʂʰok⁴	着{睡~}
ʂok²¹	芍
ʂok⁴	勺
ʐok⁴	若
kok²¹	角觉各阁搁
kʰok²¹	确郝
ŋok⁴	鄂岳乐嶽
hok²¹	殼
hok⁴	学鹤
ok²¹	恶
iok	
tiok²¹	琢啄涿
liok⁴	略掠
tsiok²¹	爵嚼雀
siok²¹	削
ȵiok⁴	弱
kiok²¹	脚
kʰiok²¹	却郤
iok²¹	约跃钥
iok⁴	虐疟药
uok	
kuok²¹	国郭廓
ut	
put²¹	不
mut⁴	没
fut²¹	窟{白}
fut⁴	忽佛
vut⁴	勿物
tʰut⁴	突
lut⁴	率{利率}律
tsut²¹	卒猝
tsʰut²¹	□{抹的一种动作}出{~入}
sut²¹	戌
sut⁴	恤术述秫率蟀
kut²¹	骨橘
ut²¹	屈倔
ut⁴	核{白}
uk	
puk²¹	卜
pʰuk²¹	仆曝瀑
muk²¹	木目
fuk²¹	福腹复
vuk²¹	屋
tuk²¹	笃督
tʰuk²¹	秃独读牍犊
tʰuk⁴	毒
luk²¹	禄
luk⁴	鹿绿录碌
tsuk²¹	足
tsʰuk²¹	浊速促束
tsʰuk⁴	族
suk²¹	粟宿
suk⁴	俗续
tʂuk²¹	烛嘱蜀觸
ʂuk⁴	属赎
ʐuk²¹	辱褥
ȵuk⁴	玉
kuk²¹	谷
kʰuk²¹	曲
kʰuk⁴	局
huk²¹	哭酷
iuk	
iuk²¹	浴狱欲育
iuk⁴	沃郁
m	
m	吾
ŋ	
ŋ³⁵	吴蜈梧
ŋ³¹	五伍午误悟
