pai平	擺
pai去	拜稗敗
pʰai平	牌排
pʰai去	派
mai平	埋
mai上	買
mai去	賣邁
fai平	衰摔
fai上	甩
fai去	帥率(~領)
vai平	歪
vai上	舀崴
vai去	外
tai平	呆
tai上	歹逮□(好)
tai去	戴貸待代袋帶大(~夫)
tʰai平	胎臺苔擡
tʰai去	態太泰
nai平	挨捱
nai上	奶乃
nai去	耐奈愛那(2)
lai平	來
lai去	賴癲
tsai平	災栽齋宅□(咬)哉
tsai上	宰載崽
tsai去	再在債寨
tsʰai平	差(出~)猜釵材才財裁柴
tsʰai上	採彩
tsʰai去	菜蔡
sai平	腮鰓篩
sai去	賽塞(邊~)曬
kai平	該楷街
kai上	改解(2~開)
kai去	概溉蓋丐
kʰai平	開
kʰai上	凱慨楷
xai平	咳孩鞋
xai上	海
xai去	害亥
ai平	哀唉呆(~板)
ai上	矮
ai去	艾礙

pan平	班斑頒般搬扳
pan上	板版阪
pan去	伴拌半絆扮辦瓣
pʰan平	攀潘番盤蟠
pʰan去	判叛盼襻
man平	蠻瞞饅
man上	滿
man去	慢漫鏝幔
fan平	帆凡翻煩繁栓閂
fan上	反返
fan去	範犯販泛飯涮
van平	豌灣彎完丸玩頑
van上	碗晚挽綰軟阮
van去	萬蔓(瓜~)腕
tan平	丹單耽擔(~任)
tan上	膽撣疸
tan去	淡旦但擔(挑~)蛋彈(子~)
tʰan平	貪灘攤癱坍譚壇談彈(~琴)
tʰan上	毯坦袒
tʰan去	探嘆炭
nan平	南男難(~易)安
nan去	難(患~)揞案按
lan平	蘭欄藍籃
lan上	覽攬懶
lan去	濫爛
tsan平	簪
tsan上	斬盞攢
tsan去	贊濽暫站蘸
tsʰan平	參餐摻攙蠶殘慚
tsʰan上	慘產鏟
tsʰan去	燦□(開綫)
san平	三山衫珊
san上	散饊傘
san去	散(分~)
tʂan平	粘沾氈
tʂan上	展
tʂan去	占戰顫
tʂʰan平	蟬纏嬋
tʂʰan去	顫(1)
ʂan平	刪搧羶
ʂan上	閃陜
ʂan去	善扇騸膳單(姓)鄯釤(~鐮)苫
ʐan平	燃然黏(~飯)
ʐan上	染
kan平	乾(~濕)竿肝甘柑潛尷
kan上	感敢稈桿搟趕
kan去	幹(~活)
kʰan平	看(~守)刊勘龕
kʰan上	坎砍侃
kʰan去	看(~見)
xan平	憨酣涎(~水)寒韓含函鹹還
xan上	喊罕
xan去	漢旱汗銲翰撼莧
an平	鞍
an去	暗岸

paŋ平	幫邦浜
paŋ上	榜綁
paŋ去	棒蚌
pʰaŋ平	螃旁龐
pʰaŋ上	耪
pʰaŋ去	胖
maŋ平	忙芒茫盲
maŋ上	莽蟒
faŋ平	方芳坊妨房霜雙
faŋ上	紡仿訪防爽
faŋ去	放雙(~生)
vaŋ平	汪亡王枉
vaŋ上	往
vaŋ去	忘妄望旺
taŋ平	當(~時)襠
taŋ上	黨擋
taŋ去	蕩當(上~)檔宕
tʰaŋ平	湯唐糖棠塘
tʰaŋ上	倘躺淌
tʰaŋ去	燙趟
naŋ平	灢(泥濘)昂
naŋ上	饢攮
naŋ去	齉
laŋ平	郎廊狼
laŋ上	朗
laŋ去	浪
tsaŋ平	贓臟
tsaŋ去	葬藏(西~)臟(内~)
tsʰaŋ平	倉蒼艙昌(~吉,地名)藏(隱~)
saŋ平	桑喪(婚~)
saŋ上	嗓槡
saŋ去	喪(~失)
tʂaŋ平	張章樟璋
tʂaŋ上	漲掌長(成~)
tʂaŋ去	丈仗帳賬脹障
tʂʰaŋ平	昌(~盛)娼長(~短)腸常嫦嘗償
tʂʰaŋ上	場敞廠氅
tʂʰaŋ去	暢唱倡
ʂaŋ平	商傷墑
ʂaŋ上	賞晌
ʂaŋ去	上(~山)尚
ʐaŋ平	瓤
ʐaŋ上	壤嚷
ʐaŋ去	讓
kaŋ平	鋼綱剛缸肛扛(1)
kaŋ上	崗港
kaŋ去	鋼(~刀)虹杠□(脾氣~,倔强)
kʰaŋ平	康糠扛腔(胸~)
kʰaŋ上	慷
kʰaŋ去	抗炕渴□(煎)
xaŋ平	夯航杭行(銀~)
xaŋ去	巷
aŋ平	骯

pa平	巴笆疤扒八拔爸
pa上	把(一~刀)□(~屎,拉屎)
pa去	霸壩耙罷楊
pʰa平	帕(肉~)爬杷
pʰa去	怕
ma平	媽麻抹(~布)
ma上	馬碼螞
ma去	罵
fa平	發法乏伐筏罰刷
fa上	耍
va平	漥蛙挖襪娃挼
va上	佤瓦
ta平	搭答褡耷達
ta上	打
ta去	大
tʰa平	他她它塌溻塔獺踏沓(一~子)
na平	拿納捺
na上	哪
la平	拉臘蠟辣落(~下來)拉
tsa平	渣植閘炸(油~)紮劄側眨順砸咱雜
tsa上	咋拃(一~)這
tsa去	詐榨乍炸(爆~)挓(~手,舉手)
tsʰa平	叉差插茶茬察擦□(包穀~子)搽
tsʰa上	視
tsʰa去	差(2)岔杈詫(~生,認生)
sa平	沙紗砂殺煞
sa上	灑
sa去	啥廈
ʂa上	傻
ka平	尕尜蹶(尥~子)
kʰa上	揩(~油)卡(~車)
xa平	哈(~氣)蝦(~腰)瞎
xa上	哈(姓)
xa去	嚇下(~頭,下面)
a平	阿

pau平	包胞苞雹
pau上	寶保飽
pau去	報抱暴曝豹爆鉋
pʰau平	拋脬(尿~)泡(軟)袍刨
pʰau上	跑
pʰau去	泡(~茶)炮
mau平	毛貓錨茅蟊(~賊)
mau上	卯鉚
mau去	冒帽貌茂貿
tau平	刀叨
tau上	倒(打~)島導搗
tau去	稻道到倒(~水)盜悼
tʰau平	掏滔桃濤逃淘陶
tʰau上	討
tʰau去	套
nau平	撓熬
nau上	惱腦襖
nau去	鬧□(搽)藥(做動詞)
lau平	撈嘮勞牢癆
lau上	老姥
lau去	澇□(拉、拽)
tsau平	遭糟
tsau上	早蚤爪(1)澡棗
tsau去	造皂竈躁罩築(~籬)
tsʰau平	操抄鈔曹槽
tsʰau上	草吵炒
tsʰau去	糙
sau平	騷臊(~臭)捎梢稍
sau上	嫂掃(~地)
sau去	臊(害~)哨潲掃(~帚)
tʂau平	朝(~夕)召招著(~涼)
tʂau上	沼
tʂau去	趙兆照
tʂʰau平	超嘲朝(~代)潮
ʂau平	燒韶□(傻)
ʂau上	少(多~)
ʂau去	少(~年)邵紹
ʐau平	饒
ʐau上	擾繞(圍~)繞(~綫)
kau平	高羔糕膏(~油)
kau上	稿搞告膏
kʰau平	拷
kʰau上	考烤
kʰau去	靠銬犒
xau平	蒿薅豪毫號(呼~)嚎
xau上	好(~坏)
xau去	好(喜~)號(~碼)耗浩
au平	傲鏊奧澳

pei平	杯背(~槍)碑卑悲百白伯掰北
pei去	貝輩背(後~)臂(胳~)被(2~)被(~迫)焙鐾
pʰei平	胚坯披培陪賠裴拍
pʰei去	配佩倍
mei平	麥墨脈梅媒煤眉黴
mei上	美每
mei去	妹昧媚
fei平	飛非妃肥
fei上	匪翡水
fei去	廢肺費睡稅
vei平	微煨威維危惟唯違圍為(作~)□(挪動)
vei上	偽偉葦緯委萎尾(2)
vei去	衛魏慰畏位味未胃渭謂蝟為(~啥)銳瑞
tei平	得
tei上	□(吆喝牲口往前走)
nei去	內那(3)
lei平	勒肋
lei去	累(工作~)
tsei平	擇(~菜)窄摘賊
tsei去	這(2)
tsʰei平	拆
sei平	塞澀色骰(~子)嗇虱誰
kei平	隔
kei上	給
kʰei平	客剋
xei平	黑

ə˞平	兒而
ə˞上	爾耳餌□(扔)
ə˞去	二貳

pɤŋ平	錛崩蹦(跳~子)繃
pɤŋ上	本
pɤŋ去	笨奔迸蹦
pʰɤŋ平	噴盆烹抨滕臌朋
pʰɤŋ上	捧
pʰɤŋ去	噴(~嚏)碰
mɤŋ平	悶(不通氣)門蒙(~騙)
mɤŋ上	蒙(~古)猛
mɤŋ去	悶(煩~)夢孟
fɤŋ平	分芬紛吩墳封峰蜂豐瘋風逢縫馮
fɤŋ上	粉
fɤŋ去	糞奮憤忿份奉縫(~隙)俸鳳諷順舜
vɤŋ平	溫瘟文紋蚊聞翁嗡榮茸容絨
vɤŋ上	穩吻刎
vɤŋ去	問甕閏潤
tɤŋ平	登燈蹬鐙
tɤŋ上	等戥(~子)
tɤŋ去	扽凳鄧瞪澄
tʰɤŋ平	熥吞騰謄藤疼
nɤŋ平	能
lɤŋ平	楞棱
lɤŋ上	冷
lɤŋ去	楞
tsɤŋ平	增曾(姓)爭箏睜
tsɤŋ上	怎
tsɤŋ去	贈掙
tsʰɤŋ平	撐鐺(鉼~)層曾(~經)
tsʰɤŋ去	襯牚蹭磣鋥
sɤŋ平	森參(人~)僧生牲笙甥
sɤŋ上	省(節~)滲□(潮冷)
tʂɤŋ平	針珍真征正(~月)蒸貞偵
tʂɤŋ上	枕診疹整
tʂɤŋ去	鎮陣振震鄭政正(~直)證癥
tʂʰɤŋ平	抻稱(~呼)沈陳塵晨臣橙乘(~除)承程城成誠盛(~飯)
tʂʰɤŋ上	懲逞
tʂʰɤŋ去	趁稱(相~)秤乘(~車)
ʂɤŋ平	深身申伸紳呻神繩升聲
ʂɤŋ上	沈審嬸
ʂɤŋ去	腎甚剩勝盛(~大)聖
ʐɤŋ平	扔人仁
ʐɤŋ上	忍
ʐɤŋ去	任刃認靭紝(縫~)
kɤŋ平	根跟更(~改)庚耕
kɤŋ上	梗埂耿
kɤŋ去	更(~加)
kʰɤŋ平	坑
kʰɤŋ上	墾懇肯啃
kʰɤŋ去	坑(陷,車~住了)
xɤŋ平	亨哼痕橫
xɤŋ上	很
xɤŋ去	恨杏
ɤŋ平	恩
ɤŋ去	摁

pɤ平	波玻菠撥薄博搏駁剝嫑
pɤ上	簸
pɤ去	薄(~荷)
pʰɤ平	坡潑頗迫婆
pʰɤ去	破剖
mɤ平	摸魔磨摸模(~範)膜沫沒莫漠陌末
mɤ上	抹
mɤ去	磨(~麵)
fɤ平	說佛勺芍
vɤ平	窩矮握沃弱若
vɤ上	我
vɤ去	臥餓
tɤ平	德
tʰɤ平	特
nɤ平	娥鵝訛惡(善~)
nɤ上	那(1)
lɤ平	樂(快~)勒(庫爾~,地名)
tsɤ平	澤擇責則
tsɤ去	仄
tsʰɤ平	側測策冊廁(~所)
sɤ上	□(吆喝牲口後退聲)
tʂɤ平	遮蔗摺折哲轍蟄
tʂɤ上	者
tʂʰɤ平	車徹撤
tʂʰɤ上	扯
ʂɤ平	賒蛇佘舌折(弄~了)攝設
ʂɤ上	舍捨
ʂɤ去	舍(屋也)社射麝
ʐɤ平	熱
ʐɤ上	惹
kɤ平	歌哥戈疙格鴿割胳擱閣革各角(1)
kɤ去	個
kʰɤ平	棵顆科柯苛殼克刻
kʰɤ上	可課
xɤ平	呵何河荷禾和合核(~對)喝鶴豁(~出去)
xɤ去	賀荷(薄~)和(~聲)
ɤ平	阿(~膠)額惡(~心)

tɤu平	都(~是)兜
tɤu上	鬥(一~米)抖陡
tɤu去	鬥(~爭)豆逗痘
tʰɤu平	偷頭投
tʰɤu去	透
lɤu平	摟(~錢)樓爐
lɤu上	摟(~抱)簍耬
lɤu去	漏瘺
tsɤu平	鄒謅(1)
tsɤu上	走
tsɤu去	奏揍
tsʰɤu平	搊愁
tsʰɤu上	瞅
tsʰɤu去	湊
sɤu平	搜艘餿
sɤu上	嗾擻
sɤu去	瘦嗽(咳~)
tʂɤu平	周舟謅(2)州洲粥妯
tʂɤu上	肘掫□(脾氣~,倔)
tʂɤu去	晝宙咒
tʂʰɤu平	抽綢稠仇
tʂʰɤu上	醜
tʂʰɤu去	臭
ʂɤu平	收
ʂɤu上	手首守
ʂɤu去	獸受壽售
ʐɤu平	柔揉
ʐɤu去	肉
kɤu平	勾溝鉤
kɤu上	狗垢
kɤu去	購構夠
kʰɤu平	摳眶
kʰɤu上	口
kʰɤu去	叩扣寇
xɤu平	黝侯猴瘊
xɤu上	吼
xɤu去	厚後候
ɤu平	歐區毆
ɤu上	藕偶嘔
ɤu去	慪

pian平	編鞭邊蝙
pian上	貶扁匾
pian去	辯辨變便辮遍
pʰian平	偏篇翩便(~宜)
pʰian上	諞
pʰian去	片騙
mian平	棉綿眠
mian上	免娩勉緬
mian去	面
tian平	掂顛癲
tian上	典點
tian去	店墊佃殿電踮
tʰian平	天添填田甜闐
tʰian上	舔腆
lian平	廉鐮簾聯連蓮憐
lian上	臉
lian去	斂殮戀練鏈
tɕian平	尖殲監兼搛間(空~)艱奸堅肩
tɕian上	減堿檢儉簡揀剪繭
tɕian去	鑒鑑艦漸劍間(~斷)犍件濺賤腱健建鍵薦見
tɕʰian平	鹐簽謙遷乾箋千牽鉛鉗潛錢前
tɕʰian上	淺
tɕʰian去	欠歉
ɳian平	蔫年
ɳian上	碾攆撚
ɳian去	念
ɕian平	仙杴鮮掀鍁鹹(2)銜嫌閑弦
ɕian上	險顯
ɕian去	陷餡限線羨憲獻現縣
ian平	淹煙胭巖炎鹽閻嚴言延研掩
ian上	眼演魘
ian去	驗厭艷焰釅雁諺硯燕嚥宴

liaŋ平	良涼量糧梁粱
liaŋ上	兩
liaŋ去	亮諒涼(~一下)輛量(容量)
tɕiaŋ平	將(~來)漿姜韁礓疆江豇
tɕiaŋ上	蔣獎槳講耩(~地)
tɕiaŋ去	醬獎(大~)匠降(下~)犟
tɕʰiaŋ平	槍腔(~調)墻強
tɕʰiaŋ上	搶
tɕʰiaŋ去	嗆
niaŋ平	娘
niaŋ去	釀
ɕiaŋ平	相箱廂湘鑲香鄉詳祥降(投~)
ɕiaŋ上	想享響餉
ɕiaŋ去	象像橡向項
iaŋ平	央秧殃羊洋陽楊揚
iaŋ上	養癢仰
iaŋ去	樣漾

pia平	蹁(~跟頭,跌跤)揙(甩)
pʰia上	□(兩腿左右分開伸開)
mia平	咩
tɕia平	家傢嘉痂加佳夾裌甲(盔~)胛(~拐子,肩膀)
tɕia上	假(真~)賈(姓)
tɕia去	假(放~)架嫁駕價
tɕʰia平	掐恰洽
tɕʰia上	□(跨;邁)卡(頭髮~子)
ɳia上	□(~人家,他)
ɕia平	蝦霞匣俠峽轄
ɕia去	夏廈(~門)下(~火)
ia平	鴉丫鴨押壓牙芽衙軋
ia上	雅啞
ia去	亞訝

piau平	標膘彪
piau上	錶表婊裱
piau去	鰾
pʰiau平	漂飄嫖瓢
pʰiau去	票漂(~亮)
miau平	瞄矛(~子)苗描
miau上	秒
miau去	妙廟
tiau平	刁貂雕叼
tiau上	屌
tiau去	釣吊掉調
tʰiau平	挑(~水)條調(~和)
tʰiau上	挑(~戰)
tʰiau去	跳
liau平	聊僚嘹遼
liau上	燎了(~結)
liau去	料尥廖鐐撂
tɕiau平	教(~書)膠郊交椒焦蕉嬌驕澆
tɕiau上	絞攪鉸狡餃
tɕiau去	教(~育)酵校(~對)覺窖轎叫
tɕʰiau平	敲繰(~邊)鍬悄喬橋僑
tɕʰiau上	巧
tɕʰiau去	俏竅撬
ɳiau上	咬鳥
ɳiau去	尿
ɕiau平	消宵硝銷逍蕭簫
ɕiau上	小曉
ɕiau去	孝效校(學~)笑鞘
iau平	要(~求)腰妖邀幺(~二三)吆搖謠姚窯
iau上	舀(~水)
iau去	靿要(重~)耀

piɤ平	憋鱉別
piɤ上	癟
piɤ去	□(迸裂)
pʰiɤ平	撇撇(雨~)
pʰiɤ上	□(~斷,折斷)
miɤ平	滅蔑
tiɤ平	爹跌疊碟跌蝶
tʰiɤ平	貼帖鐵
liɤ平	列烈裂獵
liɤ上	咧
tɕiɤ平	階皆接結捷傑節截潔揭接
tɕiɤ上	姐解(~放軍)
tɕiɤ去	借介界械戒屆
tɕʰiɤ平	切妾竊茄□(銜)
tɕʰiɤ上	且
tɕʰiɤ去	褯笡(~坡子)
ɳiɤ平	苶捏聶鑷孽
ɕiɤ平	歇蠍楔斜邪脅泄協血
ɕiɤ上	寫
ɕiɤ去	瀉卸謝解(姓)
iɤ平	椰噎頁葉業液爺
iɤ上	野也冶
iɤ去	夜

tiɤu平	丟
liɤu平	溜流硫榴留瘤劉六
liɤu上	柳綹
liɤu去	餾遛
tɕiɤu平	揪鳩鬏鬮糾究
tɕiɤu上	酒九久韭灸
tɕiɤu去	就救舊蹴(~縮)
tɕʰiɤu平	秋鰍囚丘蚯求球仇(姓)毬
ɳiɤu平	牛
ɳiɤu上	紐扭鈕
ɳiɤu去	謬
ɕiɤu平	修羞休
ɕiɤu上	朽宿(~夜)
ɕiɤu去	秀繡銹袖
iɤu平	尤優憂悠由油郵遊
iɤu上	有友
iɤu去	又右佑幼釉

piŋ平	賓彬冰兵
piŋ上	丙餅
piŋ去	殯鬢病倂並
pʰiŋ平	拼貧憑平坪萍屏瓶
pʰiŋ上	品
pʰiŋ去	聘姘
miŋ平	民明名鳴銘
miŋ上	閔敏皿
miŋ去	命
tiŋ平	丁釘(鐵~)叮
tiŋ上	頂鼎
tiŋ去	錠釘(~住)訂定
tʰiŋ平	聽廳亭停廷庭
tʰiŋ上	艇挺
tʰiŋ去	停(~牌)
liŋ平	拎林淋鄰鱗靈零鈴伶
liŋ上	檁領嶺
liŋ去	令另
tɕiŋ平	今金禁(~不起)襟斤筋巾津睛晶驚京經精
tɕiŋ上	境錦僅侭(~前)緊井警
tɕiŋ去	禁(~止)盡近進晉勁靜敬竟鏡凈
tɕʰiŋ平	侵親琴秦勤芹清輕青蜻情晴
tɕʰiŋ上	寢請傾
tɕʰiŋ去	親(~家)慶清(凝固)
niŋ平	凝寧擰
niŋ去	硬寧(~可)
ɕiŋ平	心辛新薪興(~旺)星腥行形型刑
ɕiŋ上	醒擤省(反~)
ɕiŋ去	信興(高~)幸姓性
iŋ平	音陰淫銀寅因洇鸚櫻英應鷹蠅迎贏營
iŋ上	引蚓隱濦影飲(~酒)尹
iŋ去	印飲(~馬)窨映應(響~)

pi平	屄筆鼻
pi上	比秕鄙彼
pi去	蓖篦閉箅(爐~子)髀(~石)蔽幣斃備潷碧必畢被(~臥，被子)
pʰi平	批砒□披皮疲琵匹脾劈僻
pʰi上	□(~叉,兩腿向左右或前後伸直坐於地上)
pʰi去	屁
mi平	咪瞇迷彌縻(~子)秘密蜜
mi上	米
ti平	低羝滴笛迪敵
ti上	底抵牴
ti去	帝弟第遞地
tʰi平	梯題提蹄踢剔
tʰi上	體
tʰi去	替剃
li平	離籬璃犁梨黎剺(用刀劃)立粒歷力瀝
li上	禮李裏鯉理
li去	利痢荔吏例厲勵麗
tɕi平	雞饑肌幾(茶~)基機及擊激鯽集輯急級芨吉極脊籍給(供~)績
tɕi上	擠幾(~個)己蟣
tɕi去	技妓紀記濟劑際祭寄忌既季系(~扣子)計繼
tɕʰi平	妻淒其欺齊臍奇騎芪祁旗棋麒七漆戚乞
tɕʰi上	啟企起杞豈
tɕʰi去	氣汽棄器砌契去(來~)
ɳi平	泥尼倪逆
ɳi上	妳
ɳi去	膩
ɕi平	西希稀嘻息熄錫析夕習媳席蓆吸媳
ɕi上	洗喜
ɕi去	細戲
i平	醫衣依宜儀移姨胰揖一乙溢憶億益譯易(交~)疫役
i上	蟻椅倚已尾(~巴)
i去	藝誼義議意異肄易(難~)

tsɿ平	資姿孜(~然,一種調料)支枝脂芝只(~有)指(~甲)
tsɿ上	紫姊子旨止址趾紙指(~示)
tsɿ去	自字誌痔
tsʰɿ平	□(用水~,用水衝擊)瓷垐(~實,結實)慈磁詞祠辭遲
tsʰɿ上	此齒□(擦抹)
tsʰɿ去	刺賜次伺飼翅
sɿ平	思絲司私斯撕廝時施師獅屍詩氏
sɿ上	死史使駛屎
sɿ去	四肆似寺是示視士仕柿事試廁(茅~坑,茅厠)

tʂʅ平	知隻(一~,兩~)汁直值執侄植織殖質
tʂʅ去	治智置痣制致
tʂʰʅ平	癡池持赤斥尺吃
tʂʰʅ上	恥
ʂʅ平	什十拾食石識適室飾釋
ʂʅ去	世勢誓逝
ʐʅ平	日

tʂuai上	轉(~牌子)
tʂuai去	拽
tʂʰuai平	揣
tʂʰuai去	踹膪(~皮)
kuai平	乖
kuai上	拐□(坏)
kuai去	怪
kʰuai平	塊
kʰuai上	快會(~計)筷
xuai平	淮懷槐
xuai去	壞

tuan平	端
tuan上	短
tuan去	椵緞段斷踹(《廣韻》“換韻丁貫切:足踹”)
tʰuan平	團
nuan上	暖
luan平	鑾欒□(胡説)卵
luan去	亂
tsuan平	鉆(~研)
tsuan上	□(髮髻)
tsuan去	鉆(穿孔)攥
tsʰuan平	汆櫕
tsʰuan去	竄竄
suan平	酸
suan去	算蒜
tʂuan平	專磚
tʂuan上	轉(~吿)
tʂuan去	傳(~記)轉(~圈)
tʂʰuan平	川穿傳椽船
tʂʰuan上	喘
tʂʰuan去	串
kuan平	官倌棺觀(參~)關冠(衣~)
kuan上	管館
kuan去	貫灌罐觀(道~)冠(~軍)慣
kʰuan平	寬
kʰuan上	款
xuan平	歡還(~原)環
xuan上	緩
xuan去	喚換幻

tʂuaŋ平	莊裝妝樁
tʂuaŋ上	奘
tʂuaŋ去	狀壯
tʂʰuaŋ平	窗瘡床
tʂʰuaŋ上	闖
tʂʰuaŋ去	創撞
kuaŋ平	光
kuaŋ上	廣
kuaŋ去	桄逛
kʰuaŋ平	筐匡狂
kʰuaŋ去	曠眶框況礦
xuaŋ平	黃簧皇蝗凰蟥
xuaŋ上	謊晃幌
xuaŋ去	晃(~搖動)

tsua平	□(做啥)
tʂua平	抓髽
tʂua上	爪
tʂʰua平	欻
tʂʰua上	□(捋、擼)
kua平	瓜刮
kua上	寡剮
kua去	卦掛褂蝸(~牛)
kʰua平	滉誇
kʰua上	侉垮
kʰua去	跨胯
xua平	花華鏵劃滑猾
xua去	化華(~山)話畫劃(計~)

tuei平	堆
tuei上	□(撞擊)
tuei去	隊兌對
tʰuei平	推
tʰuei上	腿
tʰuei去	退蛻
luei平	雷擂
luei上	累(積~)壘磊屢□(坍塌)
luei去	累(連~)類淚
tsuei上	嘴
tsuei去	最罪醉
tsʰuei平	催摧崔炊
tsʰuei去	脆粹翠
suei平	雖綏尿隨隋
suei上	髓
suei去	碎歲穗
tʂuei平	追錐椎
tʂuei去	綴贅墜縋
tʂʰuei平	吹垂槌錘
kuei平	閨規歸龜
kuei上	鬼詭軌癸
kuei去	桂跪櫃貴
kʰuei平	盔虧魁奎逵
kʰuei上	傀
kʰuei去	潰愧
xuei平	灰恢揮輝徽回茴
xuei上	悔毀潰(~膿)
xuei去	賄晦會繪惠慧彗諱匯

tuɤŋ平	敦墩蹲東冬犜(癲~癡呆)
tuɤŋ上	盹董懂□(攪(亂、髒))
tuɤŋ去	盾頓燉洞棟凍動
tʰuɤŋ平	屯通同銅桐童
tʰuɤŋ上	筒桶捅統
tʰuɤŋ去	褪痛
nuɤŋ平	膿
nuɤŋ去	嫩弄
luɤŋ平	崙輪掄隆龍農聾籠
luɤŋ上	隴壟攏
luɤŋ去	論
tsuɤŋ平	尊遵綜宗蹤鬃
tsuɤŋ上	總
tsuɤŋ去	粽縱
tsʰuɤŋ平	村皴存聰匆蔥囪從叢
tsʰuɤŋ去	寸
suɤŋ平	孫松慫
suɤŋ上	損筍榫
suɤŋ去	遜(托克~,地名)送宋訟頌誦訴(告~)
tʂuɤŋ平	中忠衷終鐘
tʂuɤŋ上	準種(~類)腫
tʂuɤŋ去	重(輕~)中(射~)眾種(~樹)
tʂʰuɤŋ平	春沖充唇純重(~複)蟲
tʂʰuɤŋ上	蠢寵
tʂʰuɤŋ去	沖(~子)
kuɤŋ平	公蚣工功攻弓躬宮供(~不起)
kuɤŋ上	滾龔鞏拱
kuɤŋ去	棍供貢共
kʰuɤŋ平	昆坤空
kʰuɤŋ上	捆孔恐
kʰuɤŋ去	困胭控空(~缺)
xuɤŋ平	昏婚葷渾餛轟揈烘洪紅訇(阿~)
xuɤŋ上	哄(~騙)
xuɤŋ去	混

tuɤ平	多奪掇
tuɤ上	朵躲
tuɤ去	舵馱(~子)剁垛
tʰuɤ平	拖駝馱脫詑托
tʰuɤ上	妥
nuɤ平	挪諾
luɤ平	啰(~嗦)羅鑼籮騾腡蘿洛落駱
luɤ上	裸摞糯
tsuɤ平	撮嘬昨鑿作(工~)
tsuɤ上	左
tsuɤ去	坐座作(~文)
tsʰuɤ平	搓矬
tsʰuɤ去	挫銼措錯
suɤ平	唆梭縮嗍
suɤ上	所鎖嗦瑣
tʂuɤ平	拙桌卓捉著(~落)鐲濁
tʂʰuɤ平	綽戳
kuɤ平	鍋郭國
kuɤ上	果裹馃□(給我)
kuɤ去	過
kʰuɤ平	擴闊括廓
xuɤ平	豁(~口)劐活獲或惑
xuɤ上	火夥
xuɤ去	貨禍和(~麵)

pu平	不醭
pu上	補
pu去	布佈怖部步
pʰu平	鋪(~設)撲
pʰu上	蒲葡脯捕菩譜圃普樸
pʰu去	鋪(店~)
mu平	模(~子)木目穆牧苜謀
mu上	母姆拇畝牡某
mu去	墓募暮慕
fu平	夫膚跗孵麩符扶芙浮福服伏茯袱腹復復書梳蔬舒輸殊叔熟淑贖屬
fu上	府斧腐輔暑署薯
fu去	父付附富副婦負恕數豎樹漱術述
vu平	烏汙巫誣吳蜈無屋物勿如儒辱褥入
vu上	五伍午武舞摀乳擩
vu去	悟誤惡(厭~)霧戊
tu平	都(首~)督獨讀毒犢
tu上	堵賭肚(豬~)
tu去	肚(腹部)杜妬度渡鍍
tʰu平	禿突徒屠途圖
tʰu上	土吐(~痰)
tʰu去	吐(嘔~)兔唾(~沫)
nu平	奴
nu上	努
nu去	怒
lu平	盧廬鹿祿錄陸
lu上	魯滷虜
lu去	路賂露(~水)
tsu平	租卒足
tsu上	祖組阻
tsu去	做
tsʰu平	粗促族
tsʰu去	醋
su平	蘇酥俗速肅宿□(閃躲;哄騙)
su去	素訴(~說)塑嗉
tʂu平	豬蛛株朱硃珠竹築燭囑軸
tʂu上	煮主拄
tʂu去	著助駐註住註蛀祝
tʂʰu平	初除鋤儲廚出
tʂʰu上	楚處(相~)礎杵鼠帚
tʂʰu去	處(~所)畜(~牲)
ku平	姑孤箍估軲骨汩谷
ku上	古股鼓
ku去	故固雇顧
kʰu平	枯窟哭酷
kʰu上	苦
kʰu去	褲庫
xu平	呼忽湖狐壺葫乎楜(桃~兒)
xu上	虎
xu去	戶滬互護

tɕyan平	捐娟鵑
tɕyan上	倦
tɕyan去	圈(豬~)眷卷(書~)倦
tɕʰyan平	圈(圓~)泉全拳權顴蜷
tɕʰyan上	犬
tɕʰyan去	勸券
ɕyan平	軒宣旋玄懸
ɕyan上	癬選
ɕyan去	旋(~喫~做)楦(鞋~)鏇
yan平	冤鴛員圓緣袁轅園援原源
yan上	遠
yan去	怨院願

lyɤ平	略掠
tɕyɤ平	撅(~折)絕掘橛決訣倔嚼腳鐝覺角(2)
tɕʰyɤ平	缺瘸怯雀鵲卻確
ɕyɤ平	靴薛削學雪穴血(2)恤
yɤ平	曰約悅閱月越粵躍藥嶽樂(音~)虐鑰

tɕyŋ平	軍君均菌
tɕyŋ去	俊駿郡
tɕʰyŋ平	群裙瓊窮
tɕʰyŋ上	□(~~子,食品)
ɕyŋ平	熏薰勛尋荀巡兄兇胸匈雄熊
ɕyŋ去	訊迅訓
yŋ平	暈勻雲耘擁
yŋ上	隕永泳勇
yŋ去	韻熨運暈(~車)孕用傭

ly平	驢律綠率
ly上	呂旅
ly去	慮濾
tɕy平	駒拘居車(~馬炮)桔菊鞠局
tɕy上	舉
tɕy去	巨拒距聚據鋸鋸具句
tɕʰy平	蛆趨區渠瞿麯曲(~折)屈黢
tɕʰy上	取娶曲(歌~)
tɕʰy去	去(~皮)趣
ɳy上	女
ɕy平	須需籲虛噓徐旭畜
ɕy上	許
ɕy去	序敘緒絮續
y平	淤迂魚漁於虞愉孟愚域育玉獄欲浴
y上	語羽禹宇雨
y去	禦與譽預遇

