m̩2	毋
m̩3	母
tsɿ1	氐𢎮（氐）祇胝秪疷知𢇻（知）𥎿（知）蜘䣽䝷鼅䵹呲鴜䳄嫢鮆媊惢𨚖㠿姕㰣鄑齊䖪貲鈭髭𦺱頾頿𪕊訾厜纗㭰觜鶿鷀+仔孖孜茲𦱳（茲）茊（茲）𢆶（茲）兹嗞嵫孳𡥝（孳）滋𣳯（滋）𦱳（滋）稵鼒鎡鰦𪑿𩆂蒫齎次（次且）咨姿𣳩粢資諮澬𩄚齍𪗉𧞓𪗋茬甾菑𠙹（菑）𠙾（菑）𠚀（菑）䊷䣎淄葘椔湽䎩𦸜緇輜輺錙𥀜鍿鯔鶅甾齜眵䡋氏（月氏）支𠦙（支）𢺶（支）只（章移切 專辭）𠮡（只）卮巵汥枝㲍肢栀胑㽻衼衹㩼𥾣梔𨈛䧴禔馶榰𧌔㯄鳷𪂅𩍲疻觶𧣄（觶）砥栺祗祬（祗）脂䓜㴯𥁼鴲鮨䱈（鮨）汦疻之㞢芝臸#膱#䐈諸（限 氏也）𢒕（諸）#指（限 戒~子）#𢫾（指）？事
tsɿ2	？吱子
tsɿ3	𧩼徵𢾷（徵）𢽠（徵）𡈼（徵）𢽡（徵）㨖夂黹𢾫㨖𧛢㨖茈跐訿㧗呰啙紫𣸆訾仔子𢀈（子）𢀉（子）𡐫（子）𣕓（子）㜽杍秄耔虸籽梓姊𡛷秭跐㧗𠂔胏笫䔂滓厎砥祁旨𠮛（旨）𤮻（旨）𣅌（旨）𠩊（旨）茋指𢫾（指）恉䛗酯𧿲厎止阯址芷沚洔茝趾畤坻砥恀只𠮡坁扺帋汦抧𣲵枳咫紙軹䅩䳅#祇
tsɿ5	知𢇻（知）𥎿（知）智𥏼（智）𣉻潪𢐂置𦌤（置）𦋽（置）𦋲（置）𦌃（置）褫踶陊徥䊓褆杝阤豸傂廌𢊁䚦秲洔庤歭畤㣥痔跱雉𨿘（雉）𪁩（雉）滍薙遟謘治乿（治）𠊷稚𢴧稺緻𦃘𩋩𦥐𩹈値值植治乿（治）㨁𠍜積㰣𦎸𧂐恣𣣌次（楡次）骴髊㧘眥胔漬𣿙洓（漬）㱴𦎸嫉自𦣹（自）孖孳𡥝（孳）芓字𡥜（字）𥤪（字）茡牸事叓（事）𠭏（事）椔鶅剚倳胾𤿙𧙁伎伿𢻈㩼忮䚳寘塡支（~註）𠦙（支）𢺶（支）𡽆觶𧣄（觶）識𧨺（識）織𥿮（織）綕（織）𦁓（織）𦁋（織）志𢗍（志）䓌娡痣誌鴲至𦤳（至）𦤴（至）𦤵（至）𡊏（至）𢄢𡠗摯𩊞𩊝懥贄䥍（𨬝之譌）質礩鷙䲀熾𧹹（熾）𤎷（熾）㿃銐蹛璏𦭮彘滯𩻼迣䀸𢝃晢淛𠛐制𠜔（制）𠝦（制）𠝁（制）狾㝂𦜗𥍭䇽䎺製䭁䩢𤴟䱥子（愛也）㜽（子）𢀈（子）𢀉（子）𡐫（子）𣕓（子）𣱐𨎌𦤶致㨖輊疐駤䞃懥𢷐懫𡒐（懫）𡏸（懫）騺𨆫𨇈躓
tsʰɿ1	笞痴癡齝抬瓻𥭘絺訵郗脪辴摛𡴥㷰螭魑𩳩（魑）彲黐誺離离𨌅𡰾趀𧠵𧾒𡳠蠀郪趑𦍧雌䧳（雌）䳄姕鈭𦙼胔差𢀩（差）縒𪙉嵯颸輜妛蚩𦐉嗤媸𥉍𣍆𨒬𨾦鴟𩶅鵄𧪡胵眵䌳
tsʰɿ2	池她䪧馳𧂓（馳）趍踟倁踶篪䞾䶔䶵褫誃簃傂岻蚳𧎪𧏁𧏁𧏔貾𡎰遟墀遲邌（遲）謘彽阺坻莉荎菭泜持莉治乿（治）𨌅？茨垐堲（垐）瓷𥿆餈糍薋𩜴𩆂𧓉齊薺澬䆅呲玼疵骴茈𣐑飺鴜胔慈磁糍濨礠鶿鷀茲𦱳（茲）茊（茲）兹次柌祠𥿆詞𧥝（詞）辝辤辭𤔧（辭）茬茌齹𪙐（齹）？𦳚？𦑡？堤？忯？𣏚？姼？㖷？䈕？眂？提？禔嗣台（嗣）孠（嗣）鍉㮛㔭匙#豉
tsʰɿ3	恥褫祉褫𡳭𧖛玼此佌𠈈泚䳄𧺼𩢑𡘌欼㱀㓼𠟴移杝侈𠈎（侈）垑㢁㶴𧰲㢋袳袲鉹移懘哆𡚼剶鋑鐫朘奀
tsʰɿ5	𡳭杘𣐉訵呬（同訵）跮𦥊𧩼誺䰡𦥊誺眙佁朿刺刾㢀庛莿蛓𧧒䛋㡹次𦮏（次）𠕞（次）𠤣（次）佽𧊒絘𩾔䯸䳐䰍𣣌𧉠蛓螆蚝賜儩𧀩𩜮𢨒饎哆糦埴幟卶痓翅翄𦐊䚢䀸傺䟷𧼪揥慸𨂰𥉻㑜𢘽跇滯掣𢜳痸銐𤸪瘛懘𤢻疵伺廁㥡
sɿ1	䌳虒斯𣂕（斯）㴲榹㒋凘𠗧（凘）禠䔮磃廝㽄燍𥕶蟴䫢鐁𪆁鼶𩆵謕菥蜤㾷螔傂厶㺨私俬𦮺鐁鋖司𤔲（司）思𠂺（思）𡴓（思）𢍄（思）𥄶恖絲楒禗罳㺇蕬噝𥯨緦𦃞（緦）𢆿（緦）鍶鷥偲+伺覗𧕯欐篩簁釃褷襹篩師𠵀（師）𠦵（師）𢂖（師）𩇱（師）蒒獅鰤螄𪗪齝邿呞詩𧥳（詩）䀢䀵鸍𢻫𢻱施𢒃𠇜𠤒絁葹䙾𧠜䗐鍦䌳𪓿𦇲鉈尸屍蓍𦮂（蓍）鳲撕#市（限 拖~子）#事#叓（事）#𠭏（事）#史（限 ~公祠）
sɿ2	漦旹峕時塒溡蒔榯鼭鰣鮨䱈（鮨）
sɿ3	死𠑾（死）𣥴（死）斯矖纚簁籭釃蓰屣縰𩌦躧𩎉史㕜（史）使𡥐（使）𠭆（使）㹬𧳅鉂駛𩰢弛豕𢁓（豕）𧰧（豕）𡰯（豕）阤矢𠓡（矢）𠂕𥬘屎𦳊始𠃭（始）乨（始）兘（始）𠙉（始）
sɿ5	峙思（慮也悲也道德純備也）恖（思）𠂺（思）𡴓（思）𢍄（思）笥覗亖四𦉭泗柶牭肂肆𦘨（肆）𢑨（肆）駟𧳙𩬶蕼𨽼㣈𠮇（㣈）𦞤鈶似𠚦（似）巳汜佀𢻰泤祀𥛴（祀）姒㚶（姒）𦓨𥘰洍耜𪊍禩已攺䒨兕𠒃𠒅𧰽𧱅羠薙食（飯屬也糧也以食與人也）𩚃（食）餐（食）寺孠飤飼士仕𢨪柹枾𣐈柿戺事叓（事）𠭏（事）𩛌襹屣𩌦+使（將命者曰使）+𡥐（使）+𠭆（使）駛𩢲𩰢𣳪𧳅𨽄𥾩俟𢓪涘竢𥏳騃姼氏𤜣是𣆞（是）昰恀䟗徥踶諟媞褆市恃鈰畤眎眡視𥄙（視）𥄚（視）𥅭（視）𥉙（視）𤋇（視）𢻃䩃䊓鯷𢐂醏𩜼眂眎視𥄙（視）𥄚（視）𥅭（視）𥉙（視）𤋇（視）嗜呩（嗜）𨢍𩝙蒔侍秲卶翨施𢒃𠇜𠤒䗐鍦𤖻㒾䧴馶僿弑弒試屍䛈？𤜣？𦧇？舐？舓示𥘅（示）眎諡謚貤蔱鎩㡜逝𦚨觢𣂯筮𧻸誓𣂶（誓）銴噬遾澨簭忕拽世卋（世）丗貰勢澌𣠩杫始（方始）𠃭（始）乨（始）兘（始）𠙉（始）佁#水（限 ~門汀 松江音）斯豎（松江音）
pa1	巴芭岜疤㿬蚆笆羓豝吧鈀？盼#八
pa2	？把夫（防無切 語已辭）
pa3	把𢃳
pa5	靶弝垻𧟶覇霸𣍸（霸）壩灞欛耙𧟳笆䇑跁𥝧𦫙𩹏𤝡耙跁#法#佱（法）#𣳴（法）#灋？盼白𦣺（白）𤼽（白）把
pʰa1	蚆吧妑舥𧣃葩鈀𤽉皅
pʰa2	爬琶杷筢妑匍
pʰa3	#派（限 松江音 ~司）
pʰa5	帊帕（集韻普駕切 帕腹）#怕（怖假借）怖悑
ma1	#母#麻#榪#？墨
ma2	麻痲犘㦄𪐎蟆𩔶𪓹嘛𥂓#馬#𢒠（馬）#𩡬（馬）#𢒗（馬）模
ma3	馬𢒠（馬）𩡬（馬）𢒗（馬）䣕獁瑪碼𥧓螞鷌鰢罵模駡母嗎（~啡 英morphine）
ma5	䣕䣖傌䧞禡𢒴（禡）罵㾺駡𧪨驀鬕
ta1	□（tij~）
ta3	#打
ta5	大𠘲（大）爹#盪（限）
tʰa1	它佗他
la1	#喃拖拉（拖俗假借）#垃（俗字 近世松江新音 非）#娜#落
la2	拏拿𧦮𧘽蒘詉笯挐摣南（限 ~無）𡴖（南 限 ~無）𡴟（南 限 ~無）
la3	䋈藞若（俗或書哪 非）𦱡（若）𦱶（若）𧁇（若）
la5	䏧絮若（俗以爲遠指之書音）𦱡（若）𦱶（若）𧁇（若）？那
ka1	迦珈枷痂家𠖔（家）𡩅（家）𡧚（家）笳𧉪袈葭𨔣跏傢猳犌𤠙𣮫豭貑䴥鴐鎵麚瘕幏蟼茄伽（茄）咖
ka2	□（~䳘）
ka3	嘏叚徦斝婽椵榎瘕檟
ka5	瘕架𦙺𢱈𢉤幏個箇个#尬（松江音）？各
kʰa1	㤉𣘟䶗𡤫#揩（限 ~油 松江音）抲
kʰa2	癿□（爭奪）
kʰa3	跒咖（~啡 葡cafe）
kʰa5	㰤疴𠳌𧩶䛩骼髂𩩱？下？丅（下）？𠄟（下）
xa1	谺颬岈疨蚜呀呵蝦鰕
xa2	䠍遐假徦瑕碬蕸赮鍜𩋥䫗䪗騢#還
xa3	㗿覀閜襾
xa5	㗿𧬱呼唬謑煆㙤嚇罅𧫒丅下𠄟（下）暇下𠄟（下）芐
ʔa1	丫𠜲啞㝞椏䃁鴉鵶錏ㄚ
ʔa2	而陑耏咡峏䎠洏栭胹𦓒輀𨼏髵𩰴𦠌鴯鮞𨎪誀陾𣚊兒（詞綴焉每作輕聲）𠒆唲婼？抑何牙𤘈（牙）？乎？虖（乎）
ʔa3	啞瘂𤺘𡭗尒𨒛爾邇𨖹（邇）耳洱䋙鉺駬𪕔也𠃟（也）亦
ʔa5	覀啞襾亞俹埡䢝婭𣇩㰳氬𦜖稏咡洱珥毦衈餌𩱓刵佴㛅䏪䎶䣵誀𦖢眲二弍貳樲髶下丅（下）𠄟（下）
tsa1	䅊𤶠䐒觰𧬅𪗭奓咤查査浾𦳏抯柤喳渣溠樝㪥皻𥡧𤹡齄齇䶥㸙𠌮挓
tsa2	□（昨日合又）
tsa3	觰䋾𥰭厏痄鮓謯槎厏堵赭詐#吒（哪吒）#咱（北語俗字）偺喒𧨿
tsa5	䒲奼膪㓃𨶃哆吒䐒灹奓咤𢕮䅊䖳咋（側駕切 咋語聲）笮溠詐醡𨣮榨𨢧蜡齰乍䄍嗻柘蔗樜蟅䗪鷓炙蚱#柞？祚
tsʰa1	𤵾侘哆㗬叉杈䑡𠞊艖鎈餷靫差𢀩（差）䐤車（源邑東）𠦴（車 源邑東）硨扠
tsʰa2	秅茶𡨀𡝐𡝙䅊搽𤶠𥥸𦛝𨼑𣘻䠧荼梌塗（宅加切 沮洳也）䣝查査猹槎㢒苴楂䶥？昨
tsʰa3	奼姹土㨋䰩奲哆鑔
tsʰa5	侘姹詫𧬮䞣斥厈汊杈衩㣾
sa1	沙砂紗桬㲚痧硰裟魦𩊮鯊髿猞畲畬𤰩（畬）籭
sa2	闍𥍸鍦鉈荼虵
sa3	灑𣶇（灑）䬷𩜉騇
sa5	嗄𠷚（嗄）𣣺沙𦔯𥁹𣝒舍（限 又 ~子）厙？赦？𤆅（赦）涻騇貰䀅
pæʔ7	法佱（法）𣳴（法）灋八扒玐朳㺴捌哵釟𩡩䤢捌㭭拔𥎱菝鈸
pʰæʔ7	叭汃𥐙趴𨋐𪗔
mæʔ7	䀣睰㑻礣䯦𪒜齂𥗥㩢帓帕墨
fæʔ7	法佱（法）𣳴（法）灋琺𥎰姂泛汎颰發𩑛髮𩑱（髮）𤕥（髮）𩠖冹㤄坺拔橃伐茷墢㘺垡栰筏䣹閥罰瞂藅𠲎䑔
læʔ7	㩉㕇垃拉菈搚𤛊𣤊磖𦒆𪇹摺臈搚邋䗶𦅶臘𥀰蠟𦒦鑞𪇹𪙷䶘擸䋵𢈠㻋瓎剌喇𢃴㻝楋揧辢𥈙𢉨瘌辣蝲鬎䶛䓶攋癩糲轢厲癘#藍捺𧗩
kæʔ7	砝蓋𤇁（蓋）䗘䫦𨜴𧪞鉀𪁍嗑閘
kəʔ7	鴿㠷佮匌㭘𢂷𣭝閤鞈韐鮯鉿蛤浩合㪉頜㧁郃
kæʔ7	𢂷鞈韐䀹裌筴夾郟䀫袷跲餄䩡鵊㿓䶢梜𨒇甲𠇚（甲）𡴌（甲）岬玾胛𥑐鉀𩌍𠩘押挾
kəʔ7	#𨞛
kæʔ7	嘎𠜵圿扴恝戛揩㮖鴶秸鞂稭袺𪃈忦砎骱釓磍楔頡尜𪈟𩮁猰擖#莢？軋
kʰæʔ7	甲𠇚（甲）𡴌（甲）䶢掐㓣帢恰𢂿𣁴㡊𠕣䁍狹
kʰəʔ7	趏楬𥴭磍咭劼𠛉葜㓞㓤𢼣𤫶硈䂒𦸉𩮁鬝鬜擖
xæʔ7	㾑欱𣣹㽺𣣹𩵢㽺
xəʔ7	蓋𤇁（蓋）盍𨜴熆篕𧪞闔𨶩嗑㧁㭘搿合䢔盒𡇶𦳬詥耠榙𪘁郃
xæʔ7	呷譀𣢗䛅欱䶎㰰敮䞩+洽䨐陜𩂘（陜）珨峽狹𢈙烚祫陿硤𤲍𪘘匣狎𢘉柙㘡（柙）炠𧆥翈笚舺𦾏𠗉霅
xəʔ7	
xæʔ7	㔠瞎𩮂𪗾𩪲䕸黠䦖砎𡑧𧷎𠢆𢮟𦵯舝𥰶縖轄嗐𤪍鎋𩝛𪗾鶷𧕱
tsæʔ7	嘁唼帀匝迊𠯗沞咂魳䞙䍼噆𣤶遪㜗䟃䵽𥗭囃䣟𨅔韴磼雜䕹雥䪞𢶍劄𧉫𠍹𠗨喋鞢擖霅𤁳偛㞚䙄䀹眨𠰏𥀈䛽𥯦𨖷渫牐煠𧼰䮢𤁢𠛱拶㳨䰖𨀨㩵巀囐𡂐囋眣𥄺（眣）哳𢧖𧶇扎紮札箚㱜蚻𩿤耫㳐鍘𨰉卡（字彙補 從納切 守~）
tsʰæʔ7	𥃐扱𤜯臿插㛼鍤疀㷅笈喢攃擦（俗字）䌨礤䃰擦詧察𣘤䕓檫鑔𩴳𪙻𥉻刹䓭剎柵
sæʔ7	𠦄芔（𠦄）圾𣬬靸𩎕卅𠦃㚫馺颯𢕬趿鈒霅靸卅𠦃𠎷㪪𠿓𩐅𨆂𢶍萐喢歃喋箑䈉𧳛霎攝攃𨐖撒𢴻𠱡𢲳（𢴻之譌）摋𦼧薩𥻦䉈𥷭（䉈）躠帴脎殺𣪩𢁛（殺）𢽅（殺）𢿹（殺）𢽆（殺）𢼡（殺）𢿔（殺）𧤿（殺）蔱榝𣻑鎩煞摋榝扱
paŋ1	㨍幫𨢐鞤縍邦𨚚（邦）邫（邦）垹𤰫梆#傍（又 近也 ~黑）
paŋ3	𣮧榜㮄牓蒡螃䰃氆？紡？縛綁（俗字）𦂌
paŋ5	謗舫螃搒傍徬𢗒玤㭋蚌棒棓䎧蜯
pʰaŋ1	磅鎊雱滂𣂆膀䨦霶芳𤵸肨胮𩐨𪐿𪔔#汎
pʰaŋ2	傍趽方𤙗（方）房彷旁𣃟（旁）𣃙（旁）㝑（旁）𨜷膀䅭螃篣䠙髈騯房舽胮𩐨逢逄
pʰaŋ3	髈耪（俗字）䒍#龐
pʰaŋ5	肨炐
maŋ2	䀮邙芒吂汒忙杗𥐞茫𨛌恾朚𡩩蘉尨厖哤㟌狵浝娏牻𥆙痝蛖駹䵨𠈵#盲（此音不正 當呼如萌）蝱（~牛子）邙芒杗𨛌硭朚鋩
maŋ3	忙㟐莽茻壾漭㬒䁳䒎蟒蠎䥈𠈵𪁪
maŋ5	吂㟐漭
faŋ1	匚𠤬（匚）方𤙗邡坊汸枋牥䄱蚄趽鈁鴋肪芳淓妨#望#𦣠（望）
faŋ2	方𤙗（方）坊鴋防肪房魴#妨
faŋ3	昉昞（昉）瓬倣放匸（放）仿紡髣䲱鶭彷#訪
faŋ5	趽舫放匸（放）𨾔邡+妨𩦠#犯#𤝑（犯）#𢒿（犯）防
taŋ1	當𤱭（當）噹璫𦡁㼕襠蟷簹𨎴鐺檔儅？凙樁#唐（松江音 巷~）#啺（唐）#𣉺（唐）#𡃯（唐）
taŋ3	党擋黨䣣攩𧅗灙欓𥤗讜瓽蕩儻
taŋ5	當𤱭（當）擋瓽儅譡闣愓婸𢠽蕩𥯕䑗璗盪簜嵣潒崵𡇈宕菪逿碭𦿆嵣踼
tʰaŋ1	盪簜𦳝湯蝪羰𧼮薚闛鼞踼鏜倀
tʰaŋ2	碭闛坣唐𣉺（唐）𡃯（唐）堂㙶（堂）棠啺逿傏嵣䧜塘搪蓎䣘溏隚瑭榶𥏬𤚫㼺㲥煻樘磄𤛋膛橖踼螗篖糖赯𨍴醣螳餳糛𨶈䉎鎕餹𩹶鶶𪕹場徜
tʰaŋ3	惝攩𥯕耥踼帑倘偒㼒黨儻戃曭𣎲爣矘㿩？逿
tʰaŋ5	蕩盪湯儻燙𨫖鐋摥
laŋ1	狼浪穰
laŋ2	囔囊𢑿（囊）蠰饢啷郎㟍狼㝗欴琅𤨜（琅）𤦴（琅）蓈桹廊瑯榔硠稂𥍫𦵧筤艆䡙螂（蜋俗字）躴閬鋃䯖駺𪁜𩷕浪莨蜋哴踉𨟚獽瀼禳穰瓤䉴躟𩆶鬤攘𣀮儴勷蘘𧅍（蘘）鑲涳𣰊䁸𦗳譨鬞噥𩟊𪆯瀧䮾
laŋ3	曩灢㝗榔朗𥇑（朗）脼（朗）朖誏崀俍蠰䖆穰躟壤𦦶（壤）攘𣀮（攘）嚷䑋𥗝
laŋ5	灢儾㚂閬埌浪蒗䕞攘𣀮（攘）懹讓𧮨𦦬（讓）欀
kaŋ1	岡𠆼（岡）牨杭缸罡剛𠜛（剛）𠇝（剛）𠇙（剛）堈崗㓻𤭛犅堽綱㭃（綱）𣓡（綱）鋼掆苀迒笐魧亢肛矼𧢸釭杠玒江茳豇䜫扛𢴦
kaŋ3	㽘𨟼䴚䟘港傋耩講
kaŋ5	鋼掆槓（俗字）虹洚𡲣降（古巷切）絳
kʰaŋ1	康𠭳（康）㼹𨻷漮㝩槺𤮊㱂𥉽穅𥹺（穅）䗧糠躿炕（灼也）邟㼹崆涳悾控𤟄椌腔羫𩩝㾤跫鏗
kʰaŋ2	扛
kʰaŋ3	骯慷㝩䡉𡻚忼炕（又音 灼也）懬
kʰaŋ5	蚢頏亢伉邟抗犺炕砊閌鈧𪎵阬囥
xaŋ1	夯㰠䐠忼炕舡肛谾啌𨋪
xaŋ2	肮行苀迒杭斻蚢航𦐄筕頏𨁈魧沆桁胻邟抗亢（抗）吭缻缸夅洚扛栙䜶跭降（戶江反 ~婁）
xaŋ3	酐𤰟汻骯蚢沆䟘𡕬吭傋夯𢞡
xaŋ5	笐吭項缿閧衖巷䣈鬨桁（椸也）
ʔaŋ1	咉㹧姎眏𧲱佒泱殃𥙏（殃）胦䄃鉠霙胦䱀ㄤ
ʔaŋ2	？㟅䒢枊昂㭿䩕䭹卬
ʔaŋ3	䇦盎醠咉泱姎坱軮駚映秧鞅岟炴紻𧵌駚怏柍詇䬬慃䭹
ʔaŋ5	盎醠怏㿮詇䬬枊䭹𡵙
tsaŋ1	匨戕样䍧臧藏贓張弡（張）粻餦漲章鄣蔁獐彰漳慞嫜璋樟暲蟑𩌬麞𪅂障墇箏
tsaŋ3	驡髒駔長镸（長）𨱗（長）𠤐（長）𠑷（長）𠔊（長）𠑻（長）𠑿（長）𡕣（長）𤓯仉掌鞝黨
tsaŋ5	奘弉臧藏匨（藏）奘𨌄臟張弡（張）漲帳脹痮賬丈仗杖㽴長镸（長）𨱗（長）𠤐（長）𠑷（長）𠔊（長）𠑻（長）𠑿（長）𡕣（長）瓺仗障墇嶂幛㢓瞕瘴葬𦽱（葬）𦱼（葬）𧂥（葬）𦿑（葬）
tsʰaŋ1	倉仺（倉）𠥐凔𠖸（凔）蒼𡶍（蒼）𦭆（蒼）滄𣶟（滄）𣳁（滄）艙𩀞鶬傖倀鼚𦳝昌菖猖娼琩裮閶錩鯧倡
tsʰaŋ2	臧藏匨（藏）長镸（長）𨱗（長）𠤐（長）𠑷（長）𠔊（長）𠑻（長）𠑿（長）𡕣（長）瓺㙊萇場腸脹痮䗅䠆常㦂甞嘗嫦鋿嚐償𪄹𩼝？尚？尙
tsʰaŋ3	蒼𡶍（蒼）𦭆（蒼）昶鋹惝敞僘廠𢠵氅𪅶䟫#場（俗又音）
tsʰaŋ5	昶鬯悵𥇔暢畼𥠴䩨𧀄韔廠昌倡唱𪛋淌
saŋ1	桒桑𣕐（桑）𠭌（桑）喪𡂤（喪）𡴧（喪）𡂧（喪）𦦦（喪）𡚏（喪）𠸶𦅇𩦌塲𤳈㲽商𡅟（商）𠾃（商）𡂦（商）𠿧（商）𡃬（商）𡄚（商）𠹧（商）傷蔏慯殤𧶜熵𥏻螪觴𪄲䵼湯饟禓䵮𣝻鬺𩰱
saŋ2	腸脹痮償裳
saŋ3	搡嗓磉𣞙顙𣡆上𠄞（上）丄償（集韻又音）晌（俗字）賞扄𩞃𩞧饟曏
saŋ5	喪𡂤（喪）𡴧（喪）𡂧（喪）𦦦（喪）𡚏（喪）𠷔𠸶償丄上𠄞（上）尙尚緔蠰傷慯𤵼餉𩜋（餉）饟向珦曏蟓搡
paʔ7	博搏㗘猼愽䙏䗚䍸簙鎛餺𩌏髆𥴮欂襮𧟊（襮）䶈鑮𪙍溥薄（傍各切 迫各切）礴礡䭦亳鉑箔鑮𩍿𩽛踄簿縛𦢊㿺趵爆𧭤謈剥剝𠚪（剝）𣀛𣀛𥭖駁𩐟駮髉䑈𪇰肑嚗#柏（~油又音 源松江）雹𩅟（雹）𩆗（雹）𩇌（雹）
pʰaʔ7	𦢸胉薄（匹各切）搏膊𥴮濼粕奤𦥭𦐦蒪𦿍𩔈䪙䨰𩅿颮㩧鞄攴𢪊釙謈𧴤𤆝圤㺪墣璞朴𥛟樸㹒窇雹𩆗（雹）𩇌（雹）𥭓䈏𦢊𩅟骲瓝瓟㼎䮀𩣡豰㩧懪犦𩺽跑謈泊𢷏怕（白各切 通泊 憺怕）#杷（限 枇~）
maʔ7	鄚摸膜莫𦮅（莫）䒬（莫）𦱴（莫）𠢓塻嗼𡈗𢊗漠寞𣩎瞙瘼鏌幕皃眊𥉗瞀𢷕藐邈㦝瞐𦋹毣#沬#湏（沬）脈（來龍去脈）？陌
faʔ7	縛（又）
taʔ7	㤞度𡧪（度）㡯（度）仛剫喥𩑒𢜬凙𨍏踱𧩧䐾鐸𩍜襗？拓？摕（拓）涿（說文流下滴也  一~水）特
tʰaʔ7	魄霸（魄）舄舃乇托侂𠊴斥沰託袥飥馲魠𩧐橐𡇈（橐）庹拓摕（拓）柝𦚈𣔳𨂫𣟄籜蘀矺？喥
laʔ7	諾喏（諾）鍩袼挌硌鉻䶅駱烙酪咯詻橐轢𤻲㓢各洛格洜（洛）珞𣧳䀩𤽥路落笿絡𤽼𩂣雒𩊚𣛗鮥鵅濼𨏒𧭥𪇱馲𩧐樂爍躒餎溺（奴歷切 昵角切 而灼切）㲻（溺 奴歷切 昵角切 而灼切）惹叒若𦱡（若）𦱶（若）𧁇（若）鄀弱楉搦蒻𨀝箬䐞掉搙𧢺𧣺䚥䃕犖𡁆貉
kaʔ7	咯胳袼擱格（樹枝也）閣各腳（限 新 ~色）梏䮤角較斠玨珏𤤴捔桷䡈傕瑴䁷覺覐（覺）𧠭（覺）龣搉榷䮸䚫
kʰaʔ7	恪㤩愙觳毃殼𡇱𡴊埆硞𤿩塙搉愨𣤇碻+確䐨（五音集韻苦角切 皮甲也 又从上擊下也 一曰素也）㲉燩礐㱿嶨𠕓
xaʔ7	狢䅂涸貈䶅䮤佫𠗂鶴貉𥉑豿𩌥滈翯嗀謞㕰𦰾𩌊瀥䤕翯㿥确嶨澩𥀣觷鷽郝鄗鰝蠚嗃㕡𧮸𦞦熇壑矐謞隺
ʔaʔ7	𢙣堊惡悪亞（惡）啞蝁噁（噁噁）䛩龏𦯏偓幄渥媉楃腛𠿟䮸𪑱鷽葯箹咢鄂偔堮萼蕚𦹛𧊜遌㗁崿湂愕㮙𠟎𧍞噩諤鍔顎𡓐𡾙鶚鰐𡅡齶鑩鱷𧍞𧊜
tsaʔ7	鑿𨰒（鑿）迮柞作胙（作）𢓓（作）㘀糳𣫞鑿𨰒（鑿）笮砟柞𢂃㸲莋秨筰鈼𦁎䎰岝怍葃酢飵芍着著鐯擆𣃈𥖛櫡𥗁着著焯繳勺妁彴犳㣿𧘑斫酌禚䅵𥯩䶂謶摭
tsʰaʔ7	縒剒莡厝逪錯䥘（錯）䱜昨𤟭逴辵⻍辶㲋蠚婼鄀踢繛婥淖綽焯（尺約切 魯有孟公焯 非湯中小熱者）斫磭𦁎
saʔ7	索（蘇各切 大者謂之索）𢱢𦵫㮦𩌈溹仢勺芍杓妁汋䟏舃舄獡爍䁻鑠㜰藥𤄶爚踢碩灼
pɛ3	捭擺#廢
pɛ5	扒𢳎拜𣬊（拜）𣬓（拜）𢰛（拜）𢴽（拜）𡴬（拜）𢷎庍㠔敗貝（敗）𤖐（敗）罷矲㔥䥯𢞎𢟡猈䢙𠟻（䢙）敗貝（敗）𤖐（敗）贁唄稗粺𪐄杷𦩋韛𣡖𢞎𢟡𤸶憊㶔韝棑
pʰɛ2	俳排牌輫𩑢猈棑牌𥱼犤䱝郫蠯啡
pʰɛ	□（踐以足）
pʰɛ5	𣎵𣏕𣝁𠂢𣏟派㭛蒎𥿯㵺𣎳湃沸浿啡
mɛ1	#乜
mɛ2	埋薶㦟霾䁲䚑𩍃
mɛ3	買蕒嘪鷶㵋
mɛ5	佅勱邁䜕賣𧷨（賣）𧱘䀛韎𣝖（韎）
tɛ1	懛𪒴呔#嬯#袋（限 口~）
tɛ3	傣等䫂？逮？逯（逮）
tɛ5	迨殆待怠紿軩𠷂𨽿駘䈚詒大𠘲（大）汏𡊌（汏）㐲軑䲦𪐝釱忕逮逯（逮）代甙𤮼岱帒玳埭𥓏𡍖袋瑇黛黱靆隶酨𨠾？汰帶𢄔㯂艜蹛摕蔕跢㿃戴𢨇（戴）##貸（北音）
tʰɛ1	孡胎𧉟𩬠台邰鮐漦？大？𠘲（大）
tʰɛ2	苔炱菭跆臺颱駘䈚儓𩿡擡薹嬯檯籉𪒴
tʰɛ3	㘆紿殆
tʰɛ5	貸曃儓態大（~斧）𠘲（大）太忕汰肽泰夳（泰）酞鈦戻
lɛ1	#賴#𩓃（賴）
lɛ2	㾍能㾢來郲萊逨崍徠猍庲淶棶𤦃𤲓䅘䋱𧳟錸騋鶆麳鯠𪑚𪎂𣮉犛𣀗斄𠩬（斄）唻孻（俗字）？遺
lɛ3	乃𠄎疓𠧤𢏩𢎧氖迺倷鼐唻𨦂
lɛ5	耏佴螚耐鼐𣉘能奈柰萘渿㲡錼𩹟㾢萊逨徠勑睞賚䚅誺䓶賴𩓃（賴）𡂖鵣藾瀨㸊䄤𨇆癩籟䲚犡糲？䐯
kɛ1	㱯䶣侅郂陔垓荄峐姟晐祴絯豥賅該䬵䐩㨟胲剴荄痎階堦喈街湝𦝨稭蝔𩘅鶛䕸𤭧楷𣗀（楷）鍇偕薢街家枷（連~）
kɛ2	？賅
kɛ3	改絠頦解檞薢𠎿
kɛ5	丐匃鈣蓋𤇁（蓋）㧉𠌰摡鈣溉概槩㕢漑槪尬价丯介𠨴戒𢦬（戒）芥㠹㝏玠琾砎畍界疥衸蚧悈䯰𩡺誡䲸魪䁓艐堺解㾏繲薢廨犗𧜅拐箉
kʰɛ1	侅㱾奒闓開（闓乖字）𨴂（開 闓乖字 ）𨵑（開 闓乖字）㚊揩𢔡𥻄𦂄
kʰɛ2	□（旣饜氣出聲）
kʰɛ3	䐩凱塏輆愷暟闓鎧颽𦝨䒓𡢖蒈楷𣗀（楷）𥏪𠢲鍇
kʰɛ5	𨜴𩫀㪡𥎆䳚磕溘愒轄慨闓鎧欬嘅愾喫劾揩烗𤈪𨛖𡢖隑
xɛ1	𨸜㾂咍#懈#𢢣（懈）㰨㗨𢓬
xɛ2	豥㨟孩𧻲䠽䱺頦咳鮭嚡榽慀㥟㨙膎鞋䙎鞵縀骸䓳湝蝔瑎鞋諧𩤠龤
xɛ3	海醢橀𣖻𨡬𥁐蟹？䲒
xɛ5	𤵽餀㺔𦤦𩹄儗侅亥㧡氦𥩲夆害𢞐妎戤㤥劾瀣懈𢢣（懈）欸譮䜕𢗊𡘌㞒㖑噧齂𦤬䜕謑侅絯駭駴㕢解邂衸㳦䦏𤡧薤韰㒠齘瀣䪥解？𨼬？嶰獬？澥
tsɛ1	𢦏𡿧𢦒𤆎灾災哉才（哉）栽烖𦳦渽睵𦸜𢦔災榸𪘨齊亝（齊）齋者
tsɛ3	者宰𡪤（宰）𡨧（宰）𠈾（宰）載𡙺（載）䏁縡#子（每作輕聲）#㜽（子）#𢀈（子）#𢀉（子）#𡐫（子）#𣕓（子）解（舊音）𠏰𤢒
tsɛ5	再𨚵𩛥縡䵧在裁纔栽+載+𡙺（載）在酨𣿐祭𨝋瘵債㾹眦眥
tsʰɛ1	䞗猜偲睵扠搋䞗差𢀩（差）叉芆𠞊靫差𢀩（差）釵㼮𩑐䐤
tsʰɛ2	才𦬁材財㒲（財）裁䴭纔暫溨鼒査柴祡𥚨（祡）𨌅㾹𪗶茈齜㧘豺𡺵儕麡
tsʰɛ3	采採彩㥒寀睬綵跐䰂撮
tsʰɛ5	𣞖蔡𪇭䐆埰菜棌縩䰂蠆慸蔕𧀱杈訍衩差𢀩（差）㳗瘥𧪘
sɛ1	毢揌腮噻䚡顋𪃄鰓愢粞𥳧崽篩籭諰崽#塞（蘇則切）
sɛ2	□(咸)
sɛ3	𩌦躧
sɛ5	曬塞賽簺𢞝砦寨洒𨢦䵘曬汛𠱡閷+殺鎩𧜁
ʔɛ2	崖#冶#言（~話 松江音）#𢍗（言）#𢍬（言）
ʔɛ3	也（亦之誤）𠃟（也）亦𠅃（亦）
piɛ̃1	扳班𤼬（班）般（同班）𦨗（般 同班）斑頒斒𠔯癍辬鯿朌肦鳻螌䰉斒虨攀（俗音 折也）
piɛ̃3	板瓪昄版舨鈑蝂胖#闆
piɛ̃5	湴埿阪昄魬辦瓣釆𤓳（釆）辨
pʰiɛ̃1	扳眅攀𡴂𠬜盼
pʰiɛ̃2	𨂝𤖭淜
pʰiɛ̃3	眅闆
pʰiɛ̃5	盼𥌊盻襻
miɛ̃1	蠻
miɛ̃2	姏䅼鬘𪑪蠻𪈮獌謾樠
miɛ̃3	㛧𩛎錽𡕢𢨔𦺖矕𥇅晚𣆛（晚）
miɛ̃5	𦱏𦲯㾺僈𣍑慢漫（同慢 亦作僈）嫚熳縵謾蔄鬗曼蔓獌澫䡬䝡娩䨲輓㿸卍脕𦂔𨞼蟃贎
fiɛ̃1	䒦𣢲帆𩗋（帆）颿蕃藩轓籓鱕鐇番𥸨（番）𥻫（番）幡翻旛轓𤃳飜𤄫繙+反（平反）+𠬡（反）𤄜
fiɛ̃2	凡柉𦨲𠆩氾番𥸨（番）𥻫（番）墦蕃藩旛笲𥿋棥煩緐樊㺕璠𢶃薠膰燔𥢌繁襎羳𢐲繙蹯籵（蹯）蘩礬𨆌鐇瀿蠜䪤𩐏䮳𧢜𨟄鷭𪖇蟠袢
fiɛ̃3	𦜒釩阪坂橎反𠬡（反）返䡊
fiɛ̃5	姂𠆩氾汎釩䒦泛𥁔䀀犯𤝑（犯）𢒿（犯）范軓笵𧍙範帆𩗋（帆）颿梵反畈販汳𣀔㽹奿㤆𡗹𨠒嬎嬔㪻𠠵娩䪻笲飯軬閞𧉤𥹇飯飰𩚳㶗#乏#𠓟（乏）#番#𥸨（番）#𥻫（番）
tiɛ̃1	襌丹𠁿（丹）㣋（丹）𠕑（丹）單匰鄲㠆殫䐷癉簞
kiɛ̃1	甘𠙸（甘）𠙿（甘）苷泔柑疳䇞𤯎咁媣淦蜬䶃䌠弇𢍔（弇）𥦦（弇）尲瑊緘䌠𪒹黬玪尷監𧨭（監）𧩾（監）譼（監）礛𥌈鑑#咸迀忓玕𤥚（玕）肝㿻竿𢧀𨝌鳱漧干邗汗奸（犯也）乾𠄋（乾）𡯋菅𦭂（菅）葌䔵
kiɛ̃3	䇞𠭖𣪏敢𢽤澉橄感𢦡（感）䃭鱤䤗贛𧆐灨贑㔶𥸡灝堿碱𥳒矸仠𤿊秆衦皯𥾍桿笴稈趕䵟擀𦼮簳靬蕑覸覵閒𨳡（閒）𨳢（閒）柬揀暕簡𥳑㶕𤄒𧟉僴僩
kiɛ̃5	淦紺贛𧆐灨𪉦㔋𥌈𪉦䫡矸杆犴旰盰倝𣵼骭幹榦𧹳𢁗覸襇襉𨣇𧙧覵閒𨳡（閒）𨳢（閒）鐗澗㵎諫𧧅（諫）鐧
kʰiɛ̃1	𤬪𤯌𤯎撖𢦟堪嵁戡𩑟龕㪁坩嵁厱鵮𠔺𢽣嵌靬𣓁刊栞看臤豻馯鬜臤掔慳𩋆顅鬝鬜𧢞羥#鉛凵（集韻又音）
kʰiɛ̃2	銜#鉗#箝
kʰiɛ̃3	凵坎砍（俗字）莰埳惂歁輡顑轗竷臽𥦶錎䖔𠪚撖𢜩㦿𣓅槏歉䫡䫡侃𠈉（侃）衎齦？限
kʰiɛ̃5	𪉿闞𣊟瞰嚂勘轗竷崁䘓𧗀磡𪉯歉䫡靬侃𠈉（侃）偘看衎䳚？艦
xiɛ̃1	蚶𧵊憨𠐣歛嬜𣢺谽𡪶𩈣馠𡬖唅㟏𧮰妗𧍧㰹䩂頇鼾嫨羴#獾#陷
xiɛ̃2	𤯎酣魽邯甝䗣炶煔含肣函𠥴圅梒𤭙晗焓涵𠗴筨𣹢蜬䈄鋡䨡䤴䶃𩄙𢎘頷顄𩔞函㮀椷鹹稴鰜咸㮭輱醎諴𩤥啣銜甉虷邗邯寒𡫮（寒）𡫾（寒）𦺦韓𩏑𧃙汗翰䮧鶾瞯閑閒𨳡（閒）𨳢（閒）蛝憪嫺𥊺癇藖𩦂鷴鷳#降（下江切）#夅（降 下江切）
xiɛ̃3	喊㯺嚂𡒓䫲喊闞鬫欦厂䍑罕䍐蔊焊暵熯灘潬（灘）䓍旱𡷛皔䛞軒限
xiɛ̃5	𧵊䖔蘫𩞿䫲肣涵𢎘𢇞莟菡𢃗淊蜭𡻡撼頷𡣊顄𡣔頜欿憨㺖䗣譀䐄𤎡唅浛琀莟蜭憾䐄㺖豃闞鬫㒈譀喊㺝減甉𡞣㺌𥻇餡豏撖㺝㔋轞𨏊檻壏濫𥽏㯺㽉臽𥦶陷䐄錎餡䱤厂罕䍐漢㵄𣶔暵熯𤳉䎯𡅽𤅩豻忓矸扞鼾𧃙汗㢨垾捍悍㪋閈釬䏷𤿧馯銲螒翰駻雗瀚䮧𩹼㲦捍橌憪僩𤡥硍㹂限䁂䦘骭娨藖莧粯麲
ʔɛ̃1	殷
tsiɛ̃1	篸糌䐶簪兂（簪）𥯓（簪）䍼鐕𥸢撍鵮詀䩇𪉜𥩠站譠㣶
tsʰiɛ̃2	慚㨻慙𩈻䳻鏨
tsiɛ̃3	昝坅寁撍䭕旵𠐩斬嶄攢趲𩯳䰖拃䩆䎒琖盞醆𧣴喒
tsiɛ̃5	篸撍歜䰼㔆㣅嵌槧㟛鏨暫蹔鏨𪉜𣳤站偡湛㴴譧詀賺𧸖𩈻𩅼覱蘸巉瀺嵁嶃嶄䳻欃艬讒鑱䪌儳𨼮䪌攅䟎攢趲𡳋賛鄼濽贊讃灒㜺欑襸𩯳讚饡𩛻（饡）䬤（饡）䰖䟎趲瓉瓚禶𣧻碊䏼𡂐囋㜺瓚穳袒䋎綻孱湔淺㟞濺𣽖棧輚嶘虥轏𠊩䗃驏𪘪棧䗃輚𧮺虥棧𨵊#塹
tsʰiɛ̃1	參𠫰（參）朁（參）傪㜗䟃驂攙飡湌餐䉔喰
tsʰiɛ̃2	䣟𨅔蠶䗝撏攙𢽝獑毚儳酁㺥欃讒饞𪖎𪗂鏨獑毚酁嚵巉艬鑱劖嶃𣦻𣦼㱚殘䏼𥂥戔帴𤣆孱僝潺䡲𨬖孱𡎻潺䡲𨬖
tsʰiɛ̃3	傪㜗慘憯黲朁䫩噆黲䑎䤘醶丳剷㦃䐮鏟剗羼㹽產産
tsʰiɛ̃5	參𠫰（參）朁（參）㽩謲儳嚵摲懺𤮭㺖㛑粲薒璨燦𪆶㬄㾺鏟䴼羼
siɛ̃1	參𠫰（參）朁（參）三弎𢁘叁鬖犙毿蔘髟纔彡芟衫穇縿𩌰摻𩃔𩃢櫼杉䀐𩁺㺑檆𩌰𨏪攕𦙽𦙱𦚻䈀𥮚姍㛽（姍）珊𡜜跚𨀢山邖舢疝𠜂𣧱狦𣧺潸訕汕
siɛ̃3	㧲䊉𢕕糂糝糣䫩槮㨻㺑摻醦𧀵㺑傘𠍘𢄻䉈𥷭（䉈）糤繖鏾饊㪔散枚（散）𢿨𣀧𢽳產産嵼滻㦃㹌簅𩥮𥽽摌
siɛ̃5	`+三（再三）弎（三）俕㤾閐䫅䀐釤㣌帴䈀𥮚繖𦇕散枚（散）𢿨𢿱𣀧狦疝訕䴮赸𦌔柵
piɛ̃5	扮
sæʔ7	啑㞚唼帹翜𧻵翣䬊𧲌
pən1	奔賁犇錛䴅
pən3	本楍（本）㮺（本）𡴡（本）苯㡷畚𤲙笨
pən5	奔犇（奔）逩笨㨧獖夯体坌𣴞糞𥼇（糞）𥼈（糞）𥻔𥻎𡐢𡏙坋𡓴𣀰𡏰粪𢹔拚𡊄𥼢𥻪𥼯𣀰𡊅
pʰən1	噴濆歕
pʰən2	盆葐湓𪂽
pʰən3	翉
pʰən5	+噴湓+歕
mən1	#悶
mən2	樠䟂𪈿門捫璊𣯩鍆䫒䊟𤅣虋們怋亹
mən3	懣本楍（本）㮺（本）𡴡（本）
mən5	悶燜懣璺
fən1	扮分匪吩𣯻餴饙𡊄砏芬𢁥㞣氛𣬩衯紛棻酚雰𨷹錀𦐈
fən2	頒賁䫶㞣妢氛棻𣱦汾枌盼朌肦蚡羒梤𧮱棼焚燔（焚）𦶁馚蕡鳻魵燌鼢鼖羵轒豶鐼䩿馩䴅墳𡏶（墳）橨𪔵濆葐
fən3	扮粉黺魵忿
fən5	𡊅僨𥻔奮㱵糞𥼇（糞）𥼈（糞）𥽒瀵拚魵忿瀵湓扮蚡魵鼢轒坋弅墳𡏶（墳）憤膹㿎𢅯𢤬鱝分份坋秎㿎𢅯+粉（飾也）𥻎𡐢𡏙坋𡓴𣀰𡏰粪𢹔𡊄𥼢𥻪𥼯𣀰
tən1	登𤼪（登）𤼷（登）䔲噔璒燈㽅㲪竳簦䳾豋𧯭𧰍㢯弴惇𥫉（惇）𤭞敦𢼪（敦）𠧈（敦）墩噸礅驐箏#魨#燉
tən3	等戥
tən5	橙隥凳嶝磴鐙𩞬𧄼𧀆蹬僜鄧𣩟䮴幐𢻴扽敦𢼪（敦）𠧈（敦）頓炖砘鈍𩔂鶨屯
tʰən1	膯𤃶鼟𧰥吞燉噋涒暾黗𧑒𪏆
tʰən2	幐滕𥉋螣縢謄藤𢟱儯騰𤻴籐鰧𧈜邨燉沌屯芚㹠庉忳𡱂𤫭軘豘豚飩肫𥸵𪌋𦞠𪎶魨臀𥴫𩪡坉窀啍純𠄤（純）㝄（純）#疼
tʰən3	吨黗氽𤊯畽
tən5	𤃶沌盾𥫱囤庉坉㡒
tʰən5	遁𨔡（遁）𨘹（遁）𨙆（遁）遯褪㧷
lən2	犉𩀋瞤眴
lən2	能塄棱楞稜倰祾輘耳艿扔仍辸㭁礽䚮𠽽𤕦𠹣（𤕦）獰㲰𧂘𥣗鬤儜薴嬣𧭈鑏䭢鬡䋻䛘鵀紝恁壬䛘銋鵀任紝黁掄菕崘崙論亻儿人𠔽（人）仁忎（仁）𡰥（仁）朲掄侖倫陯圇淪惀棆蜦䈁䑳綸輪踚鯩論
lən3	能檸冷拰恁銋𢆉荏栠棯稔䭃䏕䏯（䏕）袵䇮飪𦜙（飪）腍餁㶧睔㤻惀碖忍荵涊耣𦓾𣯍蝡#紉
lən5	踜愣倰㱥認扔㭁芿賃鵀任妊衽絍抐嫩（媆俗字）媆腝碖溣論䀼刃仞杒牣肕軔𢂻訒韌認䏰閏𥹿（閏）閠潤寧寍（寧）
kən1	搄縆絙庚䢚浭賡鶊羹𩱧埂更秔稉粳耕畊（耕）根𣥦跟珢
kən3	郠埂挭峺硬𢯬哽梗𧋑䌄綆䋁（綆）骾鯁𦛟耿熲（耿）𦵸𥉔䫀詪
kən5	亘亙𣘰𠄭揯縆堩𥔂䱎暅𠄣𣍭筻更艮茛詪珢
kʰən1	砊劥阬坑𥉸硎㰢㧶𡷨牼硜硻誙銵䡩䡰鏗摼鳽羥殸傾顉
kʰən2	□（節省）
kʰən3	肎肯𣍟（肯）豤墾懇齦
kʰən5	硍
xən1	亨亯（亨）𠅖（亨）哼悙脝
xən2	𢘆恒恆𠄨（恆）𢛢峘莖䪫牼哏拫痕鞎㯊𦣍筕珩桁胻䯒衡𡘻（衡）𡙉（衡）蘅洐
xən3	佷很狠䓳
xən5	䛭𧨫㚔𠂷𡴘悻婞𡟡㼬荇莕絎胻恨
ʔən1	恩𤇯蒽煾ㄣ硬然
ʔən2	圻垠㙬（垠）𡊷（垠）𡏴（垠）泿
ʔən5	摁䭡
tsən1	曽曾竲贈增𦼏憎橧熷磳罾矰䎖譄僧䒏鬙𣃘𨟃癥症徵𢾷（徵）𢽠（徵）𡈼（徵）𢽡（徵）脀䒱𦚦烝蒸䕄篜䟓朾丁𠆤（丁）玎𧯫䆸𠑅趟𩘽綪爭𠫩（爭）𠄙（爭）埩掙猙䋫箏䱢貞𠨀（貞）湞楨禎𨜓𨺟鯖延佂𨒌征徰（征）怔𦙫眐𧘿䋊鉦𨢹正㱏𣥔𤴓𧾸鴊坫椹枮砧碪旡𠘸（旡）兂簪𥯓（簪）撍㻸瑊㘰針（鍼俗字）葴斟箴鍼𪈁鱵𪇳塡𥧑（塡）珍錱（珍）鎭𨦸（鎭）𨬖溱瀙𣓀搸蓁榛潧𣐽樼臻轃唇磌真㖘帪眞𡙊（眞）桭㲀蒖甄禛薽籈畛𤱥（畛）稹侲振診懲
tsən3	氶抍拯𨋬撜盯整戡㱽枕䪴䫬屒𣞟敐胗槇姫㐱𠘱眕畛𤱥（畛）疹袗𦕑紾軫裖䪾駗稹縝鬒黰賑晸𧤛𣐽
tsən5	增𪒟瞪𪑬𪒘甑䙢䰝𩱭烝證𨨾（證）倀趟柼偵幀㡧𩏠瑒鋥䂻𥊼掙諍呈鄭㽀正㱏𣥔𤴓𧾸政症証鴊揕㓄螣鰧顩栚朕𦩎𦩗沈㼉鴆譖針（鍼俗字）枕填塡𥧑（塡）瑱鎮鎭𨦸（鎭）䏖䀕紖眹陳𨸬（陳）軙（陳）陣𨳌敶䢻娠袗𩒉挋侲唇振賑䟴震𩆉（震）䳲濜#擲囎（囎唹（そお）は鹿児島縣の地名）
tsʰən1	庱僜睖爯𤔹（爯）偁稱䟓撐橕瞠竀樘倀噌鏘𢐓琤棦凈錚琤鐺槍鎗䟓䞓赬檉蟶竀虰偵䑣郴琛棽綝𥉨賝參𠫰（參）朁（參）嵾𥤇駸梫槮𧡪𤣆胂縝嗔䐜瞋謓𣞟縝#逞
tsʰən2	曾層增䁬澂澄浧（澄）憕懲瞪嶒竲驓鄫橧繒磳丞承𨋬揨朾䆑𢾊䁎憕橙𢿦䆵瞪虰湞䟫挰掁棖澄浧（澄）憕盯呈埕珵程裎䇸酲𨜓成郕城𢦩宬珹筬誠鋮䫆盛䒞沉（同沈）𤘣莐鈂霃沈湛㴴（湛）枕㞥岑笒涔梣䅾𩅨𣠟𩻛忱㽸訦愖煁瘎諶葚𣞵陳𨸬（陳）軙（陳）𪋻塵𦧄（塵）𡐪（塵）尘（塵）塡趁䍶敶臣𢘑（臣）辰𠩟（辰）𠨷（辰）𨑄（辰）䢻茞䣅宸敐晨𠔹（晨）䢅麎鷐桭屒晨𠔹（晨）帘㲀𦿒傖嗆（~哼）䚘崢𩫿鬇鏳埩𦱊崝琤崢迚鬇#纏（限 盤~）乗乘𠅞（乘）𠓸（乘）棧
tsʰən3	庱䩶裎悜睈騁𩧢（騁）踸䫖鍖醦墋磣沈瀋辴𢌝
tsʰən5	𠟂蹭覴稱秤鱦䞉剰𡹴剩嵊賸媵𣎜牚靗偵遉㵾𧡬闖讖疢趁齔儭嚫櫬䞋瀙𢌝
sən1	㱡升昇陞+勝+𠢧（勝）+𠅫（勝）+𢾶（勝）𦫵抍聲殸（聲）參𠫰（參）朁（參）棽森槮穼𥥿蔘薓葠蓡𦺭曑襳深𣸧（深）𦸂㯜扟屾侁𢓠籸莘甡兟𨐔詵𦐹𣘘駪㜪燊𩺵䯂㾕姺阠申𤰶（申）𠭙（申）伸身呻珅柛神𣢘㑗砷眒𥋀（眒）𠲳娠𣇗紳訷𩉼䰠胂牲笙泩狌珄甥生胜
sən2	乗乘𠓸（乘）𠅞椉塖塍堘畻溗騬澠憴繩譝鱦神𥛠（神）層
sən3	㱡省𡮀（省）䁞（省）眚𨜜渻𡞞㼳㾪䚇𨵥槮㾕瘮淰㜤䰼邥沈宷魫諗審𩶇瞫𧀯嬸㰂䀢弞矤哂听（哂）矧訠頣洒
sən5	𡬙丞勝𠢧（勝）𠅫（勝）𢾶（勝）榺蕂膡生𤯓（生）鼪貹晟盛墭聖𦕡（聖）𠄵（聖）罧滲訦甚𠯕（甚）𥱅（甚）甚𠯕（甚）𥱅（甚）侺深𣸧（深）𢊖+𣞵㰮脤祳腎𦜜蜃鋠昚蜃慎愼𡴜（愼）眘（愼）㥲（愼）抻眒𥋀（眒）阠
ʔən1	莖嫈罃褮甖𠠜罌嚶譻
ʔən2	俓娙
ʔən5	鞕硬行嫈䙬瀴䭓
fɔŋ5	捀縫俸㡝
fɔŋ2	夆捀逢漨𥛝𥎌縫䩼
fɔŋ5	唪奉𠬻（奉）𢱵（奉）鳳𧱶（鳳）𪆍（鳳）鴌（鳳）𠤈
sɛ̃3	潸
pəʔ7	不𠀚（不）𠙐（不）
pʰəʔ7	馞䪬昢哱㛘孛悖誖𢨋（誖）𢠜荸䄶餑郣勃挬𡋯浡桲𣭷㪍脖㶿渤𦸦馞𩣡鵓𩱚艴
məʔ7	𠬸沒歾（沒）𣇶（沒）没𠬛𤣻歿殁莈𩑦#無#𣟒（無）#𣚨（無）#𠘩（無）
fəʔ7	𨚓鈈𤊸芾巿弗甶冹帗𡗻柫氟笰翇紱紼綍𩖼韍髴黻乀刜拂茀𢂀彿祓艴𧿳髴䭮嶏佛𠇛（佛）仏（佛）坲刜咈𡶒怫炥䞞𣀣沸𩰾㵒
təʔ7	䙷得𢔶（得）𢔨（得）淂惪𢛳㥁𨁽德𠮊鍀𣌏鴏𧈱𧴮𧈩貣特𤙰𧎢螣棏樴咄𩢎柮𩨳
tʰəʔ7	𧊇匿㥾忑忒𢘋貣㧹脦㥂慝鋱𥊸特宊𠫓？脫𡿮𣅝䠈㥆棁梲凸𡿮突𡦾（突）堗葖𦩤鼵揬𣔻鈯腯𦔅鍎鶟吐
ləʔ7	#若（遠指 俗或書那 非）#𦱡（若）#𦱶（若）#𧁇（若）𣉘䘅䎪㔹仂阞扐艻叻玏泐竻勒𤨕鰳肋嘞朸疒眲䭆蹃𥖪礐砳搦𣲷𦮾㵫㘝孨入肭抐㕯𣧍？訥𨁸𠀽硉㪐𥓎𢂤㠴日𡆸（日）馹衵臸矣（每作輕聲）𠤘（矣 每作輕聲）
nəʔ8	#喏#諾
kʰuəʔ8	？塊
kəʔ7	#鴿#㠷#佮#匌#㭘#𢂷#𣭝#閤#鞈#韐#鮯#鉿#蛤#浩#合#㪉#頜#㧁#郃#噶#丐#匃#割#㓣（割）#𠛷（割）#𠛛（割）𨞛#𩢛#䈓#㵧#輵#𥢸#葛#獦裓𢧧孂搹革𠦶（革）鬲䰜（鬲）隔塥嗝槅膈𢡍𦑜𥉅諽䨣𥴩䪂𧈑𩹺𢡤挌茖𢓜格㦴𢼛蛒觡骼𪌣𩹿𩹺鉻㪾鵅呄
kʰəʔ7	#匌#歁#峇#𢈈#㕉#𠩧#䆟#𧨵#溘#𣹆#𣩄#㧁#榼磕瞌𨍰㕎𧛾䶀鞈（䶀）#䯋#骹#䅥#䳚#磕#瞌#嵑#渴#𣊅（渴）#𤸎#㵣咳孩（咳）克𠧳（克）𡱀（克）𠅔（克）𠅡（克）𠧻（克）刻𠞫（刻）剋勀勊娔氪𡞢尅諽䙐緙礊罊𩱝喀揢客礊可
xəʔ7	#蓋#𤇁（蓋）#盇#盍#𢈊#𢩋#𨜴#熆#篕#𧪞#闔#𨶩#嗑#㧁#㭘#搿#合#䢔#盒#𡇶#𦳬#詥耠#𩡔#𦤦#喝#㿣#䫘#𠿒#猲#暍#曷#毼#㮫#餲#鞨#䫘#𩩲#褐#鶡#骱#蝎#害黒黑嘿（同㱄）潶㱄劾赫爀𥋿𢅰嚇滆核𣝗（核）𤈧㮝䃒翮覈繳蒚䞦楁𨍇垎淈𥝖紇齕麧#欱
ʔəʔ7	餩殕
tsəʔ7	則𠞋（則）𠟔（則）𠟭𠟻𣿐賊𧵪𦽒蠈鰂鱡𣮊𢕚稙陟捗𠌹（陟）𡮞直𣓟（直）𣖴（直）值（直析）値（直析）𡸜犆䐈禃萴𣅔稄夨仄𠨮㳁𣅦昃𣅳𢯩𥟔萴𡸦溭崱戠織𥿮（織）綕（織）𦁓（織）𦁋（織）𧄕+䐈樴𥋏職蟙軄昵嘀摘厇矺𡇠𤟍棏䊞謫讁嫡𪄱𩑒乇杔馲舴𤜤+虴磔𥧮𪐏𤁰𤂥檡擇澤㚖（澤）襗䕪蠌鸅㡯宅𡧪（宅）翟𪀥𩏪𧐐咋責𧵩（責）嘖幘嫧𦟜簀謮𩔳債迮笮舴㳻嘖諎蚱窄措𪐏蹢𨅙（蹢）𧓸躑䵂潪擿擲䨥𠪮適𩀝拓摕（拓）䘸這（俗用作近指字）䗪隻䞠跖墌摭蹠𨂂（蹠）炙指𢫾（指）熾𧹹（熾）𤎷（熾）𩅀𩢏縶𡂣譶俋㞏䐲蟄㙷戢㗊蕺𠿠濈𧤏𥊬𧥄霵𩒣霵䯂汁叶執瓡褁慹𡠗䥍（𨬝之譌）㲳挃庢𥎹秷𦤻窒蛭㗧銍𨖹膣螲𪗻楖擳𥠈㘉瀄櫛侄郅桎晊蛭銍質劕𡂒懫𡒐（懫）𡏸（懫）櫍䑇騭礩鑕𪗨+膱？妷姪𧽮？柣袠？翐？紩？鉄（紩）𡙮𢧤𣗻豑指𢫾（指）戠厔#祇（俗又音）#作#胙（作）#𢓓（作）#者
tsʰəʔ7	墄侙勅㽚恜敕飭遫慗𪀦趩鷘荲栻淔𡍫測惻𢝔（惻）䔴𦔎畟𦔫瀷拆坼𤖴㿭𡍩𩎚𧼳𩑒擇冊𠕋拺𣆩笧策𥬰㥽憡筴矠嫧𧶷皟䶦柵鰿矠嘖㣱耫賾𡄙（賾）葃咋泎齚齰岝𤭏彳䜺簎柵哧尺呎蚇斥赤𠧚㡿𠧵烾㚖郝滷湁雴漐𡍪㞚䙄𢕬卙斟抶跮眣𥄺（眣）咥秩豑（秩）廁（側也）䜉㓼𠞩𪘧叱側
səʔ7	塞𡫼㥶𢤑（㥶）𢥜（㥶）𢥛寨薔嬙色𢒸（色）嗇𠻮（嗇）𤲝（嗇）𤳋（嗇）𤲷（嗇）銫𠢳濇懎㱇穡𧒗䉢繬轖𩍙𩕡遈湜寔埴植殖𢨀㨁鉽識𧨺（識）𧄹式拭𢂑烒軾飾𥿮飠食𩚃（食）餐（食）蝕拺䪂洓㾊栜𣽤擌䨛摵愬索（山戟切 求也）𡩡溹虩𧈅㳻𥻨索㮦䂹𡩡䞽溹哧郝㚒冟睗適奭𡚐（奭）螫檡𡣪䁺𥼶釋摭襫𩮜晹𦔥+射+䠶+麝雭歰澁㒊濇澀啃翜鈒什十拾褶溼濕𦒣（濕）䏉瑟㻎（瑟）𡘼（瑟）𡚉（瑟）𩇰（瑟）璱𦆄飋虱蝨鯴蟋失室𩋡實宲（實）𡾍（實）石𥐘炻祏䄷鉐䲽鼫雫辻說
iæʔ7	#𣡌#𣎴#歺歹𡰮（歹）𣦵屵#𠱥#㩵#頇#枿#嶭#蘖#櫱+䡾#𠲗#靄#胺#咹#遏𠥜#頞#餲#齃#堨#𢉥#閼#嬒#睕#䩊#𥄗#𣁳#捾#焥#䁊
ʔəʔ7	䁊頟額䩹䱮峉詻䩹㣂鳽虉砈厄戹阨扼苊呃阸㧖呝蚅軛軶豟𧲒（豟）𧠞𩚬啞䛩搤貖𪕶𩚬啞
təɯ1	吺剅侸兜𧯠𥆖兠蔸篼𧢗𩮷郖
təɯ2	頭（每作輕聲）𥘖（頭 每作輕聲）
təɯ3	阧抖枓陡蚪㪷斗𣂑（斗）襡豆
təɯ5	鬥䬦𧱓䛠𧪧𡟳𧱦斣闘鬭鬬襡噣𠁁䕆𨪐襡𩿢揄豆𣅋（豆）𤽋（豆）𣅣（豆）郖荳逗浢㛒梪毭酘脰䄈痘餖投𩊪𤀨竇讀窬
tʰəɯ1	鋀偷偸鍮媮婾
tʰəɯ2	投𢫹（投）𣪌㓱㢏緰頭𥘖（頭）𪁞𪎨䤅亠坄揄牏歈𣤏（歈）窬
tʰəɯ3	妵鈄斢黈𪌘𩿢䱏蘣飳𪌜
tʰəɯ5	咅透䞬綉（集韻他𠋫切 吳俗謂綿一片爲綉）𧺢㰯䟝
ləɯ1	#鏤
ləɯ2	羺䨲獳䰰剅瞜婁𡜰（婁）𡇔（婁）𡝨（婁）𡝤𠞭䣚僂𨻻遱嘍廔慺𢡌（慺）樓膢𤬏耬𦔪（耬）螻艛𦎹䝏謱𧁾鞻髏䱾摟簍鷜褸柔𨛶揉葇瑈䐓腬㽥蝚蹂鍒鞣䰆騥鰇鶔
ləɯ3	㝅𡭾啂㳶𡝦陾嘍謱𪍣塿嶁漊甊㪹䅹簍沑禸𠘯粈葇煣𥠊輮蹂韖楺縷褸惹（人者切俗又）
ləɯ5	𣫌槈耨鎒譳搙擩𠞭僂𧷡陋屚𦸢漏𣤋瘻瘺𧫞鏤𨫒蔄煣輮蹂鞣#肉（又 如六切）#宍（肉）#褥？露肉（如又切）宍（肉）
kəɯ1	#歌#可（歌）#哥#謌勾句區𠛎冓𤫱䑦鈎鉤拘溝褠緱篝鞲𥴴韝枸夠㗕𪓟軥鴝𪁖（鴝）𩿩（鴝）
kəɯ	□（闚）
kəɯ3	苟𠷜（苟）岣狗玽耇枸𦊒笱豿垢茩詬𢼒敂
kəɯ5	#箇#個#可#个冓𢄇姤够夠䝭遘搆彀㝅雊㝤媾𤚼構煹䃓覯購句怐軥究𡫄（究）
kʰəɯ1	韝夠芤𢂁剾摳彄慪瞘䁱滱𣻎
kʰəɯ2	□（慳）
kʰəɯ3	#可㸸口𠮚（口）𠙵（口）𨙫𤘘竘叩扣𧥣釦
kʰəɯ5	詬扣怐佝寇𡨥筘𡠆滱𣻎瞉䍍簆𥲃鷇㜌垢
xəɯ1	齁𪅺
xəɯ2	𥎦侯矦葔喉帿猴㮢𧮶睺銗瘊䙈䗔骺篌糇翭鍭餱䫛鯸鄇翵疣骰
xəɯ3	蚼吽吼犼㖃𤘽㸸呴
xəɯ5	佝訽詬吼㖃豞䪷怐蔻蔲㰯㖃后郈厚𡦩（厚）垕後𢔏（後）𨒥訽𣣠睺鍭后洉厚𡦩（厚）逅後𢔏（後）侯（閩~）𥎦（侯）矦（閩~）候𠋫鄇堠䞧䞀鮜鱟
ʔəɯ1	剾摳瞘䁱蓲漚甌歐膒䙔櫙謳鏂鷗嘔區醧熰慪
ʔəɯ2	□（諾）
ʔəɯ3	㸸塸歐毆䙔𠙶嘔𠴰㰶𧖼𣢨𠴰敺
ʔəɯ5	𠹝漚渥䙔𣓕𣉾蓲熰
tsəɯ1	陬掫棷緅趣𣠏調侜啁矪𥎻𧻖輈𩢸盩譸𡆓（譸）𡃮（譸）𧪀（譸）咮齱𠿈䑼騶郰陬菆棷鯫箃緅鄹𨃘黀𪎪（黀）舟州𠄓（州）𠃕（州）𠛏（州）𣧓（州）周𠱬（周）𠄗（周）洲郮週婤𥺝輖賙
tsəɯ2	□（不順）
tsəɯ3	走㞫（走）赱扭肘疛𤶡搊掫𧌗晭箒𧳜鯞帚棷趣
tsəɯ5	走㞫（走）赱族㞺（族）𥎩（族）𥎼（族）𥏁（族）奏𡙹（奏）𡲯（奏）𡴨（奏）𢽥（奏）揍楱㔌䠫晝啄噣咮注𦡴鮦紂葤䈙棸懤㿒𤺜（㿒）繇疛伷宙逐冑胄酎䛆𩊄駎籀甃㼙（甃）㾭皺縐䐢𥣙㑳僽驟椆䯾呪咒祝𥘱（祝）#鄒
tsʰəɯ1	䜅抽𢭆㨨瘳惆𥈌婤妯𢬆搊㮲醔篘𥻤謅犨犫
tsʰəɯ2	鯫㔌𥲅抽紬菗𢃖椆𠷎稠裯綢𨞪儔𠍻（儔）薵幬𢤉懤𦡴燽疇𢑔（疇）𠾉（疇）籌躊𪆇𪇘檮䬞鯈怞鮋棸愁㵞酬詶𨞪雔𣀓𣀘𣫐醻讎𢢧（讎）𠵁（讎）𢛇（讎）魗鮋
tsʰəɯ3	取趣棷䪮丑吜杽杻瞅𩋄𩌄醜媿（醜）𥆞（醜）𧃝魗
tsʰəɯ5	湊楱腠輳𧱪𪉮族㞺（族）𥎩（族）𥎼（族）𥏁（族）蔟嗾畜嘼（畜）俞兪遚䔏簉臭殠
səɯ1	鏉𠘂摗鎪䩳𩌱𩮶涑𡠼犙𦺋捜鄋𨜛搜𢯱𢅢（𢯱）蒐獀廋溲螋䗏𧽏醙䤇𨤇（䤇）鎪䤹餿𩜯䐹颼䬒騪䮟𣸈𪌲（𣸈）𧼭犙收㧃（收）
səɯ2	□（振）
səɯ3	操𥈃籔駷廋廀叟叜傁𠊯𠋢𠻛瞍嗾䏂𦖪謏藪𧩮棷溲𣸈𪌲（𣸈）手𠂿扌守𡬮（守）𡬴（守）𦣻首𥃻（首）𩠐艏䭭
səɯ5	鏉漱族㞺（族）𥎩（族）𥎼（族）𥏁（族）嗾謏欶嗽瘶瘦𤸃鏉漱嗖𨞪受𠭧（受）壽𦓃（壽）𦓂（壽）𠭵（壽）𠷎（壽）綬璹𠩱（璹）詶授㖟售壽𦓃（壽）𦓂（壽）𠭵（壽）𠷎（壽）綬㥅收㧃（收）守𡬮（守）𡬴（守）首𩠐（首）𥃻（首）𦣻狩獸手𠂿扌#擻
ʔəɯ2	齵聱牛
ʔəɯ3	偶㼴耦蕅藕髃吘
ʔəɯ5	偶𪖐
pɨ1	#婢？斃？貝
pɨ3	㗗佊彼柀𠐌匕比夶（比）𣬅（比）朼疕沘妣䃾秕舭髀俾𢔌𠬈𦸣𪐄𢳋鞞髀箄崥娝啚𠴿（啚）鄙𠴿（鄙）痞𤽊㪏
pɨ5	陂藣賁波佊貱詖跛㝿（跛）比夶（比）𣬅（比）䃾𦸣庇畀畁（畀）𢌿㪏閉閇箅嬖𦸣𠈺陛㙄梐𤙞䯗髀鐾𣘥薜𥴬𨢡𨫔䥍（𨬝之譌）庳婢埤（部靡切 部比切）牝𠤎（牝）比夶（比）𣬅（比）䃾坒䫁𤹝襣芘枇䑄泌
pʰɨ1	䪹呸怌丕不㔻伾秠豾鉟髬駓魾䫠苤悂㩺+紕𢞗𦀘𧧺帔披狓被㱟𤿎𤱍秛耚旇翍鈹鮍𤿎鈚𨻼批砒𠜱磇錍𪄆
pʰɨ2	罷犤皮𥬖（皮）𠰎（皮）陂郫疲頗㯅鈚比夶（比）𣬅（比）沘魮阰芘+枇肶毗毘𦊁蚍𣬈𨈚豼琵𦳈㮰膍貔𧑜𧖈仳鵧𪌈裨紕郫陴𡌨埤啤𦜉脾焷蜱㯅螷䴽𧓎蠯𩫫邳鉟魾䫠岯䲹鞞笓崥椑㼰膍鼙#痹
pʰɨ3	吡疕庀仳䚹諀疕𢻹秠𡺮嚭紴披翍（披）㱟䫌圮𡉏
pʰɨ5	濞淠𦤢䑄㿙嚊屁䊧濞渒𠞇埤睥𣹮媲䠘#紕（俗又音）？髀
mɨ1	#謎#渳
mɨ2	𪎭𦗕糜𩞁𩞇摩縻蘼㸏醿䊳𪎕冞𢏏弥𥹄䍘𨤐擟麊彌𢑀（彌）𥎖獼㜷镾㣆鸍𥸀䥸瀰𥉓咪迷𡝡𡝠𧠠醚䤍麛𪓬謎#眯
mɨ3	骳𦗕靡蘼𡬍𪎓𨇻咪芈羋侎弭𢏱（弭）敉葞㥝瞇濔瀰咩䦵䖹蝆𡬍米洣脒䋛蔝䱊
mɨ5	㩢
tɨ1	岻低奃袛䧑㓳羝隄𥿄趆堤䐎𡰖磾鍉鞮氐𢎮（氐）柢揥腣眡䬫䚣屜#地（限 ~頭）#埊（地）#𨻐（地）#埅（地）#𠏂（地）#嶳（地）
tɨ2	？題
tɨ3	堤邸坻抵𠥯（抵）底弤柢牴㪆軧觝詆䏄
tɨ5	地埊（地）𨻐（地）埅（地）𠏂（地）嶳（地）墬弟𠂖（弟）𢦢（弟）娣㼵遞䑯媞悌逮逯（逮）軑髢杕弟𠂖（弟）𢦢（弟）娣第釱𢰂棣睇遞禘摕遰慸締#乄（しめ）#〆（しめ）踶𧫚𧡨題𪂿鯷𥶛鷤悌鬀㣇𡱃（㣇）墆#屜
tʰɨ1	睇梯㔸𨁃䖙𩤽𠥸鷈謕
tʰɨ2	隄䧑（隄）𡰄䐎𡰖詆締鼶銻䖙厗𦯔㖒提徲啼罤崹稊𢔭媞瑅𣖅𧋘嗁㡗䬫𣹲綈䨑褆蕛𥉘蝭䬾緹趧醍𧡨蹄䚣鴺蹏謕踶題𨪉鮷鵜騠𪂿鯷䱱鶙𥶛鷤荑桋銕鮧折禔
tʰɨ3	緹醍𣈡軆𩪆䪆體挮涕
tʰɨ5	啻达楴暜𣧂戻鬄剃洟𪖦（洟）𥫵涕屜替𢝹𡲕𧛒𣤖殢𤾕㬱䎮鬀薙地（限 落~）埊（地）𨻐（地）埅（地）𠏂（地）嶳（地）遞䠠趆柢骶𤬵帝𢂇（帝）𠫦（帝）偙𦨢𢰂蒂䟡僀腣摕䩚蔕碲諦螮啑渧蝭嚏嚔疐蝃
nɨ1	#狸#璃
nɨ2	呢妮尼怩𢘒（怩）䛏蚭跜䝚鈮𩚯柅聻伲抳狔旎柅柂㷰攡黐离𡴥（离）漓𢟢璃樆䅻褵罹篱縭醨謧離鵹蘺𪅆灕蠡𢍝（蠡）𥯵（蠡）㰚𢥗孋䍦𪖂劙矖𧕮穲籬𧕯驪鸝𣀷麗𠧥（麗）𠀙（麗）𪋘（麗）酈䕻倈厘𠩬狸𣮉喱剺𠭰筣艃孷嫠貍犛𣁟𢟤𩭇釐𨤺（釐）斄㾖氂梩刕梨棃犂蜊蔾蟍𠠍䴻𢤂鯬鑗秜泥屔埿兒𠒆（兒）𠆵郳倪猊婗棿㪒䘽蜺輗貎觬霓鯢麑齯𣕁犁犂筣盠蔾𨛫黎𥠖㦒𨿯𦃇謧藜邌𤛿鯬𥌛黧廲𩧋驪莉瓈#佴（氏也）櫚
nɨ3	悝李杍里𨛋俚哩浬娌理㾖裡裏鋰鯉㸚峛邐薾檷禰瀰嬭𡇲（嬭）坭昵苨䛏𦰫𩋪䦵鑈𩍦𩯨㪒䘽觬掜晲堄盠蠡𢍝（蠡）𥯵（蠡）劙鱺礼豊澧禮𠃞𤔑𥴡醴欐𣀷鱧欚𦫈𩽵離
nɨ5	䣵膩𦡸䁊琍利𥝤俐莅猁涖痢蒞䇐䬆鬁䚕𢟤吏離荔珕詈𥶾㿛例砅𢂥栵㾐厲勵巁癘濿𢤆櫔蠇犡禲礪蠣糲𩧃洌䅀𥟜（䅀）䮋鮤𥣭𧸱𢤇泥埿䛏迡濘霓堄睨𧡎甈盻𢏗離𠠫劙㸚欐丽沴戾𤡵（戾）盭（戾）荔珕栛㑦涖䓞唳悷蜧綟隷𣛒隸𩘡麗𠧥（麗）𠀙（麗）𪋘（麗）𤃀𣟌𥃏儷䕻𥶾㿛䚕𧢮捩蜦
ʔɨ1	㿄+噫+𢤏（噫）毉醫譩犄猗欹㾨禕戲漪檹𩕲椅旖陭衤衣依䧇㛄郼㥋銥譩繶㐆伊𦯴（伊）𠈽（伊）咿𧉅蛜黟黝矣𠤘（矣）
ʔɨ2	拸袲鉹蛇施𢒃𠇜𠤒箷詑虵𣣢歋匜也（匜）杝䄬衪𠩗𤝻迻拪（迻）栘扅移柂暆𠗺㥴䔟𥠥䬁熪螔𠐀簃謻迆迤酏眱𥄿（眱）𥅣（眱）𡰥珆鴺洟𪖦（洟）羨夷䧅荑峓𢓡恞𡱐姨桋胰痍蛦羠跠鮧彞彝𦇚（彝）𢇏（彝）𧤋（彝）鏔𣟗㰘寅𦦚（寅）𡓵（寅）㝙（寅）𢁐（寅）𡩪（寅）蔩#遺#𨗮（遺）#𨖽（遺）#𨗭（遺）姬㚦（姬）𦣝洍台圯沶怡瓵巸戺𣢮眙宧弬㺿㼢𣐵𦚟貽䬮詒媐飴𩛛頤𩠞𩠢䱌鏔异姬
ʔɨ3	僾㥋庡扆偯靉奇猗倚旖輢猗譩醷㰻矣𠤘（矣）𦮸肔孈匜也（匜）衪㥴扡迆迤崺酏巳已以㠯苡笖佁攺𢻰苢綺（墟彼切 墟里切 語綺切）尾𡱕（尾）𡱓（尾）𡲵（尾）
ʔɨ5	衣倚輢陭猗𠃸䵝意鐿鷾欭亄㙪撎饐䬥（饐）懿鷧㱲螠縊隶𥿫㣇𡱃（㣇）貤殔肄勩㡼食𩚃（食）餐（食）巳敡已异異𢄖（異）䔬廙潩㒾伿易貤㑥施𢒃𠇜𠤒移
tɕɨ1	丌姬㚦（姬）基𡉝（基）稘䇫箕𠀠（箕）𠴩（箕）䇧（箕）𦋊（箕）𥫶（箕）𠷛（箕）𠔋（箕）𥫚（箕）𠔛（箕）𡿸（箕）錤諅𧥽（諅）居㞐（居）㝒（居）朞𣍡（朞）𥟝（朞）𣇳（朞）期（同朞）𣅆（期）𠔸（期）諆其亓（其）萁𦬟（萁）姬机肌飢虮刏𣱞𣱚僟𦺬嘰璣機禨𧗇磯䟇譏鐖饑𩜆（饑）𩚮（饑）鞿幾𢆻（幾）𢆼（幾）榿蘄攲躸羇羈䩭（羈）掎妓㱦奇倚竒𧆌䂑齊隮賷櫅䪡躋𢁃（躋）䠁（躋）𤼥（躋）齎𩐒齏𧅱擠齌𨥳𢥎麡啙卟𥝌乩枅笄𠚙（笄）㮷稽𩠜（稽）𨪴雞鷄䗗#墼#檵敧#祭
tɕɨ2	？吱
tɕɨ3	庋剞攲踦掎㞆㱦机几䢳㞦𤜝㞛麂𪊨䂹己𢀒（己）𠮯妀紀幾𢆻（幾）𢆼（幾）穖蟣𩴆枳䍤癠𤸾（癠）夘㧗擠
tɕɨ5	翨馶溉漑機禨旡𠘸（旡）𣢆既旣蔇暨曁𦤌（曁）𠕨（曁）洎兾穊冀覬懻𩥉驥蘎（驥）記徛寄䐀其伎技妓徛䗁錡跽畁忌坖（忌）梞惎𢗏（惎）𥭜䋟誋諅𧥽（諅）鵋鱀𢍁帺𨙬𧳙幾𢆻（幾）𢆼（幾）䤒芰茤（芰）𦼽（芰）䛋䝸鬾騎輢汥㧘垍洎臮塈墍𡉙（墍）𡍳（墍）暨𣽍鱀曁𦤌（曁）𠕨（曁）季𡥞（季）𡦠（季）𩐄（季）𩐖（季）祭際穄穧鰶𩯰𩯷㦣彐彑𣯅罽蘮瀱𦇧訐猘𤝼（猘）偈隮躋𢁃（躋）䠁（躋）𤼥（躋）擠䶓濟（子禮切 子計切）泲（濟）㴉（濟）穧霽䰏𩶆癠𤸾（癠）鱭薺啙劑𠜸（劑）齌穧癠𤸾（癠）𨣧𪊆䶩嚌𠴧（嚌）齊亝（齊）懠轚計𨜒㲅+髻薊檕+檵繫繼蘻係#紀#屐左㡭氣（去旣切）
tɕʰɨ1	攲踦觭䗁㩻㥓㱦𤘌𦖊榿崎碕䫥娸欺僛䫏魌𠐾𪅾𪀩䶞𪗞（䶞）抾#期#𣅆（期）#𠔸（期）齌妻𡜌（妻）𡜈（妻）郪凄萋淒悽緀霋鶈檕𤳤嵠溪磎螇谿鸂#奚#蹊棲栖
tɕʰɨ2	畁錤期𣅆（期）𠔸（期）亓其丌（其）𢍁𢃛萁𦬟（萁）淇琪棊棋祺𥘕（祺）碁蜝綦𥾟（綦）蜞䑴旗綨璂𧯯踑䟚（踑）禥藄𦪆𤪌騏䭼（騏）䭶（騏）櫀䳢蘄鯕麒䶞𪗞（䶞）翄伎𨙸芪岐𨙾（岐）㟚（岐）𡵨忯歧祇蚔支（令~）𠦙（支）𢺶（支）𦭲𠁭疧蚑䉻𨱜䞚軝跂𩉬𢻚䲬示⺬礻𥘅（示）汥衹馶刏𣱚（刏）㙨畿𦠄幾𢆻（幾）𢆼（幾）蟣圻岓祈蚚旂崎碕頎𩴆𧰙玂𪙧俟弜鵸𢺷奇竒㩽琦碕鬾騎錡埼癠𤸾（癠）𨥦𨥳齊亝（齊）䶒懠臍蠐濟（前西切）泲（濟）㴉（濟）𪗍麡畸𨵤茨耆鬐䅲螧愭鰭祁鮨䱈（鮨）
tɕʰɨ3	觭㥓䞚碕婍㾨跂邔芑屺玘杞起𨑓（起）𡆡（起）𨑔（起）豈䔇亟䀈唭玼泚皉緀敧崎
tɕʰɨ5	掎㞆䀈气汽炁盵氣𣱛蚑跂企𠈮（企）𢺵𨑤吱弃㞓夡棄𢍞（棄）𨓋（棄）蟿器𡄛（器）揭愒𡳅甈䔾憩摖妻𡜌（妻）𡜈（妻）砌䀙𦕀𥉻䏅去（舊音）亟
ɕɨ1	#些㶼𣢑娭毐（娭）𠩺煕焈（煕）熙僖誒嘻嬉熹瞦譆歖禧媐忾屎𣢂䐅咦詑焁希𠬹（希）俙莃浠悕桸晞欷烯睎稀𧻶豨鵗桸焁䖒羲𢨛隵㚀𢹍曦巇𢋼犧㺣𤃪𣤴𧕆戲䚙羛卤栖𨵤嘶㽄𠧪西㢴（西）𠧧屖硒舾粞犀𠞂㾷㯕樨𤺊𧬊㡗忚䒊橀𦫬醯#畦#兮#圾（俗字 近世松江乖音 非）
ɕɨ5	胿嵆嵇𡗞傒徯㜎榽螇豯貕鼷郋蒵騱𪓷
ɕɨ3	俙唏狶豨𪖥霼喜憘（喜）𢐭（喜）歖（喜）憙蟢囍𪖪洒洗史（諱 姓氏用此音）㕜（史）蹝
ɕɨ5	𢟪摡塈墍𡉙（墍）𡍳（墍）䀈愾鎎氣𣱛唏欷忥犔熂䊠黖䮎𧱲餼霼䊠㕧呬侐𤡬䨳屓齂嬉憙戲嚱栖𣳦細𥿳殢㰥忚㚛𡘐瘛𦃟繫妎蒵系盻𦝜慀禊稧䐼㨙䦏#攜+喜（好也）+憘（喜）+𢐭（喜）+歖（喜）匸
ʔɨ1	𦎣䚷㙠嫛䃜繄𧫦黟黳𣕁翳鷖倚崎
ʔɨ2	溰沂听𠲻崖涯𧭖義（魚羈切）議（魚羈切）𧧼（同議之魚羈切）誼（同議之魚羈切）宐宜𡪀（宜）𡨆（宜）㝖𠣨儀䣡𥫃𥪺鸃䴊轙狋疑𦬦（疑）嶷觺施𢒃（施）𠇜（施）𠤒（施）
ʔɨ3	疑譺孴擬薿𥣖儗蛾䰙螘㠖嶬錡檥礒艤轙齮羛螘顗𪕔䚷𠯋裏依
ʔɨ5	#億#憶#薏#𦺳（薏）#蟻譺豙儗㘈㽈䰯顡𢖫豙毅藙䉨𧅙𥫃竩義𧧼誼𩈭𧭖議劓艾乂刈𠛄（刈）㲼㣻䖊𩾘䢃㦣埶蓺槸褹藝秇（藝）䆿囈㓷䔽餲𦝲瘞𨻏（瘞）䋵㛳𦒎丿泄洩𤵺曳曵抴𠂆呭枻㑜㹭𢘽𤤺𢂼袣䄿跇䇩詍䎈裔𧘉（裔）𧘊（裔）靾勩㵩䕍㵝𪀕羿詣栺𦐧医㙠繄枍殹㝣㥷嫕𢟇㙪瞖殪𣨑（殪）𣩉（殪）曀縊翳豷𧬇蘙
mia3	乜哶
tia1	爹
nia3	忚䟩
tɕia1	加家𠖔（家）𡩅（家）𡧚（家）瘥蒫𣩈䦈嗟𧭨𧬑𧪰𧪘差（嗟）𧨁𨲠罝怚袓㜘謯迦#佳嘉假
tɕia3	假賈飷抯
tɕia5	賈價架家嫁稼駕𩢟（駕）借唶藉𧃫（藉）躤䣠褯䤳𧭨𧬑𧪰𧨁𧪘嗟
tɕʰia1	𠋧佉呿㰦
tɕʰia2	㚗伽枷茄斜䔑？彊？且
tɕʰia5	𧻀䞣笡
ɕia1	#蝦#鰕些
ɕia2	鰕蝦霞
ɕia3	𣬕瀉𣞐
ɕia5	廈丅下𠄟（下）夏暇下𠄟（下）夏𡔰𠍺昰𡕾卸寫䉣蝑灺䵦抯㴬榭
ia1	丫#椰#曰#涯#耶
ia2	吾𠮣（吾）牙𤘈（牙）伢芽枒蚜衙齖庌呀邪余斜䔑琊瑘？耶倻椰䓉𦭿揶𦰳釾爺𤕓（爺）𥯘鋣鎁擨若𦱡（若）𦱶（若）𧁇（若）婼
ia3	疋牙厊庌㿿雅虵𡐨喏𠰒
ia5	牙枒齖迓犽砑訝御𢓷（御）𢕜（御）亞射夜𡖍（夜）𠙑（夜）𠙇（夜）鵺偌
tiæʔ7	耷𠞈㿴褡𩝣䪚㩉䓠𦵺（䓠）𢴄笚矺畣嗒褡搭撘𤝰㿯㾑答剳畗（答）㜓瘩㯚荅𨅞𠉤𦂀𩣯龖眔𥄳蹹沓㧺涾㭼䂿遝𧌏誻𦾽𣝋䜚譶䍇𦑲䈳蹋闒䳴𤒻躢𧮑譫噠𦬹呾怛妲炟笪胆𢛁靼𩍕（靼）䵣狚墶達薘鐽搨（手打也 或作㩉）
tʰiæʔ7	搭嗒鰈魼狧塌遢溻褟蹋𧪦塔𩥑鰨𦐇傝𦶑榻毾㯓𦧭鞳𦪙佮漯濕𦒣（濕）溻䓠𦵺（䓠）𢃕㹺㛥㭼䍝𦑇𦧟䈋𨌭踏嚃錔鞜濌𤄥䶀鞈（䶀）𪂌䵬𪘁羍達韃汏𡊌（汏）躂䲚獺𣥂𦍒㒓撻𨘈（撻）𢽞（撻）澾闥泰夳（泰）噧搨龘
læʔ7	吶訥妠衲納軜鈉㨥蒳䪏魶笝𩚛魶㗙𡤙㘝㑳捺䖧𤷈𤷈痆𧞍
tɕiæʔ7	甲𠇚（甲）𡴌（甲）牐（限 ~北 松江屬區）
ɕiæʔ7	峽挾俠
iæʔ7	儑𥋙儑䜙㾑砐䑥𡀾哈礘魥㬎𣊡礏䀹庵媕罯姶㛕（姶）㔩𨂁𤸱𩋊𩇠鞥佮搕罨唈盦廅𤸱鰪䀴凹𨂁圔浥押庘䆘鴨鵪（鴨）𪁨（鴨）厭壓閘𡿖聐𩮝呾咀劜𡇼䦪𪆰嫼穵圠軋揠䰲猰窫䝟𥈔#阿（詞頭）
niaŋ1	#孃
niaŋ2	娘孃瓤鑲良𡰩（良）𥭣（良）𡆨（良）凉惊涼梁𣹷（梁）渿（梁）椋㹁𥹭蜋粮粱墚綡樑輬䣼䝶𩗬糧𣄴量𨤦（量）𨤥（量）踉
niaŋ3	䒢卬𠨐仰𠓜両㒳兩㔝倆掚䓣𣓈脼裲蜽緉魎輛#匁（め　もんめ）
niaŋ5	𥽬釀䖆仰𨋕悢涼惊㹁𩗬兩㒳（兩）緉亮哴量𨤦（量）𨤥（量）䀶晾喨𣄵䁁踉輛諒掠
tɕiaŋ1	𢪇將摪漿𤕯（漿）螿鱂蔣姜畕僵壃薑橿殭㹔礓䗵疆繮韁𧅁畺江
tɕiaŋ3	蔣㢡㯍槳獎䉃膙憼襁繈繦鏹勥講
tɕiaŋ5	將𢪇（將）𨟻𨡰醬匠䞪𪀘彊彊弜滰誩𧮣（誩）弶糨#雀（吳音）
tɕʰiaŋ1	鶬將𢪇（將）斨瑲槍嶈牄篬錆謒𨶆蹡𨄚鏘𢐓（鏘）𪙝搶嗆蹌熗（俗字）𥏻羌𡹽猐𡸓蜣
tɕʰiaŋ2	爿𤕪（爿）戕墻薔廧𢋾（廧）嬙檣牆𤖧（牆）蘠佯𤞛庠𦍙祥翔𨀘詳洋痒彊䲔強
tɕʰiaŋ3	搶摤勥𠣀𠣃
tɕʰiaŋ5	戧蹡嗆𥇉唴羻
ɕiaŋ1	相葙廂湘箱緗襄𡣿（襄）𠆝（襄）𧞜（襄）忀瓖欀纕鑲驤皀𪏽香（𪏽之省）㿝（香）郷鄉薌膷
ɕiaŋ3	想鯗亨𠅖（亨）享𠅠（享）亯䖮蠁饗響𡪥（響）𡪆（響）曏嚮向（嚮）𡩉（嚮）𡪥（嚮）
ɕiaŋ5	相象𤉢（象）像勨𦺨嶑𨖶潒橡襐蟓鱌蠁向珦萫曏嚮𡩉（嚮）𡪥（嚮）𧬰䦳項
iaŋ1	央秧鴦
iaŋ2	詳羊佯𦭵昜徉洋眻陽𨼘（陽）𨽐（陽）𣆄（陽）揚𠭲（揚）蛘崵𦍹瑒楊敭暘煬湯禓瘍輰諹鍚鴹𩋬𥂸颺鰑鸉样烊
iaŋ3	勨蛘蝆氧痒養䍩（養）𢼝（養）瀁癢𧓲䑆
iaŋ5	像㑰眻煬諹颺痒養䍩（養）𢼝（養）瀁恙羕𠍵㺊㨾漾𡡂樣䭐𩞭𧫛䵮
niaʔ7	逽蹃𨵫磭虐𧆱（虐）𣑅（虐）瘧婩硸詻撂掠擽䀩㨼䂮略畧㗉䛚𧎾𪀡䌎+藥
tɕiaʔ7	燋爵𥥼（爵）𩰧（爵）𣡫（爵）𠙘（爵）㩱𩰥爝䶂嚼皭爝脚腳屩繑蹻卻醵𧮫𠊬𠶸䐘𧍕臄蹻噱覺覐（覺）𧠭（覺）
tɕʰiaʔ7	恪㤩愙㹱䱜踖𨅦（踖）皵碏䇎趞鵲錯（物理麤也）芍舄却卻𤷽𨟠玨珏#恰雀確？嚼
ɕiaʔ7	削學
iaʔ7	葯約䋤蒦𦆗𠨲敫櫟爍藥㿑𢅹𤄶纅𥌺𧢢鑰礿𠩃䋤龠㜰蘥𤒀瀹𤅰躍趯爚禴𧕋籥𤅢䟑䖃䠯𨷲鸙𨈋𩱲彠觷岳捳㹊樂嶽𡶓（嶽）𡶳（嶽）𡴳（嶽）𩓥鸑曰
niɛ1	#嬭#𡇲（嬭）
niɛ2	䍲掜誽摨
niɛ3	㚷嬭𡇲（嬭）
niɛ5	褹
tɕiɛ1	皆階
tɕiɛ3	解
tɕiɛ5	豸廌𢊁𧳋𦤧械介屆曁（屆）艐（屆）界
iɛ1	哀埃唉㶼欸鎄毐𢰇㰪哇洼𠴺+娃也𠃟（也）
iɛ2	#癌#巖嵦㱯皚獃隑剴敳捱啀厓崖猚涯𪘲𩂢娾𩂢#然
iɛ3	欸挨毐㕈娾𧡋𤶗騃唉挨㢊奇矮躷𨱥也𠃟（也）
iɛ5	哎艾𧰿鴱硋礙䙷閡𥝌懝儗哎藹靄砹䔽壒𢣏𣩱𣋞曖馤𪕭㤅愛𤔤（愛）𢛭（愛）𢟪僾薆噯嬡璦曖𥴨靉𢟰𦗐𧏹譺睚嗄𠷚（嗄）䬵喝餲欬隘䅬㿄賹𨽴阸呃噫𢤏（噫）猗
tʰiɛ̃1	嬗痑㨏嘽漢㵄𣶔擹攤灘潬（灘）癱譠嘆𡂥（嘆）𦧴#誕
tiɛ̃1	妉眈耽𤯉（耽）𡖓酖媅𧡪甔湛㴴（湛）頕儋聸擔甔
tiɛ̃3	䒞紞膽䃫𪆻黵瓭耽𤯉（耽）𡖓衴黕䉞𥴶丼抌䪴笪担疸亶𤺺狚觛嬗
tiɛ̃5	𧭃擔甔𩈉馾𩾺淡噉澹憺𥲄氹惔啗？啖淡氮腅澹憺倓惔𤁡贉䀍𧗜瞫醰𢘇笪疸旦狚㡺觛鴠繵但疍蛋蜑觛誕僤䩥膻潬袒襢澶撣但胆僤憚彈𢎝（彈）
tʰiɛ̃1	聃𨈭䔜舑坍㘱㴂𦸁䆱緂欿貪㵅探僋撢
tʰiɛ̃2	㶣炎淡餤澹倓郯惔痰談𥰨錟眈㽎蕁覃𪉙（覃）𪉞（覃）𪉲（覃）𨝸沈潭橝曇㽑𦗡藫罈（甔俗字）䊤𧽼壜罎𧂇𧂗譚𩡝鐔燂蟫儃繟聅癉胆撣但彈𢎝（彈）壇檀貚鷤驒唌驙繵
tʰiɛ̃3	裧忐菼毯𦵹𤎥𦃖緂𠪚䏙𥁺嗿醓襑黮啖啗坦䦔鉭
tʰiɛ̃5	澉𪊇睒䆱舕賧𪉧誩𧮣（誩）㶒傝憛探僋撢䐺㐁𠀬（㐁）𧡪萏窞髧嘾禫𣛱䨢𧂄贉𥥦倓䊤醰譚黮炭湠㛶𣁗碳嘆𡂥（嘆）歎？坍
niɛ̃1	？然？𤓉（然）
niɛ̃2	+喃+諵
niɛ̃2	囝（吳音俗字）囡（吳音俗字）男抩弇南𡴖（南）𡴟（南）𤱣楠柟䶲婪葻嵐燷燣啉惏儖藍懢𩈵䆾襤籃𢉧（籃）䰐𪇖㩜蘫難𩁬（難）𩀙（難）𩁲（難）𩁩（難）𩀏（難）𩁤（難）𩁚𩁘𩁢𪇠𪇼𩁣𧆖斓闌攔蘭㘓幱瀾欄籣欗躝讕䪍𨷻㬮嘫𢛓𢿻斕潾
niɛ̃3	萳揇湳腩蝻䈒𦐃燣𠓭浨漤醂壈𨎹纜灠顲罱擥覽攬欖爁𦊔𦌫淰臉醶#兩#㒳（兩）攤灡讕懶嬾𥻂𥽭赧㫱𩈶戁
niɛ̃5	妠㔋懢䆾纜嚂濫㜮爁𨣨𤃨顲僋諵難𩁢（難）𩁬（難）𩀙（難）𩁣（難）𩁲（難）𩁩（難）𩀏（難）𩁤（難）㬮𦍀𢅼𢆃攤灘潬（灘）闌瀾讕鑭𢒞爛爤糷灠
tɕiɛ̃1	監𧨭（監）𧩾（監）譼（監）奸姦𢙶（姦）艱𡆒（艱）囏閒𨳡（閒）𨳢（閒）
tɕiɛ̃3	減鹻鹼簡#趼#𥀹
tɕiɛ̃5	監𧨭（監）𧩾（監）譼（監）鑒鑑#艦閒𨳡（閒）𨳢（閒）#降（古巷切）#夅（降 古巷切）
ɕiɛ̃2	咸（新）閒𨳡（閒）𨳢（閒）#降（下江切）#夅（降 下江切）
ɕiɛ̃5	限
iɛ̃1	㞄庵媕腤盦諳馣鵪韽䳺嬜菴葊（菴）陰霒（陰）侌（陰）𤽎（陰）𨽙（陰）𠊺（陰）瘖（陰）喑黯淊𤟟淹安侒䢿桉氨䀂鞍鞌㸶𦎣黫+殷黰#廨ㄢ#然
iɛ̃2	𡪁䜙嵁+癌羬嵒㺂碞𧇱𧬌䫡麙黬𪙊+巖𡆑礹嚴𡅾（嚴）𡽜犴豻雃楌顏顔詽㗴𤡥虤雸玵
iɛ̃3	㜝嵁顉㞄垵俺唵隌揞晻罯𤃷黤黭埯揜黯黤𪒠眼𥃩（眼）𪗙
iɛ̃5	儑闇暗顑韽揞厭淊𤟟𪒠犴岸婩豻𡹼𨲊䮗頇喭𧧑（喭）㷳䢿按荌洝胺案䅁晏𤜵偐雁鳫鴈𩾦（鴈）贋贗䁙晏鴳騴鷃𤜵汗
pʰiŋ1	砯
pieʔ7	扒別𠔁（別）别莂䇷𧧸鄨鷩𡐞憋䳤鱉鼈虌別𠔁（別）别𡷘㭭閉𩋇𡘴㔡䘷䋢㢼䌘㧙柲苾飶馝咇䏟𢛎蛂䭱𩓝襒蹩癟㮰皀偪逼楅䫾䮠㘠皕湢幅𤗚腷𥻅𤐧踾鶝煏𤐧𤏹㷶𤏛馥碧𨐨𣦢璧襞躄鐴辟𠈳（辟）𠊸（辟）秘（蒲結切）萆𣮐㱸躃𩪧椑擗辟𠈳（辟）𠊸（辟）闢𨴔（闢）𨴔（闢）𣝍𦼭欂薄（同欂）綼廦壁繴𧲜鼊㱸鸊椑甓鷿皀鵖𩾳𠦒必珌畢㓖蓽𦸩（蓽）嗶𡻞滭彃𡠚㻫㮿㪤熚𥛘𥀕罼觱篳鮅縪䟆蹕鏎饆韠鷝柲筆㻶𨅗鉍𢴩潷咇泌柲比夶（比）𣬅（比）吡坒佖邲苾怭妼𣢠䖩𨠔飶䩛馝綼駜鮅咇鮩泌佖邲𠡂𢘍䄶㢸弼𠨒（弼）𢏇（弼）𢼥（弼）𢐀駜胇#柄#不#𠀚（不）#𠙐（不）#蝙#鼻#自（鼻）#鳧
pʰieʔ7	憋癟潎瞥䫾䋢𢠳䭱氕暼瞥丿撇撆鐅嫳堛愊𤗚稫畐踾副㽬䦼𨼱（䦼）揊𢾇𩜰疈廦癖辟𠈳（辟）𠊸（辟）僻劈釽憵霹癖䤨僻澼㵨譬鵯鷝匹#枇𠯔䏘
mieʔ7	烕搣滅𣹹（滅）𢦹（滅）𥸴𥾝𤊾覕蔑𥉓㒝鴓㩢幭篾瀎懱𧂝䁾𥣫蠛衊䩏𪇴鱴𩱷粖𥌨䁇糸𢆯（糸）糹汨淿（汨）覓𡬻䖑塓幎覛漞鼏㵋冪𧜀䈿濗幦𧐎䌐𧱻羃䮭𪒄蓂覭冖冂沕宓𡶇𥄃密蔤嘧滵樒𥉴𪅮宓𥁑淧榓蜜𦸞（蜜）䤉謐𥋱𧖅日𡆸（日）
tieʔ7	㝪㑙𨓊𠲷喋笘涉𣥿（涉）㴇（涉）聑㡇墊𠗨堞揲喋㥈惵牒牃碟𣯉褋𤗨艓蹀諜褺䠟曡鰈𪑧疊疉𥷕䴑㩸㩹㲲氎䴑𨐁𨈈慴渫䁋䥡褶𡇓𨴗𥉺咥窒蛭㗧蛈僣𢶋鐵䥫（鐵）驖飻餮銕摕跌㦅苵迭垤胅恎𥑇眣𥄺（眣）瓞戜镻趃耋詄絰𨳺𢲼嵽𡼄䳀𪀒荎驖咥𠽧泆昳軼䭿姪墆𪗻摘的約嘀滴𤁷墑肑𥐝𦉹靮馰魡嫡𣂉𥕐鏑𪄱玓𨑩啇甋扚弔菂芍杓適樀蹢𨅙（蹢）㣿䶂踧䌦狄苖迪逐㣙籴荻梑笛滌蔋頔㹍敵篴𩷎䊮糴覿䢮滷籊蓧邮？翟樀䵂𧠫#淚帙
tʰieʔ7	硩𤈥詆䚐𢞒𠜓剔𠠡（剔）踢䢰俶倜逖逷悐惕惖（惕）𥉈𠊹（𥉈）眣（𥉈）𥊕䯜𩮜籊趯蓨凸摘（他歷切）跕䩞𢬴𧚊蝶（徒協切 他協切）𪔧鉆䑜帖怗萜貼跕䩞呫㡇#踶
nieʔ7	睪𥇝（睪）帇㚔𥬬踂𩣘𠕄聶䳖䌜籋𣀳𣌍㸎躡鑷業𤑽（業）𤎸（業）獦邋䃳𥪂㼲巤儠𠠌𠠗擸𡂏獵㯿𣋲㲱犣䁽𥶢䉭鬛躐䜲䪉鬣鱲𩐭鑈捻埝苶㘨菍惗敜錜𩋏籋攝暬慹𪑧㼲𦖩𡂩栵咧列𡿪冽𠛱挒𡊻茢迾迣（迾）姴洌烈煭（烈）㤠䅀𥟜（䅀）裂蛚趔颲𩢾鴷鮤捏揑苶圼𦯖㖏涅菍𦛠𡍤𦵐𤶚湼𥔄篞摰𡶫闑䘽蜺霓臬隉嵲槷嶭臲鎳齧𡿖戾𤡵（戾）唳綟盭𥃎𥸸捩夨𧈟匿㥾𧏾𩺱恧薿懝嶷觺㘈仂泐力𠠲（力）𡯄屴朸𣲒𧲡鳨𩾜𠢠屰𠱘逆𥿬縌㘙惄㲻（溺）愵𧗂鬲䰜（鬲）㽁鎘秝𧙉厤蒚歷𡿌（歷）曆𢍷（曆）𦠓𨢌㔏磿𤪢瓅壢攊藶櫟嚦瀝䮥櫪礫皪酈𥌮䍥癧𥽗䟏轢䍽𡳸䟐𪅼靂䥶𩽏䤙𪙽寥觻擽濼蝷躒𤩚淚砬立苙岦笠粒𩚷（粒）䇐鴗䶘昵㥾暱䵑䵒䘌衵栗𣡼（栗）𠞉傈凓塛搮䔁㮚㗚㟳溧慄瑮篥䬆𦃊𨍫鷅麜𣡷窵欥潏肀芛茟（芛）聿䢖矞䋖銉噊遹燏鴪𥎐𧑐𦒔繘𦇹（繘）𦈇（繘）霱𩙅驈鱊鷸膟寽律率卛（率）葎𠷈壘（鬱壘）𥭐䔞繂蛶㲕劣𦓤埒浖𢚃㭩㸹脟䟹哷鋝𨫏（鋝）#李#杍踩？銳
tɕieʔ7	#蔗（舊）耴𢬴㡇㭯輒鮿襵𦯍殜䐑㙷楫檝接菨𣶏椄婕䀹睫𥊆𥇒𣮌𣮍𣰞鯜唼䈉疌捷崨踕誱䌖倢寁囁慴攝懾霅摺謺䜆𣠞讋襵䝕慹鵖𦀖砝袷跲劫衱䀷蜐鉣𦀖𩾳㭘极笈衱㭘极笈跲昅浹㼪𠗉䕹脥梜筴莢唊𥞵鋏頰𩠣蜇哲悊喆嚞尐𢪍𠯙𧓷𩯰𪇲蠽𣧖䀿靼𩍕折晢晣浙䏳䩢偈揭杰桀㘶（桀）傑楬嵥滐榤碣竭櫭渴𣊅（渴）搩揭担𢷒楬碣竭卩㔾𢎟𠬝𠬨蝍癤𢎛𡴺岊節楶幯㸅𤁢𧞩䲙𩯰岊截𢧵䕙𦿐巀蠞𧾢𩟦拮𡔢狤𡔣袺契絜結魝潔𣳱𣚃𧍩𪃈䥛𧾯桔鍥蜈垐堲𢯩茍瞿革亟㥛棘殛蕀𧩦㻷襋悈𡕮極赩𥈜𢤋䀌䵱衋𨒪積𧐐庴踖𨅦（踖）蹐𪃹鶺𦟝脊迹𨒏（迹）跡襀蹟鯽𩺀鰿𤁢借䃊速𧫣（速）庴塉耤膌踖𨅦（踖）瘠㾊（瘠）䣢藉𧃫（藉）簎籍𨆮猎葃谻𦺩丮𤜾戟屰（戟）𢜭撠𩯋𦻝𤭏屐𨍿𨍺𢜭劇㘌𪄸勣績樍䚐𡧘𡧯諔𧧌漃𠴫寂𦼷墼約激𡫀擊鸄毄轚敫憿檄獥？鸄？獥？椺？覡？薂？䚫？𪕯湒䁒𥠋㗱㠍潗䌖蓻咠舙（咠）葺𧚨亼𠓛𠦫集雦（集）𦺴箿檝鏶慹皀𩾳給芨𦳌伋彶汲㽺急級及𢎜（及）㧀笈拾𨕤𦶍䲯苙吸堲唧㲺𧉍楖蝍㘍𢪍揤𤕺疾𤕼（疾）𤖏（疾）𥏂（疾）𠥻（疾）𤶅（疾）㑵蒺𠹋愱嫉槉𧎿𧪠吃扢曁𦤌（曁）𠕨（曁）訖䰴吉郆𤿠趌拮狤洁𧾢曁𦤌（曁）𠕨（曁）佶姞趌狤鮚秸䞘𢇓堲唧䐚即卽皍（卽）揤楖蝍𤠎𨂢𪃹畟㮨㹄稷𥞷（稷）鯽#藉#𧃫（藉）#旗#髻#者（鄉）這（俗以爲近指字 鄉）
tɕʰieʔ7	鏶妾淁睫緁踥穕䌌鯜𣠺𠟪㚲㳧㤴𦛖䧪喢謵詀𣠞𠩂㹤怯𤴼㾀魥抾胠呿匧悏㛍㤲㾜愜㥦篋屮聅硩撤徹𢖉（徹）𢕹（徹）䚢䒆撤徹𢖉（徹）𢕹（徹）澈㯙轍掣池瘛揭愒朅𡐤藒詧沏切䟙㗫竊𢿝（竊）𪙇𪙌柣𡔢𡔣契（苦結切 欺訖切）栔䫔㼤挈蛪鍥猰䩯刺措𢵄𧙞𧻕磧䟄皵洓嫧𠊬𠶸郄郤𡭴綌𧯈㝛宿戚𧠪慽慼𧐶𧒕鏚𪒑𦸗磩鼜喫毄𠿊𣪠䍊𢞒𢿣𢶡燩𥍰緝諿咠輯舙（咠）葺趿𧚨𪔪揖㬤𣉓泣湆七柒桼𢒡（桼）䣛𦸓漆𣴶（漆）㯃𣛺𪄭趌蛣詰𩢴乞䒗契鍤㤴𩂻𥯥䈎煠歉（舊音）喋
ɕieʔ7	洽萐喢䀹睫㰼歃箑霎接涉𣥿（涉）㴇（涉）𣻣䤮欇弽韘攝灄欇𥍉歙㩉葉拹㢵脅𣢩嗋𣹩愶熁𣣲蜨𧕊韘𦔼徢𡞘𤗈屟𦩌爕（俗燮字）屧䕈摺燮𤍛𤏻鞢𤫉躞䢡㛍弽䁋偞劦俠協旪（協）𢂐𠗉+挾𤙒綊勰叶齛泄禼紲渫媟絬𥝁㡜暬𣊓𣽒緤褻䊝㔎疶絏𨫔䥍（𨬝之譌）折設蔎揲鞨舌蛥歇𤢔蠍𦪬猲娎焎㚛𡘐䙽𢴲䩤擷契褉籺紇齕覈絜㹂𪕯䐼奊翓䦖𢴲頡𥊯𨵪擷𧀺𥢹襭纈息𧪩（息）鄎蒠㴧㮩𦞜熄瘜螅𥰝䭒𪄛媳棤腊䯜鬄昔惜焟𩾼𦠡舄舃蕮潟磶𩍆夕汐矽穸𨛳席𠩛（席）𥔆（席）蓆褯隙隟（隙）虩裼㭊析𣂔（析）菥淅惁㱤晰皙蜥緆錫㒪（錫）𪎥𧋐赥㤸𣣉𧨃䦧䈪鬩㦦𤄎𥍠𩎕㗩𧿅霫卌𥱵習𦸚槢隰𨻿（隰）濕䒁霫飁騽鰼襲㦻（襲）𧟛（襲）𪄶褶𨝫#吸翕翖噏嬆歙熻潝𧬈闟𪅲悉𢚊（悉）𢝕（悉）怸（悉）厀𦸝膝窸蟋𧀬僁䊝欪咭㣟恄欯莔䒗迄汔肸䛥釳仡忔肸拾#婿#壻洩辥（舊）薛（舊）血（鄉又）
ieʔ7	業𤑽（業）𤎸（業）𠄅𠟪鄴䧨㗼嶪澲𢢜㸣𩑃驜鸈𩼋䲜𩋊腌罨㡋㪑𢽱殗鄓䁆䎨䤶餣𦤡䱒浥裛𦀖腌𢽱裛𣄉魘厭嬮𣚕嚈擪靨懕曄曅燁瞱皣㷸饁爗揲殜㯿枼偞葉楪䈎鍱煠殜𩐱𦣀囁讘顳喦酓䶬闑𡴎孽㜸孼蘖櫱𣎴（櫱）𧕏蠥糱䡾钀𤅊讞钀焆𠵭𠱝暍𢉥謁閼黦抴拽苶熱咽噎蠮𤝱䊦㝣肊抑𡊁𠶷𦺳+億+薏𣚍澺憶檍臆癔䗷繶醷𩍖蛡弋芅𢓀𢖺㚤杙𢎀𢦭䄩䘝𦏵䣧隿釴翊翌㔴䴬廙潩黓熼𥡪𦔜𧑌翼𠥦𧃟瀷𩙺𨙒𤼌𧾰嗌謚益𠍳（益）𨜶𦶩膉𪕶齸睪𥇝（睪）射掖液腋亦𠅃（亦）易弈奕帟埸𡱿焲㴒痬䘸蜴墿㘁嶧圛燚懌斁燡𥜃𦔥𠓋繹醳譯𤑹驛襗𠩫艗鶂鷁虉岌㱞揖𢈈挹邑⻏⻖䓃唈浥悒𦶂裛䭂厭騽曄熠煜孴熠圪疙仡屹𧆫圪𡿪聉㔎耴𦨇𠡝一弌壹夁（壹）𡔾（壹）𡕋（壹）𡕍（壹）乙釔鳦亄䳀欥劮佚佾𢔍（佾）泆逸迭𤖍（逸）軼溢䭿鎰齸#隘疑蛺月頁
piəɯ1	髟+彪驫不
pʰiəɯ2	淲瀌𩖛
miəɯ2	鷚繆䋷
miəɯ5	繆
tiəɯ1	丟（似俗字也）？投？𢫹（投）
niəɯ1	□（以手掐之）
niəɯ2	牛𨶪摎憀㳅留畱流琉硫裗蒥嵧𤠑旒泵𥹷瑠榴劉𠭱（劉）瘤瑬疁𥰣𦃓駵𢷶鎦餾䱖䚧𪎣瀏鎏懰鏐飀騮𪕚䉧鰡鶹𣠚䬟𪆱遛飂勠𠝧（勠）䖻蟉鏐由
niəɯ3	𨙺扭狃杻䏔莥紐𦱙鈕㺲（鈕）禸𠘯𢔟𪕋瀏懰䉧𧂜蔞珋柳桺丣（柳）𣓠（柳）𦊑𨋖𩖴綹罶鋶熮嬼茆妞（高麗姓）
niəɯ5	猱狃𩚖腬糅窌畂廖溜澑畱留瘤餾嬼㙀塯廇𥛅䄂（𥛅）霤飂㽌鷚翏僇勠𠝧（勠）謬
tɕiəɯ1	揪揂啾揫𩭓鬏𣟼湫逎遒䎿蝤鮂稵龜𠃾（龜）𠁴（龜）𤕣（龜）𦫶㽱丩勼𠠳朻䡂鳩𨷺鬮㽱𠃚朻𦭺樛㢧九#灸
tɕiəɯ3	酒朻糾赳𨷺鬮九久𡚮𡚰玖韭𨾉
tɕiəɯ5	媨䅢僦愀湫就㠇殧鷲究𡫄（究）灸㝌疚救㲃廐廄𨖏𠣿𧧷廏𠤙（廏）猶𨗋𣓌臼咎处桕倃䊆舅𤷑䛮䳎麔齨𢛃蟉柩舊匶𧾻
tɕʰiəɯ1	䵸𪓰𪓵秋𥤛（秋）𪚼（秋）龝（秋）𪔁（秋）秌萩湫楸篍𦃈緧趥䨂鞦鞧蟗鶖鰍鰌𦝱䐐
tɕʰiəɯ2	鰌酋崷遒逎（遒）㥢煪䎿蝤𧤕𦵩慒囚汓泅鮂苬仇艽捄頄馗厹扏㧨（扏）叴犰朹肍𦬖求九（渠尤切 國名）氿䊵䣇俅䜪訄訅莍㭝逑釚𡨃球梂殏毬𢛃裘蛷𥭑𧚍絿𧻱巰賕䟵璆銶𩒮鼽𧒔脙𦜵蟉鷚虯觓𤙠觩璆
tɕʰiəɯ3	取糗
tɕʰiəɯ5	䞭䠗𪖛
ɕiəɯ1	修脩羞樇𩛢䡭𩝧饈休咻㹯庥脙㾋𦜵貅髤髹𩢮㵻鵂䰍烋飍
ɕiəɯ2	嗅
ɕiəɯ3	醙䤇𨤇（䤇）滫綇糔𦄼殠㽲朽㱙？投（訓讀 洋文shoot）？𢫹（投）
ɕiəɯ5	宿（㝛俗字）㝛夙（㝛）秀琇銹莠繡鏽蜏鏥岫𥥉袖褏（袖）牰臭嘼珛嗅溴齅畜
tɕʰiəɯ1	惆㲃蓲區丘㘳（丘）丠邱坵恘蚯訄𠁫
iəɯ1	妋𢕶獶𢆶怮麀憂𠪍（憂）𨗫（憂）鄾優𧀥嚘𢖒瀀櫌㱊𪋎耰纋𢆶呦泑怮幽𣢜𧍘#悠
iəɯ2	腄尢尤怣（尤）沋𣏞肬郵訧优（于求切 五穀精 如人髮白也）魷𪐤囮㘥甹抌䱔䚻繇蘨𦥝舀冘攸悠由邮油斿𨒰𠧴𠧷秞䍃浟蚰偤𦳷𣔴猶㾞遊汓（遊）𨓎（遊）游汓（游）𦵵楢鈾猷蕕蝣輶鮋𧡹𨙂櫾邎𨙃𨘺卣𠧪（卣）庮𤪎㳛兪揄𢋅
iəɯ3	眑泑怮𣢜䬀黝蚴懮䬀䱂友𠬺（友）𦐮（友）𦫹（友）𦐯（友）㕛又有𠂇（有）䒴銪䳑𥁓䀁栯㝌琇輶酉丣卣𠧪（卣）羑莠庮梄𦍶𥟁蜏𣣸槱牖𦏇𨣆𤪎㕗䛻
iəɯ5	幼𠣎（幼）忧又右佑𤴨侑囿宥祐𨳾（祐）姷𥁓䀁𦳩䞥酭𩑣蜼褎油猶輶櫾蜏𤍕槱狖柚牰釉貁鼬𪕏#誘#羐（誘）
pɪ1	襬陂波碑𥓓㽡㗗藣𥶓𨰟詖𤜑𨧦錍焷𥀍䴽羆𥀦（羆）𥀧（羆）𤰞卑埤𢃍鵯𩔹痺裨鞞箄𣴪渒錍椑悲臂杯𠤯（杯）盃桮揹悂㡙𥏠𨻼豍䚜鎞狴𦱔梐蓖篦箄𦀘螕#被㯅
pɪ5	柲粊𡛗邲毖䀣䉾閟鉍鄪䪐費沸泌祕秘轡𤰇俻𤰈備𠈍（備）㣁𣖾犕㸢糒鞴奰贔𡚤𩇯䨽絥韍䑄被㢰鞁髲旇𤿙鐾避𨓶（避）𢕾（避）貝𢂏𣬪㸬狽䟺鋇垻䰽唄茷芾𨙶伂沛㤄𥄔軷跋䟺旆背誖𢨋（誖）褙輩琲痱𢳁孛邶苝背悖鄁偝焙𤊷𤉮㻗誖𢨋（誖）𢂤蔽鄨鷩彆㡀敝弊𡚁幣獘斃罷被閉倍蓓俖
pʰɪ1	坏肧胚衃𤬃醅𩵣㾦坯抔啡
pʰɪ2	棓徘輫陪培婄毰𤗏𩑢䣙坏裴𨛬賠錇
pʰɨ3	𢁦否𠘶（否）俖㩺𢻹𡉏圮仳痞𡺮䤏殍
pʰɪ5	襬帔秛沛㤄𥄔浿霈妃朏𣍧（朏）胐配嶏潎佩珮啡
mɪ2	眉𥅮（眉）郿葿嵋睂猸湄瑂楣矀攗蘪𤃱鶥黴𦗕麋糜薇㵟䉠覹玫枚莓脄梅𣐥（梅）脢䍙媒腜䊈煤禖酶塺霉鋂䤂玟槑呆（槑省）#明（限 ~箇子）#朙（明 限 ~箇子）
mɪ3	美渼媄媺鎂𤛎每挴浼䜸燘潣
mɪ5	媢寐郿鬽媚𡡚（媚）煝魅𢑘（魅）蝞篃嚜䉋娓沬湏（沬）昧𣆜（昧）枺眜㭑瑁㺺（瑁）𤣽（瑁）莓脢䍙黴每䆀眊妹昧𣆜（昧）眛痗袂茅旀
fɪ1	非飛𩙱𦐭猆扉匪𩙲緋餥馡騑騛𩹉誹妃菲婓𥇖裶霏䬠騑䩁#啡（咖~ 洋文coffee）
fɪ2	賁肥淝𩇯腓𤷂䈈蜰蟦痱裴
fɪ3	蜚餥蜰匪榧䕁篚菲𩦎朏𣍧（朏）奜䨽悱蕜斐#啡（嗎~ 洋文 morphine）棐
fɪ5	𧙂䟛鯡誹芾疿㹃䛍𩰾茀昲費𣙿鐨靅髴䊧蟦陫䒈䆏橨膹菲蜚腓蟦𩇪翡𧕿㔗狒䀟𥄱萉𡌦䨾屝費痱𤲳𧌘䠊㵒𦦔䆏𥝋黂怫袚廢橃𤼺癈𥳊䚨䉬祓砩杮肺䑔㤄茷吠𩵥鼣
kɪ3	#給
kʰɪ5	去
ʔɪ1	噫𢤏（噫）
sɪ1	兮（限）
tɪ1	爹之（每作輕聲）㞢（每作輕聲）
tɪ3	只（每作輕聲）𠮡？者（每作輕聲）
tɪ5	對（又）
nɪ3	爾𡭗伱尒
kʰɪ5	去
tɕiɪ1	遮
tɕiɪ3	姐她（姐）毑（姐）
tɕiɪ5	借
tɕʰiɪ1	車𠦴（車）奢
tɕʰiɪ2	衺邪斜（新）#前（限 ~箇子）#歬（前）#𣦃（前）
tɕʰiɪ3	且𠀇（且）𠀃（且）撦
tɕʰiɪ5	笡
ɕiɪ1	賒
ɕiɪ2	佘佘余蛇
ɕiɪ3	寫捨
ɕɨ3	萆䈚枲葸𤟧𠪙諰𠈈𢇌徙𡕝（徙）𨗬（徙）𡲴（徙）蓰壐璽史㕜（史）
ɕiɪ5	卸寫瀉社𥙲（社）䄕（社）𥙭（社）舍赦𤆅（赦）射謝䠶麝
tɕʰɨ3	卟稽𩠜（稽）启啟啓棨䏿晵䡔㒅綮䭬闙
tɕʰɨ5	恝䏿契栔䁈𦩣𡢖𢢞䫔蟿罊
iɪ1	噫𢤏（噫）
iɪ2	爺𤕓（爺）#宜（又 便~）#𡪀（宜 又 便~）#𡨆（宜 又 便~）#𠣨（宜 又 便~）
iɪ3	野埜（野）𡐨（野）壄惹
iɪ5	夜𡖍（夜）𠙑（夜）𠙇（夜）#液#意（限 又 生~）
tɕʰiɪ̃5	晵遣繾譴䪈
tɕʰiŋ2	殑䔷
piɪ̃1	砭𥑁箯編鞭𠓠（鞭）鯾鯿揙萹猵牑煸？蝙編邊𦍇（邊）𠑟𤄺䟍籩𥣰甂蹁𨇱
piɪ̃3	𦥘貶褊㦚鴘䁵辡覸覵萹編扁𡲜（扁）匾惼碥糄藊𥣰𥤓緶𦄒
piɪ̃5	砭窆變𢒟（變）𢒪（變）𢒦（變）扁𡲜（扁）𢣑遍楩諞𧦪辡辨辯諞卞弁抃苄汴忭䒪㺹𡭪昪閞䪻匥笲㺕拚便徧㲢艑𩩯𪉱𤻶辮緶扁（薄泫切 姓也）𡲜（扁）
pʰiɪ̃1	萹扁𡲜（扁）偏媥犏㾫篇翩
pʰiɪ̃2	箯便緶㛹楩楄𧍲諞平𤔁（平）𠀭（平）跰胼楄賆㼐骿駢蹁玭琕蠙軿
pʰiɪ̃3	鴘
pʰiɪ̃5	偏騙騗#諞片䏒㸤遍徧
miɪ̃2	宀謾芇𣏜𧉄棉㮌綿蝒臱緜𢣔櫋矊矏𩕰䫵𣡠眠𥺠（眠）䏃㝰𥌂矏䰓瞑𥾃𥽔
miɪ̃3	厸𡕢汅沔勔偭𢃮湎愐緬𩋠黽免俛勉㝃娩冕絻鮸㨠芇丏眄挽
miɪ̃5	偭面𡧍眄㴐麫麪𥻩𩈹麵（俗麪字）瞑賣（本字未定 燒~）
tiɪ̃1	䀡敁掂𦕒𩬑詀佔㡇𧚊𣸸添黇舚沾厧傎？滇槙瘨𧽍蹎顛顚𩥄㒹𠑘巔巓癲齻驒槇
tʰiɪ̃2	𢙖恬菾甛甜𦳇湉
tiɪ̃3	𦒻䍄踮㸃點㓠玷𣐸栝𣕊忝䄼悿舔餂銛典婰敟碘𥮏蕇𩒝䵤琠錪
tiɪ̃5	䀡𦒻坫店惦墊㝪𩅀埝唸痁沾煔忝㐁𠀬（㐁）𨸱掭㮇𣐸𣕊栝舚扂𠂼簟㶘驔橝㼭磹殿𠿍癜唸跈殄𣦺（殄）𠂈（殄）蜓蜒𧽍佃甸淀奠電𩃿（電）鈿殿㞟靛澱壂𪑩畋填塡𥧑（塡）窴闐涏𡱂鎮鎭𨦸（鎭）
tʰiɪ̃1	天𠕹（天）𠀡（天）𦴞（天）兲𠀘䒶𦧝吞詽
tʰiɪ̃2	嗔滇佃鈿貚𦧴田沺畋䟧填搷塡𨌈䡘磌窴𥧑闐鷏鷆畇
tʰiɪ̃3	蚕町淟㥏琠晪腆䐌（腆）𤲖痶賟䠄靦錪𨆁圢䵺（圢）塡
tʰiɪ̃5	滇顛顚瑱睼
niɪ̃2	䬯黏粘搛帘㡘廉磏（廉）槏（廉）𢋯（廉）𢉧（廉）覝奩匳薕臁𣀃𥖝𩄡䆂鎌蠊簾鬑𨎷鐮籢籨襝蘞薟獫拈䬯鮎鯰溓熑薕濂濓燫鬑趁𠬝㞋𥑊𨋚碾連漣㦁䃛褳聮翴聯𤣆㺦㶌鰱𪚀𪚁槤鏈令年𠫺（年）秊姩𨛲研硏怜蓮苓（蓮）嗹憐㥕（憐）縺𪍴𨏩零𡈍（零）
niɪ̃3	撿溓䭑㯬嬚斂㰈羷䌞蘞澰瀲薟獫淰㜤姌𨸱溓𤬓稴蓮苓（蓮）璉鄻𤑿𪍦𤒤僆摙膦輦𨍻（輦）攆跈撚蹨嫨涊齞
niɪ̃5	𩅼爁斂殮𧸘瀲獫念𦁇𦁤稴碾輾漣摙𤹨㲽㜣晛㬗揀浰堜萰僆湅楝㪝𤗛煉㼑練𣿊鍊𣞰鰊#戀#𤕈（戀）𥽸#廿姩
tɕiɪ̃1	遮沾霑𪏉尖㦰䇝𩃔𩃢熸𡄑㡨瀸櫼纖𣨦（殲）𩅼虃鑯漸鋟蟾厃詹噡瞻占兼𥡝（兼）蒹𦋰縑鶼鰜𥻧鱣邅𧾍驙𩼼葏湔煎鬋𩜾栴旃氈𩔣旜饘𢐹餰飦䊕𩛻𥼷鸇𪄃（鸇）靬軒㓺犍𢳚𣘖䭈𩎀腱鞬騝𩱡𩱤甄薽籈牋椾（牋）𢃬湔𨕨箋𣚙𣝕韉帴碊籛𣽖濺瀳淺㮍轃幵趼肩菺堅猏豣豜𧱚𪊑麉䌑鵳䶬鰹鋻鑒鳽𢮂㡉
tɕiɪ̃3	𩟗颭檢瞼臉儉𠈏（儉）芡孂襢展㠭搌㜊𧎰輾皽㞡紾揃帴剪（翦俗字）㨵（俗揃字）戩𦺍齊翦𦑳（翦）𥳟鬋籛譾俴𥰸媊錢燀樿饘𠟉䎒醆㔊嫸橏𥊳𦗢䁴䆄皽䡀𨭖𩕊㔓湕𥍹蹇揵囝𢵈𦂇藆蹇謇𠐻𡾰𩽜搴𢷘䙭挸𡘸梘𢆞筧絸繭𢹕蠒𢺃襺垷
tɕiɪ̃5	𡄑𥕌嚵蔪漸𦾶螹䟅䤔槧鏨潛占劍劒劔僭䁮兼𥡝（兼）搛趝䱤襢𧝑𩥇湔煎鬋籛葥榗湔箭𥳭濺𣽖俴㣤淺𤷃𧗸踐諓餞賤𧶤（賤）諓餞顫戰建旔揭𢶆訐羯𧼨鍻𠐻楗寋鍵𡾰件鍵鑳健腱踺䇟牮薦𧲛洊荐栫袸臶瀳𨷓梘見鋻𤜵贍
tɕʰiɪ̃1	𡝫覘䑎㡨殲鹼臉僉𠑲（僉）𠠃簽籤槧憸譣纖孅韱襳㚲㾆𢃔裧幨襜䪜妗𤎥緂𢛈厱㪁𢜩𨦄䌠謙𥡝（謙）㢟梴鏈脠㿊扦𨝍遷𨔰（遷）𨙞（遷）拪（遷）𢰕（遷）𢫥（遷）𠨧櫏䉦𨙙韆騫䇂㗔愆𠐨（愆）𠎝諐褰𧽐攐䙭䞿攑千仟阡芊迁圱汘杄谸釺𪊑岍汧開𨴂（開 ）𨵑（開）蚈牽摼（牽）𢴡（牽）雃掔縴郉
tɕʰiɪ̃2	㶣誗𪏂螹朁𥮒潛䁮灊鬵𩱠（鬵）𤎢燂𢅮䕭𢸧㰊𤍙燅𤏝燖𦢨閻爓棎蟾撏𢁮拑鈐𨥩（鈐）鉗鉆箝𥮠羬黔𦌣（黔）黚雂鳹鍼廛緾鄽㙻瀍𧔊繵纏躔𨷭𧾍碊錢𧔢㳄涎赶𥴤犍揵鍵虔掮乾漧（乾）𠄋（乾）𠢅𨜻墘筋榩騝鰬湔前𣦃（前）歬𥮒𥮓騚鍼鋋儃嬋澶禪蟬單撣僤
tɕʰiɪ̃3	䤘憸脥嵰𩑳憯慊歉嗛膁㢟𣃘𧈪蕆𨩪䩶囅搌淺𧥛𠳋㹂遣𨺫𥳐𩝡繾䭤豤蜸𥧬䵖
tɕʰiɪ̃5	塹槧？壍嬱裧幨襜䪜㙴䠨韂䦲欦䇜𩒥𤬯欠𣣓（欠）㐸㪁傔邅纏邅䛹䍎芊茜𢂺倩棈蒨𧚫䑶輤篟綪汧牽摼（牽）𢴡（牽）㯠䵖菣蜆俔涀#歉
ɕiɪ̃1	綅𦃌彡𢘁銛暹憸䯹枮襳纖𡝫苫𦺭痁蘞忺杴𣞘（杴）𥟕㿌𩏩䌠妗欦㽐㾾䵌馦硟仙奾氙苮㲔僊鮮廯㒨𠑗躚䉳鱻埏脠䘰搧煽鯅羶扇挻䡣䞿掀鍁鶱軒蓒仚屳嘕𦒜嫣先𥑻酰蹮躚祆訮詽祅？身（~毒）
ɕiɪ̃2	臤賢贒礥㘋
ɕiɪ̃3	㚒陝閃𧴭𧵏𡟨睒㴸覢㛍憸譣險嶮獫玁𩏩鮮䉳𥙮尠尟獮燹𤐨蘚𤣔𤣗𧕇癬㜣㒄䁴攇幰䘆䜢憲軒洒洗銑姺冼𦭶㭠毨筅跣箲𩶤燹蜆㬎𣊡韅顯抮
ɕiɪ̃5	剡？擔贍苫閃煔掞姭脅䆎䃸㺌鼸惗鮮腺綫線𦆀絤𦇫羡羨䢭單善𦎍（善）𠾄（善）𧮟（善）僐鄯墠墡磰蟮蟺譱𪍶鱓鱔禪䄠單僐鄯擅膳嬗𤮜𦉕繕饍煽扇傓𦶋𧎥𥰢謆騸瀗獻𧾨𩆵先㪇洒䨘𢊰𥰳霰𩂪（霰）軐汛韅𩎌嫢詪䵤顈蜆俔垷哯峴晛睍鋧㦓臔𨘇見涀現縣顯軒
tɕʰiɪ̃1	燀
tɕʰiɪ̃3	諂讇𨼒幝燀繟𦆀闡䵐灛嘽
tɕʰiɪ̃5	覘䀡硟
ʔiɪ̃1	崦醃閹䣍菴葊（菴）㤿䅧懨𨣻猒厭嬮懕饜腌醃蔫焉蔫焉鄢嫣閼橪咽胭烟菸湮𡨾煙𠖜（煙）𡍯（煙）𤎟𥷀燕驠閼
ʔiɪ̃2	嚴𡅾（嚴）䉷𪙊炎阽閆塩閻爓檐壛簷𪂈㶄櫩䦲鹽𣡞𤅸𣡶㿕㾆𧦦冄呥𠯍柟袡蚺舑髯𩓾䶲冉蛅言𢍗（言）𢍬（言）訁䓂琂䇾甗焉漹䗡鋋埏䘰延郔莚狿䀽𨕐蜒筵綖䢭肰𦛦（肰）𦛡（肰）𦝸（肰）然𤡮㜣燃𥳚繎䕼𤓉沿㳂趼俓鳽妍㿼研姸硏揅𥓋緣寅𦦚（寅）𡓵（寅）㝙（寅）𢁐（寅）𡩪（寅）
ʔiɪ̃3	广𠆲𢇘㢂儼𡅝（儼）曮礹广嬐嶮隒噞顩䲓媕晻𡹮閹奄弇𢍔（弇）𥦦（弇）䣍𣃰掩揜㭺𤗎渰罨𣄉裺𩃗埯𣃧酓檿𥜒厴𧞣魘黶厭擪淡淊夵剡琰棪扊䎦𨁹閻䌪燄柟冉苒姌染𡜉䎃𥬕䣸𩃵屵𧥜𪗛巘嵃遃甗巘𤫣齴讞䟍嫣㫃鄢㫃匽郾偃褗蝘鶠鰋鼴堰䞁𧍢衍𧊔𠻤演戭縯蔩熯戁㒄橪蹨𥈔蝘躽宴嬿
ʔiɪ̃5	噞𣄝驗𪙊釅俺淹㤿裺覎㛪𦑎䛳俺𢜰猒𢜰厭嬮饜懕𢴵鹽𤅸炎燄焰焱豓𤅿灩艶（俗豓字）閻爓艷（俗豓字）灧（俗𤅿字）豔灩弇擔髯染甗彥彦婩唁囐（唁）喭𧧑（喭）諺𠷗（諺）這鬳𤬝鄢傿漹嫣匽郾褗躽堰椻㰽𡙷䞁涎羡羨延莚狿衍𠻤䢭趼硏研𤜵豜硯𨁍溎咽𥉛宴但燕酀嚥嬿㬫鷰醼讌驠𤜵
piŋ1	仌冰𣲝（冰）掤冫兵𠈯（兵）𠡿（兵）栟并幷竝屏箳攽汃邠玢砏彬斌㻞豳虨霦𥇖份𧶉賓𡫅（賓）𥦎（賓）𡧍（賓）𡪛賔儐濱𣴩（濱）𩔤（濱）𨽗（濱）濵檳㯽瀕䚔鑌顮𩴱矉#殯（又）
piŋ3	丙邴苪秉怲昞炳窉蛃鉼餅䴵併屏鞞稟朩
piŋ5	靐凭邴怲柄棅鈵寎并幷竝併倂傡摒庰偋病坪𡊞枰評併並竝鮩儐䚔擯𢷤殯𣩵𧸈鬢覕𩯭猵臏髕牝𠤎（牝）+冰㓈
pʰiŋ1	拼姘甹俜艵頩𢖊竮覮頩砏虨繽𩴱𢣐䎙𩰝
pʰiŋ2	馮淜凭㵗憑𠗦平𤔁（平）𠀭（平）坪苹泙枰胓蚲評鮃畊郱荓洴屏瓶萍𤲒蓱蛢缾䈂軿竮箳䶄獱𩴱玭頻𩔤（頻）薲嬪𡜷（嬪）𡝏（嬪）姘（嬪）𡣑（嬪）𡤁（嬪）嚬𡤉㰋蠙𦇖𧭹顰蘋𡧋貧
pʰiŋ3	品榀頩艵
pʰiŋ5	聘俜娉#噴#歕𣎵䚔𧢘𨷚𣎳
miŋ2	𥁰盟𢄾（盟）𧖸𥂗明朙鳴䳟名洺冥𥹆鄍蓂猽溟嫇榠暝銘瞑螟𧱴覭䫤𪃯玟苠旻旼岷珉盿罠㨉瑉碈鈱䁕𤸅䪸緡鍲抿笢闅忞汶渂（汶）民𠘽（民）怋䁕泯闅
miŋ3	𥁰皿𥥊眳慏茗眳溟嫇姳酩瀴䟨刡抿泯𤿕笢黽僶𨍌澠䐇#閩
miŋ5	命詺名暝䒌暋敃敏勄（敏）閔湣愍㥸（愍）𤛎慜潣憫𦌡簢𥴲鰵𨏵
tiŋ1	丁𠆤（丁）仃䦺叮玎疔虰釘靪灯
tiŋ3	㞟奵耵靪酊頂𩠑鼎鼑（鼎）薡𩕢葶濎
tiŋ5	奠磸釘𦘭矴定㱏（定）訂頂飣錠顁定㱏（定）萣啶腚碇錠廷掟振#澄#浧（澄）庭
tʰiŋ1	町訂艼庁汀𦉬烴綎𦀚䩠䋼鞓聽𦕢（聽）廳桯
tʰiŋ2	渟綎㼗廷𧖧莛㹶亭庭停葶蜓筳婷楟霆聤鼮𧓴𩹇挺娗
tʰiŋ3	徎町艼𦉬𡈼圢䵺（圢）侹珽脡𤱹䦐頲町訂鋌莛蜓霆挺涏娗梃艇𦨿（艇）誔聽𦕢（聽）
tʰiŋ5	汀聽𦕢（聽）侹
niŋ2	冰凝疑夌凌陵𨻪（陵）䧙（陵）掕菱𧅊（菱）崚淩㥄𣣋㱥𠗲祾𡕮䔖蔆綾𩜁鯪跉令𨛲寍䆨寧𣍆嚀聹𧕝鸋擰冷怜拎獜鏻〇伶𠄖刢灵阾苓囹彾狑泠姈玲柃昤𠱠㸳瓴𣬹砱秢𤫲㾉竛聆蛉笭舲翎羚紷軨跉詅零𡈍（零）閝鈴𩚹𧆺䯍駖蕶鹷鴒魿澪䕘𩄀霝霛䉁𪕌酃蘦孁齡櫺𩟃𤣘𩆜𩆚𧕅𦉢䡼醽𩆮靈𧨈（靈）𢩙（靈）䴇𩖊𩵀𢺰𤣤欞麢爧𥤞𧖜䉹𦫊𦏰龗𩆇（龗）𪚙（龗）呬岭令呤𩆈林淋琳玪（琳）箖霖臨𦣷（臨）瀶痳紉粦鄰厸（鄰）粼㷠𡑜嶙獜潾璘燐磷瞵疄麐翷繗轔𧲂壣鏻驎𩻜鱗麟駗凪（な（ぐ））輪
niŋ3	令阾柃袊䕘領嶺聹䗿𩕳䔭濘冷笭𦊓癛㐭菻凜廩𢈺（廩）𤎭澟懍檁顲嶙撛僯橉𩕔
niŋ5	凝詅令寧甯鸋佞寗濘零𡈍（零）𢺰另令臨𦣷（臨）𠐼㷠粦（㷠俗）㔂遴燐磷瞵疄麐轔鏻𠄈撛吝𠲲（吝）𠯌（吝）𠴽（吝）悋𤌎𨴙𧶆𦺸橉閵𨶄（閵）甐䗲𥳞藺𩕔䉮躙轥躪𧖔
tɕiŋ1	矜𥎅兢𠓆（兢）靑𡴑𡴏𡴐𡗡寈菁旌旍晶腈睛聙精𣻒𩓨鼱婧蜻鶄箐氏京荆𦮓（荆）荊鶁麖驚麠蟼#鯨巠𡿱（巠）徑（堅靈切 古定切）逕涇經𤔕（經）坕（經）鵛頸𩻛兓埐𩀿𪖼祲𥍯綅梫浸𥧲（浸）侵𢔀𥍯䜷駸今金𨤾（金）𨥄（金）釒衿䘳黅㦗襟𪑙禁津𦩏（津）𣸁（津）𦩦（津）𨔥（津）𦘔璡𦩨𦪉濜瑧巾斤觔筋竻（筋）䈥釿#寧#寍（寧）
tɕiŋ3	井丼𨙷肼景儆璥憼蟼警㯳頸臩憬璟暻囧煚煛（煚）剄烴䤐䭙𡩻䐶錦儘㢙㯸盡巹堇漌𧯷槿㹏𪏴謹慬菦𡎸𡏳緊胗𦜌𤷌坅
tɕiŋ5	殑殑精阱汬（阱）穽妌𩇕竫婧靖靜㣏（靜）猙睜穽淨婧䝼𩓞靚請㵾勁竟敬𣀖（敬）𢿩（敬）獍鏡涇痙儆倞誩𧮣（誩）曔𥪰競檠汫經𤔕（經）坕（經）俓徑（~直）逕（~直）𠲮弳桱𩰹浸祲濅𦺭𥧲𡫏蕈禁僸㯲凚噤䫴唫笒紟妗𤘡𦧈𦨽凚噤䶖齽鈙璡枃晉進𨙟（進）𨗃（進）搢瑨㬜縉𦎷䗯盡濜贐㶳賮壗藎濜燼贐斤巾（飾也）㧆劤靳㨷近𣥍（近）瘽僅㢙廑瑾㝻饉𠞱墐歏殣覲瘽近𣥍（近）#境
tɕʰiŋ1	硱圊清淸𠗜（淸）綪卿氫輕𨌷（輕）𨓷（輕）𨆪鑋頃頔（頃）青靑𡴑𡴏𡴐𡗡寈鶄鯖靘綅衾菳嶔欽𣣽（欽）+慶+𢞢（慶）+𢙎（慶）
tɕʰiŋ2	䝼夝情𢚏（情）啨（情）晴氰請餳𩛿䫆鯨䲔葝剠勍䵞樈檠擎黥頸𦳲葝𩷏梣䤁鈂埐嶜灊䰼𣜣𩷒鬵𩱠（鬵）灊覃𪉙（覃）𪉞（覃）𪉲（覃）撏枔𩖣鬵𩱠（鬵）鐔尋𠙛𡬻（尋）鄩𨼔噚𢒫潯樳𣎟𦠅襑𦅀鱏爓鱘𤅬䅾凜庈黔𦌣（黔）黚𨙽芩㪁耹㕋捦琴䥆𨪖（琴）𨫹（琴）𤫍（琴）珡（琴）𩰔（琴）禽𢄕（禽）雂靲擒䔷噙㩒檎澿鵭㱽堇㨷墐魿𥎊慬蘄芹勤瘽懄𥎊懃𧼒
tɕʰiŋ3	睛請#傾頔𩓏苘頃䔛𩒵㩩檾磬謦䤐𦯈梫㾛寑寢𡨦（寢）𡫒（寢）鋟𡪢𡬓顉𩖄笉𤿳𧼒螼
tɕʰiŋ5	倩凊婧胜輕𨌷（輕）𨓷（輕）慶櫦𢞢（慶）𢙎（慶）掅靘𪊑𨆪鑋殸𥥻磬硜（磬）𡔝（磬）𥓕（磬）罄唚䈜儭寴瀙親𢈥（親）𡩁（親）臤𧼒菣𠦎𩔝搇
ɕiŋ1	𨞾興鉎胜星𠻖（星）𤽛（星）皨（星）〇猩惺腥煋𥠀篂鮏曐鯹醒𠷓馨蛵忄心㣺芯杺𨊳𦁍㽎歆廞嬜鑫辛新𢀝（新）鋅薪邤忻昕欣訢炘蜻
ɕiŋ2	行陘㓝𠜚（㓝）刑邢形㼛侀型坓（型）䣆娙硎𤭓鈃鉶鋞𤬐桯
ɕiŋ3	省𡮀（省）䁞（省）渻㮐惺𢜫睲擤箵醒罧伈廞䘆
ɕiŋ5	𩜁嬹興臖幸㚔（幸）𠂷（幸）倖杏行性姓𤯧（姓）𤯣（姓）𣢝𩈡腥胜睲醒脛𩷏鋞𢙼涬悻緈脛踁？𠖶？吣沁？吢阠囟𠙷（囟）𦞤（囟）䪿（囟）𤜢信㐰（信）䚱（信）顖卂汛訙訊𧨼（訊）𧫓（訊）䛜（訊）𠱖（訊）洒奞庍炘脪𦜓㾙焮衅舋釁
tɕʰiŋ1	𡩁𡪔寴親𢈥（親）
tɕʰiŋ2	秦𣜈（秦）嗪𤚩螓溱
tɕʰiŋ3	赾
ʔiŋ1	𨿳䧹膺𦢻（膺）𧕄鷹應鉠楧㿮英渶媖瑛霙韺鶧賏嬰𨟙攖蘡瓔纓𢄋嫈褮䪯縈隌音陰隂霒𩃬侌𤽎𨽙𠊺瘖喑瘖䜾䤃霠愔韾烟湮𦎣因𤇀（因）㘻㧢茵垔洇姻氤裀陻堙婣絪歅禋𥛡（禋）𠖦（禋）銦鞇駰諲闉壹殷溵慇㶏駰𪔗鼘#甖#𠠜#罌#嚶#櫻#譻#鶯#鸎#鸚#尹#𢃵（尹）#𢃹（尹）#𢃁（尹）#𢃂（尹）
ʔiŋ2	蠅迎盈𨜏𤟣楹𦝚嬴攍䕦瀛㜲贏籝塋䁝營謍濴鎣瀠矨䀴𧵣褮滎熒䁝螢碞乑吟㕂（吟）荶䕾（荶）唫崟訡𠪚䪩坅𩂢䤁䒞撢鐔鱏冘𢓕㸒淫婬𥮍蟫𨟏霪鷣碪圻㹜斦垠㙬（垠）𡊷（垠）𡏴（垠）䓄狺䖐鄞䴦齦𪛊齗㹞垠㙬（垠）𡊷（垠）𡏴（垠）泿珢䓄訔圁狺鄞銀誾檭嚚𠽺（嚚）𡅚（嚚）𡓶（嚚）𠿦（嚚）䴦䖜𪛊𧥺㘋礥寅𦦚（寅）𡓵（寅）㝙（寅）𢁐（寅）𡩪（寅）𡐔蔩夤𦟘螾園
ʔiŋ3	璄璟𠝟㲟摬影𩘑䭘𨟙𦡺廮𣤵癭郢浧梬潁穎瀴𩳍巊僸趛𤃷飲㱃潭磭听釿齗𪙤听乚殷磤㶏𠃊㐆㥯隱𤔌（隱）嶾𤻘櫽䌥𨏈癮弞𢯼𠻤演戭縯引㧈（引）𢎢吲蚓鈏靷螾濥廴䏖岑（牛錦切崖岸也）
ʔiŋ5	譍𧭭噟應鱦賸㑞媵膡䵴孕𣎜（孕）迎詇賏映暎吟唫（吟）㕂（吟）窨䅧喑陰霒𩒻侌𤽎𨽙𠊺瘖蔭飲𤸌癊𤷜（癊）䕃䫴𪔰垽猌憖憗垽殷㶏𤔌㥯隱𠃊（隱）㒚㡥懚檼印𠘄（印）茚𩂥𣱐鮣𣌾𢯼引㧈（引）鈏靷濥𦙍胤洕𨋙酳𦞩䏖#抑
ɕiɪ̃2	稴嫌
piɔ1	髟猋䙳票𤐫蔈幖標熛𦠎瘭𤼄（瘭）𣄠贆爂飆飊驫㠒𧽤杓儦藨瀌臕𦔩𧥍鑣𩽁#彪
piɔ3	標㟽褾𧢄表𧜫（表）𧘝婊裱䔸錶𧞧
piɔ5	裱䞄俵𦳤藨𠬪𧴎莩殍㹾㰶摽膘鰾𢹰𦭼顠慓𩮳驃？票
pʰiɔ1	摽𢹰（摽）𦠎𤐫鏢彯漂翲螵旚𧽤𨄏犥飄𩙒嫖瞟𪅃僄嘌慓杓？標
pʰiɔ2	𣞈剽螵飄瓢𤬣（瓢）薸
pʰiɔ3	膘縹犥瞟篻醥顠皫麃
pʰiɔ5	摽𢹰（摽）剽彯漂翲嫖票勡僄慓㬓䏇
miɔ2	猫緢苗𡩈（苗）描鶓茅䖢𪃦蜱篻㠺
miɔ1	□（暫視）
miɔ3	訬吵杪眇秒𦳥淼渺篎緲藐
miɔ5	覅篎妙玅庿廟繆
tiɔ1	刁𠚥叼䂏凋𧘨奝蛁𦨣彫弴琱貂鼦（貂）𦶌碉𩾗㚋瞗雕鵰鯛𧜣䒒䯾
tiɔ3	隝𠄏扚𢁕䄪屌𧜣伄窵釕鳥蔦䲽佻鵃㣿
tiɔ5	悼棹㷹櫂濯𨑩弔吊（俗弔字）伄釣銱瘹窵蔦𤕷掉趠踔𤱩䂽挑窕誂嬥藋掉𥁮調嬥銚莜
tʰiɔ1	佻挑庣恌祧𥜔（祧）聎𣂁𣂀蓧朓脁趒銚
tʰiɔ2	𠤼調佻芀苕岧迢𠧪𣬸條笤𧌁樤蜩髫鋚䩦鞗䯾齠鰷嬥趒跳鮡
tʰiɔ3	䠷窱朓挑
tʰiɔ5	鋽咷窱眺粜絩趒覜𥺋頫糶踔趠？跳
niɔ1	#䩍
niɔ2	燎髎摷蟧橑暸镽（細長也）聊僚䜮膋漻憀寥㙩撩遼敹嘹嶚獠憭寮嫽璙𡽐膫𦗖𥲊竂𧂏蟟簝豂繚髎飉𩯊鷯料廖瞭鐐熮翏𦿌
niɔ3	僚憭嫽璙燎繚镽（镽𨲭 長也）𢻢爒鳥裊嫋𨲂𢴶褭嬝嬲㒟𢸣㜵䃵嬈𢄺了撩憭𤁸繚镽𧘈䑠鄝蓼𥗀爒瞭
niɔ5	㙩膫燎療樂（力召切）𤻲鷯尞𤊽熮尿脲㞙嘹嫽璙尥尦炓料𦌒鐐𩕐#藥溺㲻（溺）
tɕiɔ1	交䢒（交）郊膠𩾗茮椒焦僬蕉㲬膲燋礁蟭鐎𪚰𪚱䌭鷦𤓪噍醮䩌憍嬌穚簥驕鷮撟喬蕎激憿𥄉澆徼梟蟂驍邀釗
tɕiɔ3	#角（北語 麪食屬）狡絞㽱膘漅𤃭剿勦𠞰𠟯𢄺𠟿𨙹𥃧嬌𨝰撟敽矯蟜䚩譑孂鱎蹻㭂㡑劋𧂈湫㿟恔晈皎䘨儌𢅎憿璬皦𨶪繳䰘䥵
tɕiɔ5	敎𤕝（敎）𧧿（敎）教較校（古孝切 胡敎切）𨬛（校）𤲽（校）趡僬潐𥡤𥛲趭醮䂃皭釂爝嚼癄䩌趡噍趭劁誚𨲭轎嶠激鸄敫𢅎徼叫訆嘂噭獥藠𨎬譥譙
tɕʰiɔ1	㡑𣟼𣖄幧鍫鍬篍喿鐰𣂁？悄憍橇撬趫鞽繑趬蹺蹻䫞㚠郻𡩇𢿣鄡墽敲搞
tɕʰiɔ2	䏆𡻝僬嶕鐎劁𨝱憔樵瞧𦿕藮譙誚（譙）䩌顦撨菬嬌鷮蟜㠐轎蹻喬僑蕎㝯橋䀉𦒓趫鐈毊礄荍嘺䎗𧄍翹𤖻屶（なた）
tɕʰiɔ3	巧丂（巧）𢩨（巧）悄釥愀磽䂪
tɕʰiɔ5	俏捎陗峭帩㴥𪑊篍哨削（削格）訬譑趬㢗𠿕㚁翹撽𢵿𢶡竅
ɕiɔ1	肖（思邀切）#肖（私妙切）捎莦蛸鮹哨逍𤞚消㴅（消）宵𣆺（宵）焇硝痟揱𦐺綃霄銷魈䴛奞呺枵歊獢藃熇嚻囂𠽸（囂）毊虈㺧𤣠𩱴踃艘瞍㩋潚橚㲖翛𦐺撨箾蕭彇蟰簫𪛕（簫）瀟蠨𩙚憢䫞䎄㚠嘵膮𦟞澆
ɕiɔ2	肴
ɕiɔ3	小䒕𩵖謏㩋䃤𩵌筱篠𧩮膮曉皢䥵𠄔藠芍皛𦯪㵿笹
ɕiɔ5	孝哮效鞘韒肖削（刀室也）𥬇笑咲（笑）𠇄（笑）㗛䐹㩋嘯熽歗嬈𢿿娎
iɔ1	蟯葽喓腰䙅𧍔邀䳩要𡢗（要）𦥼（要）𠾅（要）由夭𣧕妖枖祅訞𥃩蟯幺吆𢆷𦔷𨓳葽𩑗宎𡧮怮䱂犳#耀
iɔ2	𨚙鴞𢑄洮陶恌姚珧烑軺傜摇㨱搖䔄嗂徭遥猺遙𨖈（遙）愮媱瑶瑤榣銚𣣳餆窰窯𤬖𢋇𦾺䠛繇謡謠颻蘨鰩鷂邎𨙃𨘺㫍𨙂榆褕僥垚堯𡋰（堯）嶢顤
iɔ3	芺夭殀𣧕仸崾闄抭𦥝舀𦥨溔𩨴䁘鷕䯚葽㫐苭？杳𡧮窅窈偠䆞𨱧婹𩡻㫏鴢騕
iɔ5	𧇠葽要𡢗（要）𦥼（要）𠾅（要）䌁䙅約（於笑切）趭摇搖䔄㞁筄覞𧡷曜𣇪（曜）𤒂（曜）艞燿矅耀鷂𧢢瀹讑𥌺𥌉（似𥌺之省也）𧢢鷣𣤦𤪎澆顤𠹑𪖐獟䆞𥦒窔#躍（限 躍進俗又音）凧（たこ/いかのぼり）#欲
tɕiɔŋ3	窘
tɕʰiɔŋ2	璚𢗋赹焭惸𡞦睘煢㒌𢶇𦽓憌藑𦾵𨍶？瓊嬛䂬輁舼邛𦭭桏𤤶䅃筇𦨰蛩蛬𠌖𩬰𩢽𥳎窮藭𥨪
ɕiɔŋ1	兄𧵣銎凶兇匈𣧑洶恟胸胷訩𧧗芎？酗
ɕiɔŋ2	瓊雄赨（雄）熊𪏛（熊）
ɕiɔŋ3	𦬺
ɕiɔŋ5	詗夐敻矎醟？䠗？𧽒
iɔŋ1	蕹罋邕嗈雍噰郺壅𢹭（於容切）澭臃㻾雝𧴗廱灉𪄉饔癰#庸#𠆌（庸）
iɔŋ2	𩤛喁顒鰅雄赨（雄）肜融瀜㝐容𠕺（容）䡆傛搈蓉溶瑢榕㣑熔㼸𤮇褣䈶𨲟鎔𪃾頌傭鄘墉𩫱（墉）𩫃（墉）㟾㺎滽槦𤛑銿𦤘𢧳𧴄鱅䗤𪅟嵱雄赨（雄）#榮
iɔŋ3	#永擁𢹬㨣𢹭壅臃𢶜傛溶甬俑勇勈埇涌悀恿湧塎蛹𧗴𧻹踊慂惥踴#鏞
iɔŋ5	雍（雍州）邕（雍）㙲灉用𤰆（用）𠛁（用）
tɕiɔʔ7	#橘拲挶梮𦥑㮂輂䋰䡞鋦𨦴（鋦）𧤑𦅽絭臼匊掬拘𡙳踘諊𥲩鞠鬻𠮑（鞠）告吿鞫𡫬𥩁𥷤𦥑𨸰㘲泦菊㹼㥌椈𧿻𦶗㽤閰𩬜趜𩛺䳔䱡鵴蘜𧃓巈𪈓𣐊踘𠤄鞠𠮑（鞠）毱䗇趜䜯𪁁𩣽䱡鵴驧拱局侷焗䎤跼駶垢
tɕʰiɔʔ7	𠤄鞠𠮑（鞠）𩍔麯麴𥶶䱡匤䒼蛐髷曲筁促
ɕiɔʔ7	畜嘼（畜）鄐荲𥈆蓄慉㜅𤲸稸蓫頊旭勖勗𩪉𩔴續（舊 又）
iɔʔ7	頊（人頊䪴）王𤣩玉𤣪（玉）鈺獄𡈭（獄）鳿砡澳澚（澳之譌）懊䐿噢𣢜㰲𠸹𪑝郁栯拗彧戫𨞓奧隩墺𡋮（墺）𡋸（墺）圫（墺）𡌱（墺）薁稶燠灹（燠）𤈰（燠）䉛𨪎哊囿谷峪𤞞浴欲輍鋊慾𩀑鵒𧷗唷蘛𢌻育昱堉𦱀逳淯棛喅焴蒮煜蜟毓䋭𥉑錥儥𤳕鬻𩱱粥𧶠𧷏
pʊ1	波菠紴碆嶓啵番𥸨（番）𥻫（番）皤玻
pʊ3	㝿跛簸駊播𢿥（播）𨤏（播）㨐捬掊#褒#襃
pʊ5	𢿥簸譒番𥸨（番）𥻫（番）爸（蒲可切 父也 口語不用）縛（符臥切 繩也又束也裝也）䏽瓿蔀䍌篰䴺培婄犃𩌏䏽
pʰʊ1	𨸭坡跛（人名）陂𡶅
pʰʊ2	碆繁媻搫婆蔢鄱皤𩕏䏽䍌抔捊㩠（捊）掊裒𩚭箁䯽
pʰʊ3	蔀婄剖𠞌（剖）䯽䳝叵笸鉕陂駊𡽠頗
pʰʊ5	破𡲠（破）頗䞳踣豧㰴仆
mʊ1	？摸
mʊ2	麽麼尛（麼）劘𡡉𦟟摩𢳀（摩）磨𥂓蘑䯢魔𩞁𦣆䭩母呣鷚矛𨥨（矛）𢦧（矛）鉾（矛）𥍥（矛）𢦵堥蝥蟊𧐘（蟊）𩭾繆哞牟𢃷（牟）侔劺𦭷恈眸蛑䋷謀𧦥（謀）𠰔（謀）麰鴾鍪䱕毪𨡭鞪雺+摸（莫胡切 同摹）𠻚嫫摹模膜（莫胡切 拜也）橅謨𢜯（謨）譕（謨）饃𨡭无𠑶（无）墲䉑㡔#鰻無𣟒（無）𣚨（無）𠘩（無）毋
mʊ3	麼尛（麼）嬤懡𣋟莽某呆𤵝母牡拇𤝕姆胟𠭇畞畝𤱑（畝）𧿹畮踇䳇鵡姥媽峔䥈𢜮#沫
mʊ5	塺摩𢳀（摩）磨䃺耱𠔼杼茂袤䓮貿楙愗鄮瞀𦼪懋苺姆牡雺莓仫莫（暮本字）𦮅（莫）䒬（莫）𦱴（莫）募墓慔慕𢟽（慕）暮𥰻騖鶩毋#幕（莫半切 平而無文曰幕）
fʊ3	不𠀚（不）𠙐（不）缶否𠘶（否）𡜊缹鴀痞殕紑𩂆㤱秠
tʊ1	𦰿𦷛多𡖇（多）𡖈（多）茤𨹄𨹃桗
tʊ3	奲癉哆+䫂嚲䯬揣𢭍（揣）㪜𥠄褍朵㙐（朵）朶𨹄𨹃挆哚垛埵𦀉躲躱䤪𨦃綞鬌惰橢𩊜鍺𦖋
tʊ5	癉哆跢痑陊𣵻舵拕沲沱柁柂袉詑馱䭾駄挅剁刴㛆桗跺𥞛𮃄𥞛𮃄鬌𤬾惰𢢠（惰）𢞑（惰）䅜憜隋墮嶞嫷𩊜𥳔䤻䲊𥬲𥬸惰𢢠（惰）𢞑（惰）媠䙃𧱫
tʰʊ1	蛇痑拖拕佗杝鼧䛢𧦭隋（中高四下也）䜏詑涶
tʰʊ2	他池佗庹陀坨沲沱迱㼠砣袉䍫紽䡐𡩆酡跎詑馱䭾𩉺駞駝鴕鮀鼧驒𧕛鼉㸰堶碢橢
tʰʊ3	袉媠墮𨼰䲊隋隨𨼕（隨）遀（隨）追（隨）妥㟎橢㯐鵎
tʰʊ5	拖嫷𧝍蛻毤唾𣮆涶毻
lʊ1	#囉
lʊ2	那（諾何切 ）臡𤘟挪𡖔𠹈𩴓㔮儺𩙎（儺）羅儸蘿玀𤄷欏籮鑼饠剆囉䎠捼蠡𢍝（蠡）𥯵（蠡）腡𥡜𦿌螺𣜄𥢵鏍騾覼𧄿驘鸁𩼊𨰠蠃摞㚢奴孥砮𠪓（砮）𠩨（砮）笯駑帑蘆邏
lʊ3	袲𨙻那（奴可切 何也）娜哪橠㡅𣍓（㡅）𢄴𩝢欏剆砢𣂞𠻡㰁㩡鎯㦬曪㛂𢫷𧝹卵𦝠倮蓏裸躶瘰𦝠𦟀蠃臝（非口語詞 如赤~~）㒩𤼠孥砮𠪓（砮）𠩨（砮）努弩𧉭胬怒𢘂（怒）擄（又）虜（又）#卵（限）#煗#㬉#煖
lʊ5	那（乃箇切 語助也）奈郍㿚𧟌堧稬懦穤𤲬愞𡰠𡰟摞漯𠏢䇔𢺑㱻䌴笯怒𢘂（怒）
kʊ1	妿㤎滒鴚菏柯牁戕戈𩾷緺㽿楇𩰬𩰫瘑㗻鍋鈛𩰭𨍋過𧒖堝渦撾咼
kʊ2	果
kʊ3	笴哿舸𥰮鐹果菓猓惈蜾裹粿輠餜䴹划錁𠜴
kʊ5	鐹裹㳀過𧒖𩟂划騍
kʰʊ1	𠳊珂軻䯊㽿㸰科萪嵙犐稞𠏀窠薖蝌䈖髁課簻#顆#裸#𡑤（裸）𧝹臝（非口語詞 如~軆 ~奔）躶
kʰʊ3	軻坷岢棵顆敤堁
kʰʊ5	蚵軻坷艐科髁敤㪙堁𡱼課騍㾧
xʊ1	#煆#蝦#鰕抲呵苛㱒訶𩑸
xʊ2	何河荷菏魺苛蚵咼㗻禾䒩咊和𤖱盉鉌龢胡
xʊ3	㪋㰤𩑸㪃㗿火𤆄（火）灬伙邩𨚊鈥夥𨘌
xʊ5	呵㰤何苛荷賀㵑𧝂袔化貨䞈（貨）𣱷（貨）輠夥𡖿𥙯𥚁𣄸禍旤（禍）𥚍（禍）𣨷（禍）和咊（和）龢（和）盉俰付#囘？活
ʔʊ1	阿錒妸妿屙娿婀䋪疴痾鈳濄倭萵渦涹窩撾𡑟踒𥟿#蝸（北語新嵌者 非）猗#鵝#䳘#䳗#鵞
ʔʊ2	俄莪峨峩涐娥䄉睋蛾誐鋨鵝𩒰哦硪䳗䳘吪囮訛鈋魤僞譌𠂬橢（類篇吾禾切 堛鼓）
ʔʊ3	騀𩒰我𠨂（我）𢦓（我）𢦠（我）㧴硪妸娿𧙃𣘨𨵌椏㫊𠂬㛂倭婐𥟿
ʔʊ5	餓侉啊臥涴#話#𦧵（話）
tsʊ2	#喌
tsʊ1	喌
tsʊ3	𠂇左㝾#佐她
tsʊ5	左𠡃㝾作胙（作）𢓓（作）袏挫夎侳坐㘸（坐）𡋲坐㘸（坐）唑座作（後專作做）胙（作）𢓓（作）做
tsʰʊ1	搓𢷼瑳磋蹉𪘓傞溠遳初䥚（初）
tsʰʊ2	艖瘥𥰭醝䖕虘蒫嵯嵳𣩈䣜蔖㽨䑘䠡䰈䴾鹺𨇃𪘓齹𪙐（齹）躦㭫睉矬痤銼豠耡𧱑鋤𪆷鉏？麆？雛？芻
tsʰʊ3	瑳䰈硰脞䂳
tsʰʊ5	磋摧剉莝𢯽銼諎厝𢵄措錯䥘（錯）㳻趣
sʊ1	沙挱䤬𩊮𠈱娑戲桫傞挲𥆝獻㛗莎魦莏唆𢘿梭蓑𠱗（蓑）𡔤（蓑）羧趖𧨀髿𣜤梳些（些邏 麼些禿光些）
sʊ3	褨縒娑葰惢𧴪䣔𢱡嗩溑瑣𥔭䈗鎖䵀𩹳所𢨷（所）
sʊ5	䐝沙逤+些
pʰɔŋ2	帆𩗋（帆）颿
puõ1	𠦒般𦨗（般）搬䈲𤳖籓
puõ3	瓪昄粄䉽䬳
puõ5	半𠯘姅㪵絆靽𩢔伴㚘拌伴秚畔𡞟
pʰuõ1	拌番𥸨（番）𥻫（番）㢖潘㽃𤺏
pʰuõ2	般𦨗（般）瘢䈲磻繁幋媻𤠍槃搫磐𥈼盤縏蹣蟠鎜鞶𣎤（鞶）䰉𪄀𪒀柈胖
pʰuõ3	坢𧺾
pʰuõ5	姅眫冸伴判沜泮片牉頖胖叛
muõ2	顢悗㒼慲樠鞔瞞𦔔䊡䟂饅鬗䜱曼墁漫蔓𤡁槾謾鏝芇絻蹣
muõ3	𢟮滿𡈪（滿）蟎𥲈鏋懣
muõ5	𦔔墁幔獌漫𢿜熳縵䝢謾鏝+幕（莫半切）
tuõ1	剬偳𥠄端褍𧤗𦾸鍴𥵣耑竱
tuõ3	𢭃短𢷖斷𣂢（斷）𠜷（斷）𠝅（斷）
tuõ5	踹断瑖腶碫鍛斷𣂢（斷）𠜷（斷）𠝅（斷）緞𩋦𩏇斷𣂢（斷）𠜷（斷）𠝅（斷）籪段𠩻（段）椴毈
tʰuõ1	偳湍煓貒䵎𪏆
tʰuõ2	敦𢼪（敦）𠧈（敦）摶團漙慱𧐕篿𩅂糰𥻁䊜鷒𪆃剸鄟
tʰuõ3	𩏇䠪瘓𤲫疃𢣎䜝
tʰuõ5	貒彖湪褖
luõ2	濡䜌𤔪（䜌）𧄶𢺈圝巒欒曫灓㱍羉𤼙臠圞灤鑾鸞堧繎𤲬㨎䙇擩撋瑌奻䜌𤔪（䜌）孿攣𤼙𤼣
luõ3	渜湪（渜）㬉暖煗餪稬煖卵阮㞋𢘎蠕𤲬耎軟偄䓴愞瑌㮕需㼱𠬫（㼱）腝碝𠤦蝡緛輭䞂脟孌𡢛（孌）臠𡡗
luõ5	渜湪（渜）𪋐稬偄愞需灓𤔔𤔒（𤔔）𤔐（𤔔）亂𠧎（亂）𠧏（亂）𠮗（亂）𢿢𤲬奻䜌𤔪（䜌）孌𡢛（孌）灓糯
kuõ1	官𠕍（官）倌棺𣑄（棺）觀𥍊（觀）𥸑（觀）𥷯（觀）莞毌冠涫貫悹
kuõ3	筦痯䘾䗆管輨錧䩪悹盥灌琯斡脘
kuõ5	棺𣑄（棺）觀𥍊（觀）𥸑（觀）𥷯（觀）莞痯䘾舘錧館毌冠涫悺婠貫悹果祼𥚌（祼）𨝑遦樌盥雚䗰鏆灌瓘爟矔𤼐罐鑵鸛鱹懽㷄𥆗巏綰
kʰuõ1	寬完（寬）髖
kʰuõ3	棵梡欵款歀窾䥗䲌
kʰuõ5	䥗䲌
xuõ1	犿𠂄鴅𡚊酄獾懽歡𧆒（歡）貛讙驩𪈩貆
xuõ5	嚾灌奐喚渙煥烉（煥）𥈉𡅽喛
ʔuõ1	婠剜帵蜿豌眢
ʔuõ3	盌椀碗䝹#𦞿#腕
ʔuõ5	捥睕惋琬
tsuõ1	劗𣀶欑䡽𩎈𩎑鑚鑽攢撮𡰝湍摶篿鷒𩠹叀專𠧡（專）𠧢（專）𡵏（專）剸鄟嫥瑼甎膞磚諯顓鱄
tsuõ3	儧儹鄼繤𦆈纂𥎞纉䂎籫纘𣓧轉剬剸膞鱄孨𡇰𦓝竱𨷱
tsuõ5	𥎞欑䂎鑚鑽攅沌摶䧘堟瑑𦁆篆傳𦁆剸
tsʰuõ1	剶猭川巛氚穿灥
tsʰuõ2	㠝櫕𥣚𥣪巑攢欑鄼酇穳襸菆劗𩍴躦𩎈鄹椽傳遄𨒎（遄）圌篅輲歂椯輇諯舩船
tsʰuõ3	㪜舛荈喘㦃𥽽
tsʰuõ5	躥鑹殩奧竄𥨒（竄）爨𤑖（爨）𥎞䂎猭鶨穿串（穿之乖）賗𠢏釧玔竁諯篡
suõ1	狻痠酸𨢽（酸）䝜𩆑
suõ3	匴算篹選
suõ5	祘笇蒜筭算踹歂腨𦺲𡭐鄟膞𢮛叀𢮨團
ʔuõ2	刓抏岏𠒢䯈忨园蚖羱黿䎠莞雚𢘆㿪荁峘狟洹桓萈萑寏絙貆綄𦼉䴟豲𦏊瓛梡丸芄汍完紈捖烷𩾞院垸
ʔuõ5	玩貦忨翫妧𧶲澣綄㬊䈠緩𦅻（緩）𧡩浣嵈鰀棵梡晥䁔
xuõ5	肒䀓𤴯逭𨙕（逭）換漶䯘𩁧垸
tsuõ5	傳轉囀
poʔ7	茇鮁癶盋袚缽鉢發撥𩯌驋鱍䢌䳊襏筏𦪑帗㤄犮坺拔茇𢇷妭胈炦癹𧺡菝𧺺軷跋魃颰䮂鼥䟛鈸䯋馛䳊𩃶䚨䣮？百（限 ~葉）
pʰoʔ7	鱍𥄱𢯸㧊𧘟䍨𦫔𠷑𣸍潑𨡩鏺䣪𨂩𣎵
moʔ7	䀛韎𣝖（韎）瀎𨣱𩱷抹末𠇱𡊉茉沫𢗿妺昩眜秣𦫕𥬎粖䬴𩑷靺𩿣䴲䱅𥽘苜袜
tuoʔ7	祋剟掇敠裰？鵽腏兌敓敚痥𡙜奪𡙸（奪）𡜎（奪）鮵挩莌
tʰuoʔ7	挩侻莌脫棁梲說
luoʔ7	蛶㭩㸹𠜖捋呐㕯㨎蚋蜹焫𤑔爇擩妠𤬷袦肭豽貀㕯
tsuoʔ7	撮𩯳攥繓𫏎柮啜惙輟𨌸（輟）剟掇腏畷綴醊餟𧖀叕罬䟾𩋁䖦準拙炪䂐𠭴蝃䪼䫎梲𨢬？朮𦬸炢茁𦦖𠭴咄
tsʰuoʔ7	撮襊𤿫啜歠吷㔍䵵
suoʔ7	說𠞩率（所律切）卛（率 所律切）+摔帥𠌭䢦𧍓𧜠蟀𧗿𧗵（𧗿）咰潏秫朮述沭術袕噊𧑐驈鱊
pɔ1	𨚔𠅬勹包佨苞胞笣枹#鮑#抱#褓#緥#寶
pɔ3	𠤏𡥀𣎼保𤔍（保）𠊻（保）珤䎂堢葆堡駂褓鴇緥賲寶寚（寶）𠋾（寶）宲飽𩜿（飽）𩜕（飽）𩛞（飽）𩛁𩝰呆
pɔ5	報抱勽菢袌𤔣暴𣋴（暴）虣𪇰瀑（疾雨也沬也）#瀑（俗又音 飛泉懸水也）豹𢖔#爆（俗又音）𧭤䶂孢骲𡂟鞄鉋靤骲鞄疱皰
pʰɔ1	藨㲏䫽㯱𨚔胞𢿏䍖𦫶𠐋抛拋脬泡
pʰɔ2	包袌袍軳齙鉋颮謈麃瓟尥刨咆狍庖炰匏鞄麅跑泡炮胞㯡捊㩠（捊）掊
pʰɔ3	#跑（又音）
pʰɔ5	窌抛奅𣶐炮疱皰麭礮#泡
mɔ1	#䤓#貉#冒#𡈘（冒）#𡇾（冒）
mɔ2	毛枆牦耗旄酕覒堥𣹪髦氂錨芼楙㮘犛貓茅罞蝥鶜描媌#矛#𨥨（矛）#𢦧（矛）#鉾（矛）#𥍥（矛）#貉#濛
mɔ3	𠔼蓩冃䓮媢茆緢卯𩇨𩇧𤕰𦕔戼峁泖昴鉚笷媌
mɔ5	毛旄冃芼𤣽㺺眊耗冒𡈘（冒）𡇾（冒）耄䋃覒𢯾帽媢瑁𣔺𦹾𥈆𩿂𧂕㲝緢皃𢂹䡚貌𧳒（貌）𢅉䫉
tɔ1	刂裯刀忉朷氘舠魛𩕯叨（俗音）
tɔ3	懤倒島禂搗（擣俗字）㨶（擣俗字）㠀壔擣𢶈禱𥛈（禱）𥛇（禱）㿒𤺜（㿒）䮻檮道（說三~四）
tɔ5	倒禱𥛈（禱）𥛇（禱）到𤓾菿𧛔𡬲洮道𨕥（道）𡬹稻衟𣜦䆃𨱵駣儔𠍻（儔）幬蹈𨂆（蹈）盜𠪁（盜）𠉭（盜）𤋆（盜）𨹇（盜）䆃翿䊭䌦纛𠺛𨱵燾
tʰɔ1	夲𠌪綢叨翢𠦎𠬢𠦂弢𤘸掏絛詜搯幍滔慆瑫槄𠚜䈱縚謟㹗鞱韜𩥓饕洮蜪挑𠚡
tʰɔ2	翢翿錭掏濤燾匋咷逃𨒯桃跳籌陶萄啕淘䛌裪鞀蜪綯絝（綯）鞉䛬駣騊檮鼗䬞
tʰɔ3	槄討𡘷#蹈（又音）#𨂆（蹈）
tʰɔ5	導𡭎（導）韜鞱套（俗字）
lɔ1	#撈#繞
lɔ2	峱猱𢜸䛝嶩巎獿𤫕農䢉（農）𦦥（農）辳（農）𨑇（農）𣊤（農）𨑋（農）𨑆（農）𦦤（農）莀（農）㺜憹𤣜訄臑撈牢𡘠（牢）窂哰㟉樂（魯刀切）勞𠣁（勞）𢥒（勞）㗦𣘪嶗𨦭𤩂憥䝁醪蟧簩𧰉鐒髝嫪澇䜎䜮𦗖簝呶𣲿怓硇撓𡽧鐃䴃䫸𥗰㺜𥗸𣳦譊窌顟𠐋賿橈襓饒㹛蟯蕘
lɔ3	𠜶匘堖㺁惱㛴瑙𨱵腦碯𧳦𩔇老𠄰（老）佬荖恅栳銠橑𡂕䕩轑䝤䵏𣠼澇獠潦撓獿㺒嬈𤛾𧳨擾𢹎遶繞
lɔ5	𨱵腦腝勞𠣁（勞）𢥒（勞）僗癆髝嫪澇橯耮𣟽潦𠆴淖掉閙鬧橈饒繞膠
kɔ1	㤒皋髙高告羔䓘髙𣓌䣗臯䔌㟸槔𨝲睾膏𦺆槹𡼗橰篙槁糕䚌䆁餻櫜𧢌鼛鷱咎倃艽芁交茭𦺏（茭）䢒敎𤕝（敎）𧧿（敎）蛟䍊𥹜𩎔膠鮫轇㶀佼（同交）鉸教摎嘐鵁詨䉰咬
kɔ3	𣓌夰杲㚖菒𥓖槀稿稾縞藁藳暠咬姣㚣（姣）校（古巧切）㽱佼咬狡烄𢯴筊𢽻絞鉸𥂔䀊攪䕧䉰皎㺒
kɔ5	高髙膏縞吿告郜誥𢍎（誥）𧧞（誥）𧧙（誥）誥鋯𣝏烄𢼂敎𤕝（敎）𧧿（敎）膠鉸𡥈珓教窖較滘酵覺覐（覺）𧠭（覺）校（古孝切）𨬛（校）𤲽（校）絞（繒黑黃色）
kʰɔ1	尻訄鄗礉跤骹膠㺒㤍䂭敲䯨（敲）搞墝頝磽
kʰɔ3	槁祰槀燺熇撟丂考攷拷洘栲𥬯𣩅薧䯪㼥䲾
kʰɔ5	稾熇薧䯪𧋓犒槀槁靠𩝝𨃤礉敲䯨（敲）焅梏搞巧（僞也）丂（巧）𢩨（巧）膠
xɔ1	𣐾蒿薅𦵢𢫩鎒𦼸𧯌薧撓茠嚆嗃嘮灱虓詨呼㹲庨唬猇窙嘐㺒𩾾藃穘髇䬘哮涍顤
xɔ2	獔䫧𩕍𨚙毫𡨉（毫）𠢕嗥獆噑豪𨼍𣘫獋壕嚎濠蠔號崤姣㚣（姣）膠㬵唬胶絞笅筊猇洨崤淆㮁𨠦𦺔㤊肴䂚倄䋂殽餚告勂
xɔ3	好𡥆（好）𩐔（好）𡚽妞佼䀊㺒䕧䉰澩
xɔ5	好𩐔（好）𡥆𡚽秏耗藃夰𥢑鎬昊昦𨛴浩晧皓鄗滈暭薃𧇼顥鰝灝号號𡠖㙱𤩭𧬁嗃哮涍校（下巧切）詨𡦳㤊効俲詨𣱓斅斆㩭檄
ʔɔ1	𤏶鏖䥝熝㕭軪䫜坳𠣑咬眑窅梎爊𧘳
ʔɔ3	芺㤇镺媪媼襖𪁾䯠懊䐿郩夭𣧕䴠燠灹（燠）𤈰（燠）蝹拗𥃯𢂊狕鴢𥃺老𠄰（老）
ʔɔ5	镺奥奧嶴澳澚（澳之譌）懊䐿䜒𩟇𩼈隩墺𡋮（墺）𡋸（墺）圫（墺）𡌱（墺）+燠+灹（燠）+𤈰（燠）拗軪㑃岰袎靿箹
tsɔ1	傮槽𦵩遭㡟𣩒㷮糟醩蹧謿嘲鳭䞴啁鵃罺摷𠿈𦗔抓朝晁（朝）𦩻皽招昭盄釗鉊鵃
tsɔ3	繅𦃨（繅）早蚤棗𠂲（棗）璅𧎮澡璪薻（新 海~）藻（新 海~）𧃡繰䲃䝤獠爪爫㕚#找（北來語 俗字 暫代覓尋義字）𦬔𢁬䝖瑵笊抓沼菬䈃
tsɔ5	灶趮躁竈草皁皂𦯑唕艁鑿漕𢲵䞴罩䍜䈇鵫癄笊㾭抓䰫㑿巢駣兆𠧞垗狣肁旐䍮趙肈肇鮡召𠧙炤𨹸詔照曌+早造（昨早切）
tsʰɔ1	操𢻥幧㡟趠䫸灱嘮抄訬鈔𦾱䜈䰫𠰉𢁾怊欩超䫿怊弨紹（緩也）吵（人名 宋大夫吵）哘（哘さそ（う））
tsʰɔ2	曹蓸嘈漕（䘙邑）槽䐬䄚褿䏆螬𧕐（螬）艚𤵥𣍘𩫥鐰䄻訬巢鄛𡏮𡻝樔轈𣝞勦晁朝潮鼂𪓨（鼂）𪓲（鼂）𪓙韶𢨍（韶）
tsʰɔ3	艹艸草屮（草）𠹊愺騲慅懆抄吵（聲也）訬（同謅）㷅𤑵炒𩈎𤌉煼𩱈𩱦仯謅㥮巐弨眧麨𪍑楢藻𧅂薻
tsʰɔ5	操（七到切 所守也持念也）躁（字音）噪糙肏㿷鼜慅鄵懆鑿𨰒（鑿）艁慥造（七到切 昨早切）踔趠抄訬鈔罺仯耖𦨖觘縐朓脁訬（輕也）
sɔ1	搔𠋺溞叜（溞）慅繅𦃨（繅）颾騷鰠鱢臊㮴𣔱艘䑹繰鞘捎莦弰娋梢䘯蛸筲艄旓輎𡡏䈰颵髾鮹綃燒𤬖#淞
sɔ2	𢃳𢑦玿㸛𦯐韶𢨍（韶）㲈𠧙柖軺佋
sɔ3	㛐掃嫂㛮䕅𦺋埽糔捎梢稍𡡏髾𨈘𢾐䔠𧣪𦿃𥵦𦓴潲搜少𨙹䒚
sɔ5	掃埽瘙㿋𢤁髞喿？噪譟燥娋捎稍削𨛍𦓴潲𣕇揱袑紹䙼綤佋𠧙卲邵劭𠣫䬰召+燒（放火）少掃𢜶
ʔɔ2	敖嗸嶅遨蔜嗷廒滶璈𣘢獒𢧴摮熬𤏺聱螯𦪈翱謷䦋翶翺𩪋𩪕鷔鰲鼇嫯鏊䫨驁磝聱謷𢿣爻
ʔɔ3	𩑤𦽀咬齩
ʔɔ5	謷鷔奡傲嫯鏊䫨驁磽𩳔樂
lua5	䐯
kua1	瓜㧓緺騧媧蝸婐𤓰歄緺騧𧬭腡媧蝸
kua2	呱
kua3	𨀩冎剮𠊰䈑寡𧤐𦫳𣑍𣐷𥦛𠁥
kua5	坬𧬮卦挂掛罣詿褂𡐠
kʰua1	夸𠇗姱䠸誇𧥢（誇）䯞胯跨垮跨（俗字）
kʰua2	□（以利物刮）
kʰua3	髁垮（俗字）㡁𢄳銙𡕒跨骻
kʰua5	𡕒胯跨
xua1	花蘤（花）華䔢（華）嘩鷨譁𧪮𦶎𠿎𡁑𩝨化𠤎（化）𠯒（化）𠏁（化）#話#𦧵（話）？活
xua2	划找華䔢（華）嘩鋘𧑍鏵驊鷨崋𡼙（崋）樺譁釫
xua3	□（靡）
xua5	𠤎化𠯒（化）𠏁（化）杹𩲏𩵏諣輠䴹𢦚𡱏觟𦖍黊𩸄蘳稞鱯華䔢（華）㕦崋𡼙（崋）摦樺檴罣絓詿畫𤱪（畫）𨽶（畫）𤲯（畫）澅黊繣孈纗話𦧵（話）噺（はなし）孬
tsua1	撾𥬸檛膼簻髽𩛠侳？抓#捉
tsua2	□（做事ㄚ合）
tsua3	䊬#爪#㕚（爪）
tsʰua1	脞㛗
tsʰua3	䂳𤔙
sua3	葰𩈥傻#儍𧫝？耍唆𤔙
sua5	誜
ua1	哇洼呱畖窊搲（手捉物也）蛙䵷（蛙）+娃窪溾瀤𪊉洼䴜崴碨蛙䵷（蛙）鼃汙
ua2	𣢉𩨾娃（暫代 北人呼子）
ua3	瓦邷佤搲
ua5	窊攨䠚䶐懀䵳瓦圷（あくつ）
kuæʔ7	#𠯑#𤯁#䒷#䯏#鴰#劊#聒#𠅪（聒）#𣽅#𦸈#檜#佸#活#𢬸#括#𣐸#栝#葀#萿#筈#頢#髺#懖#𦗾#适#𨓈#銛刮劀鴰䄆趏颳劀𠟽鱊狹
kʰuæʔ7	䯇
xuæʔ7	#𤃴#豁#眓#奯#𧯆#濊#𣁳#泧#𣽅#姡#佸#䄆#秳#鬠䀨傄敌𠯑𤯁（𠯑）姡𦧠𤁪咶頢舌鶻猾滑磆螖𧽌䴳䱻
tsuæʔ7	鵽錣窡鵽綴聉娺窡𠿡䵵茁
tsʰuæʔ7	醛
suæʔ7	刷唰刷㕞唰𠴪𠻜選
uæʔ7	㱚䎳䚴刖聉𦤙𦘍嗗婠穵挖䯉嗢𣁳㒝襪韈韤𥄎
tsʰuæʔ7	𤁫䫄
kuaŋ1	光炗（光）𤎫（光）𠈑（光）𤉭（光）灮侊垙茪咣洸珖胱輄僙𨎩𩧉桄橫（漢門名）恍
kuaŋ3	廣鄺𠏤獷臩逛迋
kuaŋ5	光炗（光）𤎫（光）𠈑（光）𤉭（光）桄𠉫㤮臦誑俇誆狂𢚇（狂）
kʰuaŋ1	䯑匡邼劻䒰哐洭恇䖱筐軭𩬹𩢼框眶硄
kʰuaŋ2	㞷呈（㞷）𡴍（㞷）軭狂𢚇（狂）軖鵟
kʰuaŋ3	䡉夼懬爌
kʰuaŋ5	壙懭曠𣊥（曠）爌矌纊#礦况況𡶢（況）
xuaŋ1	㠵巟肓荒𠃤（荒）𠯚（荒）㡆衁𣆖䀮𣺬𥿼𥡃𩣐𧧢𧧮鄺#惶
xuaŋ2	撗皇𦤍（皇）𦤐（皇）𤽙（皇）𤽚（皇）𤽧（皇）䍿偟𨜔凰隍堭黃𡕛（黃）皇𦤍（皇）𦤐（皇）𤽙（皇）𤽚（皇）𤽧（皇）葟崲遑徨湟惶媓𨝴煌䅣獚潢璜蝗篁艎磺卝（磺）癀蟥簧𤯷𤰀（𤯷）餭趪韹騜鰉鱑
xuaŋ3	𣆖忙㤺慌㬻𡧽詤𧧢謊䁜爌怳詤𧧢𧧮謊
xuaŋ5	荒𠃤（荒）𠯚（荒）攩晃幌櫎滉榥皝攩潢擴暀𣍦貺𧵮（貺）軦
tsuaŋ1	妝㽵莊𤖄𤖈𦻊𠗎𤕶粧䊋裝𣻛樁
tsuaŋ5	䊋莊（篇海謂側亮切 恭也）𤖄𤖈𦻊𠗎𤕶裝壯𣴣狀戇憧艟䡴僮撞幢𢤤漴
tsʰuaŋ1	𠛂瘡創𠝀（創）𠛲（創）戧憃䄝𥡟𧜧䚎窓窗𡆧（窗）牎摐䆫䎫囪囱𥍷鏦堫
tsʰuaŋ2	疒牀𣃘𩪘橦撞幢𩞐淙㼻鬃
tsʰuaŋ3	搶𠞮傸㼽磢愴搶漺䫪#噇#䭚
tsʰuaŋ5	滄𣶟（滄）𣳁（滄）刱剏創戧（創）𠝀（創）𠛲（創）愴䚎𥈄䎫
suaŋ1	蠰霜孀騻鷞驦鸘瀧雙䉶艭䝄𨇯𢥠緗
suaŋ2	雙□（）
suaŋ3	㼽鷞爽𠙠（爽）𡙁𤕤塽漺樉𦄍䫪
suaŋ5	淙㦼霜
uaŋ1	洸尪𡯪汪𪁘𡯁尣
uaŋ2	亾亡莣忘？朢王彺蚟𩵭橫（松江音）
uaŋ3	㳹瀇网罒𠕃（网）𦉽（网）𦋟（网）𦉮（网）𤣴𡔞罔𡦽（罔）𡧏（罔）菵惘棢蛧𦖉網輞誷魍汪枉𣒈（枉）𢼟𣢫𢽃往𢔎（往）𨓹（往）暀
uaŋ5	汪䤑汒妄忘望𦣠（望）朢𧫢㤮王暀迋𣈧𣇭旺（𣇭俗字）往𢔎（往）𨓹（往）
luaʔ7	硦
kuaʔ7	郭崞𩫏𨟍𦘅椁㗥槨廓𢌓（廓）彉彍埻䣤𡚠戄𧾵貜
kʰuaʔ7	漷？廓？𢌓（廓）㗥噋𠠎擴鞟鞹𩌒（鞹）籗籱𢖦躩
xuaʔ7	劐䁨霍攉藿𧆑瀖矐癨靃彉彍霩擭濩𩆀𢋒𤻙㦜檴𤐰䨥+穫鑊矍攫𡚠玃彏𧾵𨏹躩貜钁𪈴蠼矆䂄戄彏謔#畫（又）#𤱪（畫）#𨽶（畫）#𤲯（畫）
tsuaʔ7	㘀斮𢧉（斮）菿噣孎桌倬涿卓𠤞（卓）𠤚（卓）𠤟（卓）𢂚（卓）㧻𢁁啄（書又）啅焯趠琢𢽚晫䐁斲諑斀𥢔椓㪬鸐鸀嬥濁𢢗擢㺟濯鵫𧃔蠗鐲𩑂𢺡𩆸捉穛𥼚穱斮𢧉（斮）篧𧂒簎捔澩汋丵浞𤉐𨖮鋜篧𢋱灂鷟齺棹櫂
tsʰuaʔ7	㪬逴踔戳趠晫𥭓䃗娕娖擉齪𪘏齱
suaʔ7	數朔𣍮（朔）矟搠蒴㮶𦋞槊𦂗欶嗽嗍揱箾
uaʔ7	瓁鸌雘蠖臒𩟓嬳臒嬳濩𡤬𧤽𧅚䢲籰𥸘齷
kuɛ2	瘸
kuɛ1	乖𠁰（乖）𦮃𠦬㾩𦫳
kuɛ3	踝𦫳枴柺𡐠𠁥
kuɛ5	㧔怪恠𥑋䃶（𥑋）𡌪壞（毀也）𡎯（壞）𣀤𣀩𦳋夬叏䈛獪挂會（~計）𣌭（會）㞧（會）𠃐（會）㣛（會）𣥈（會）
kʰuɛ1	絓𦹬䓙咼喎䦱匯㨤㔞#攜擓
kʰuɛ3	#蒯
kʰuɛ5	塊噲𥵊璯駃𢘦快筷𥢶凷塊𡓤墤䈛㕟蕢𤆂（蕢）嘳嬇
xuɛ1	#虺#虫（虺）
xuɛ2	蛔淮槐褢褱㠢瀤懷㜳櫰𤜄𧞷蘹𪊉？鼃壞（壞隤）𡎯（壞）
xuɛ3	？扮（亂也）
xuɛ5	？諣？咶？咶？𣸎？𧱳？𣟉？躛𡎯壞（自毀也）蘾
tsuɛ2	#轉（暫代）
tsuɛ5	㧳
tsʰuɛ1	衰𠆂（衰）𠌺（衰）夊？揣？𢭍（揣）崔
tsʰuɛ2	尵𩓬膗𢶀
tsʰuɛ3	揣𢭍（揣）㪜
tsʰuɛ5	㿷？𠽶？𣤌？䴝？嘬
suɛ1	榱衰𠆂（衰）𠌺（衰）#摔𤸬䭨䪎
suɛ5	率（所類切）卛（率 所類切）帥䢦（帥）
uɛ1	歪（竵俗字）竵癐
uɛ5	外𡖄（外）䠿顡䶐
luɛ̃2	𡰠
kuɛ̃1	𠴨𢇇関癏關擐瘝䤽鰥𩶊（鰥）綸
kuɛ̃5	串倌丱摜慣矔鰥𩶊（鰥）擐
kʰuɛ̃2	𡰝還㡲䭴𡍦圜𠟼澴寰環鍰糫轘𦣴闤䴉𩙽鬟䍺𦏖鐶郇
xuɛ̃2	還湲
xuɛ̃5	繯轘宦患𢤒（患）𢡙（患）豢槵𢠶擐䍺幻㕕（幻）
tsuɛ̃1	跧恮䀬跧蟤
tsuɛ̃5	巽巺撰饌孨僎撰𩔊譔𩻝僝𦠆𠨎僎𤩄襈譔饌籑䉵賺（北音之新嵌者）
suɛ̃1	閂𣠯栓𨏉刪
suɛ̃3	選
suɛ̃5	孿㝈涮孿㝈𨏉柵
uɛ̃1	潫𩅦彎灣䘎嬽
uɛ̃2	𤸷頑玩（暫代）
uɛ̃3	莞睅𪍺睆+鯇䴷皖綰㝃娩挽晚𣆛（晚）晩輓㿸脕
uɛ̃5	薍綰𩈬贃萬㸘（萬）𤍚（萬）𢁭（萬）
kuən5	琯睔睴璭謴𧬪㴫？棍
kʰuən1	惃昆菎晜崐崑猑琨䖵㡓蜫褌瑻醌錕𥊽騉鵾鯤𪋆鶤㱎𢃭巛𡿦豤髖坤𠔜（坤）堃髡𩒱臗
kʰuən5	𩒱困𣏔涃睏
xuən1	昏𣄾（昏）𣄼（昏）惛婚棔殙𣣏閽葷
xuən2	𦸌𤟤楎煇䡣忶㑮堚渾揮琿𤦳（琿）䰟魂㨡㮯餛𢣒𣝂䴷䮝鼲俒顐沄𧡡餫
xuən3	惛𦃕？混㯻
xuən5	鯇惛緷棍睔睴鯶煇葷混渾㮯倱掍䚠𨡫䫟䧰焜圂俒溷慁
tsuən1	尊嶟樽罇繜屯迍窀㡒跧僎嶟遵𨘊（遵）𢍲（遵）鷷惇𥫉（惇）肫訰𥇜諄𧭫（諄）
tsuən3	僔𠟃撙䔿噂譐純𠄤（純）㝄（純）准埻準
tsuən5	焌捘𩯄鱒栫臶鐏鱒𦪚盹圳訰𥇜諄𧭫（諄）稕𥤁（稕）𦽑
tsʰuən1	村邨杶䡅瑃椿輴櫄鶞楯皴竴踆竣㕙夋𠣟逡墫捘春萅（春）𦸬（春）旾（春）𣈤（春）蝽
tsʰuən2	存𠩯（存）𨚲拵蹲踆（蹲）袸䣩㡒
tsʰuən3	刌𢩭忖偆僢𦚧偆𢾎惷䐏𢧨踳蠢𢧋（蠢）
tsʰuən5	寸吋䍎襯
suən1	孫飧搎蓀猻蕵薞喰
suən2	槆檈眴姰郇荀峋洵恂珣㰬𣓓詢𣖼畇栒㸪楯旬𠣡（旬）巡𠣙洵紃揗䖲循㽦䋸𪀠𧾩灥馴畇𡗥陙純𠄤（純）㝄（純）䣩惇淳𤂸（淳）蒓醇𨣳（醇）錞𦎧鶉𢗋蓴焞肫
suən3	㾕損扻（損）䐣𦠆笋隼𠣤𠣬筍𥳦（筍）𥰴（筍）𣕍榫𥯗箰栒簨鵻省（鄉又音）𡮀（省）䁞（省）
suən5	潠巽巺𢁅（巽）𠹀遜愻𩕧𢓈侚徇殉賰䀢舜𡐩（舜）𡳈（舜）𡳉（舜）蕣䑞瞚瞬鬊𡿦（鬊）眴盾楯吮揗順㥧（順）巡（順）𠈼（順）揗
uən1	昷𥁕𨜵塭温殟溫㼔瘟豱𩥈𪉸鴛輼蕰緼縕韞？䡝？㚃？蒀？氲？煴？氳？𥠺？蝹？馧？緼？縕？藴？蘊
uən2	㑮梱瘒顐閩文彣炆蚊紋雯馼䰚聞𦕁（聞）䎽（聞）䎹（聞）𥹢（聞）鳼𦖫閿螡闅鼤蟁䘇汶渂（汶）
uən3	穎𡁋穩㒚勽刎抆吻㖧（吻）𠞍（吻）𦮶𦝮伆？夽？喗？𧼐？齫？𪘩？齳揾䡝褞賱惲蕰緼醖縕醞藴韞蘊
uən5	諢顐䭡揾搵娩絻莬脕聞𦕁（聞）䎽（聞）䎹（聞）𦖫（聞）𥹢（聞）鼤文抆紊汶渂（汶）問𠳅（問）愠慍蕰緼醖縕醞藴
kuəʔ7	蓇䮩扢㒴汩骨啒淈尳愲榾㾶縎鶻滑汨淿（汨）䓛
kʰuəʔ7	#𤫵#蛞#筈#䟯#闊#适胐㧾㩿矻堀䯇𩑔窟𡑣𡑧𡼿𧷎𥌄顝圣泏掘崛𡲗䘿䠇𧱝堀𡲬
xuəʔ7	#豁活啒昒㫚曶忽匫惚䩐𣓗𢑢𤶘寣𦁕㦌䬍𩙤（䬍）囫笏鍃㾁𨑥扢抇尳𡰅鶻𢪏搰𣝗𦗣滑㨡#葫#猴
tɕyeʔ7	孒𠀔𠜾趉厥氒（厥）𬇌（厥）𨈑（厥）𨈐（厥）𣅞（厥）𦁐䠇𧱝鶌屈𡕜（屈）𡲶（屈）
tsuəʔ7	？𦳮+卒倅稡捽椊崪䚝𩩠𪘧㤕絀逫泏窋㑁䂐茁𡢑笜
tsʰuəʔ7	𢪃𥾛猝卒𣨛𤝞怵㤕欪𧺶䟣黜炪出闋齣（俗字）
uəʔ7	，+枂兀阢扤𦬂屼杌矹𦨉𤴰𧈭䑢𠨜㽾䦍鼿刖軏淴𩑦䯉嗢腽膃榅殟揾媼馧沕昒勿伆芴岉𨑥物𣃦？崛菀尉㷉（尉）蔚欝𩰪鬱𦉚（鬱）灪爩䖇𥘄𩚴黦熨濣
tuɪ1	搥鎚𠂤堆𢈹𡸠𡸬𡻛𡺾垖塠嵟𡏩磓𩈜鴭䭔䜃頧敦𢼪（敦）𠧈（敦）𠩰
tuɪ3	𡑈頧䇏𦞙謉？抵？𠥯（抵）
tuɪ5	祋碓對𡭊𠏮𣝉轛錞陮𦶏𨯝瀢錞隊憝𢥲（憝）薱濧䯟譈𩐌䨴䨺鐓憞䃍兊兌㟋綐𩊭銳脫
tʰuɪ1	推𨋱蓷㞜𨌴藬㷟
tʰuɪ2	墤㢈隤尵頹頽𤗴魋㿉𧝋蘈蹪穨𧮓
tʰuɪ3	僓㞂㱣脮腿骽㟎聉
tʰuɪ5	𨓤𡯵退𨓆（退）𨑧（退）𢓇（退）𨔫（退）𢓴㥆兌裞娧蛻駾毻
luɪ1	？擂
luɪ2	嫘縲瓃虆𡿔𡤯欙𤜖𥍔纝樏纍儽㶟鸓㠥羸𡰠𡰟厽垒絫樏䉂累㨎擩甤䅑緌蕤桵捼䬐痿𨡌𢅼捼雷𤴐（雷）𩇓（雷）𤳳（雷）䨓（雷）𩄣（雷）㗊（雷）𤴑（雷）𩂩畾檑𤮚㔣瓃櫑𦌵罍𦉩（罍）鐳轠儡鑘擂靁
luɪ3	轠耒誄𡻭藟壘𤢹櫐蘽讄㶟鸓蜼猚㼏餒𩗔鮾浽娞脮餧郲櫑礧䣂𨻾磊𡼊蕾磥儡𡾋癗㵽𦢏鑘頛屢𡜸（屢）甤？蕊？繠？蘂甤
luɪ5	㨅㢻諉瓃垒纍淚類蘱禷䇐率卛（率）𦝭累內𡗠（內）内檑㔣礧耒䣂儽䒹酹銇擂錑攂𥣬纇蘱𡔇㲕酹頪㱻兌䬽䓲蜹睿銳叡壡（叡）䜭（叡）銴鈉芮汭枘蚋蜹笍䄲說
kuɪ1	皈㱕歸𤾤（歸）騩規䂓槼𨾚鳺巂雟摫槻𩓡𩓸鬹𠃾𤕣螝𪚦龜𠁴（龜）騩鱖頄䟸媯嬀溈潙䐩瑰膭𠐤𤪿瓌鞼櫰䕇傀圭邽茥珪㰪胿𡌲窐袿𦓯閨𨾴鮭𪊧洼
kuɪ3	氿宄𡧫（宄）𡧌（宄）𠬚（宄）𧗝軌𨑍（軌）匭𠥗晷𣷾厬簋頯朹㔲庋佹䣀䃽陒垝恑姽庪祪蛫觤詭䤥𪀗蟡攱洈桅鬼𩲡（鬼）𢇼（鬼）𣆠（鬼）癸𤼩（癸）湀嫢湀揆𢜽楑䣀果柜
kuɪ5	螝騩䁛頍愧媿聭謉餽規瞡瞡垝𢈌攱僞䞈㩻貴𡭙（貴）𧸋（貴）瞶𠐽跪猤悸痵𡬄𠊾櫃鞼𩌃𦆠匱蕢𤆂（蕢）樻餽簣饋𠩸（饋）臾𠀐𢶒䐴劊禬襘？會？𣌭（會）？㞧（會）？𠃐（會）？㣛（會）？𣥈（會）澮𣴯（澮）𣲸（澮）檜癐巜儈鄶獪廥膾旝䯤鱠鬠䐴䈐簂𪏤蔮幗慖刏𣱚（刏）憒䵋簣劌𨇙鱖𠜾蹶𤜂𤜂罣昋𣧎炅𤰮桂筀䳏炔䣀矩柜（~州 今或妄書貴字 非）
kʰuɪ1	窺闚戲虧𧇾蘬𦺕（蘬）巋蘬𦺕（蘬）𧢦恢㷇詼𥲖悝盔顝魁𩲔（魁）茥鮭湀刲𠝥㨒聧䯓𡐠奎䖯楏暌睽蝰藈
kʰuɪ2	𠐽艽𧢦𢌳逵𠊾頄馗𨾗𦝢戣䟸𣦞頯鍨騤夔躨犪鄈葵𢜽楑𦝢𧍜𩹍䳫顝傀磈䫥㚍踩
kʰuɪ3	跪𣄲蘬𦺕（蘬）巋䞨頍跬䠑
kʰuɪ5	䙡𥽂𧝷𨌗尯喟𠷝（喟）嘳樻䙡䯣䰎腃觖堁凷凷𥢶𦖥聵𩔀𥏙潰䙆闋
xuɪ1	墮蘳隓隳䜐眭睢觿鑴婎倠眭睢𢊄揮𢱳（揮）𤟤楎暉煇幑輝㫎翬徽𢾰（徽）瀈鰴褘噅戲麾𩻟𪎮䧦撝䁤#虫𩄁#虺婎睢毀𣪷（毀）毁卉泋芔諱孈燹豷恢灰#虫#虺豗䖶㾯鼽鼿睳隋
xuɪ2	瑰佪徊槐𤜡回囘茴迴洄蛕蛔𩢱烠蚘廻窐巂𪈥黊畦眭䙵雟酅蠵觿鑴㔒驨䀘𣫴𡸔𦋅𩰳𢥘𡰢讗纗規
xuɪ3	蛕䏨悔𠧩（悔）㷄賄𧶅燘溾輠匯瘣䕇䜋㱱𨝀廆虫虺毀𣪷（毀）毁𡢕毇檓㩓燬譭𥶵𠷏烜䁤𤈦𩃾卉
xuɪ5	恚㜇秏𣴵悔𠧩晦詯誨𠲯（誨）𩔁靧痗頮渙噦翽𧬨鐬濊䢈禬會𣌭（會）㞧（會）𠃐（會）㣛（會）𣥈（會）#檜（北音）燴𨘇繪螝膭迴䛛詯殨繢䜋闠嬇蚚䔇僓薈嬒瞺䶐濊懀䵳喙𣨶䂕𤸁餯顪𧾣彗嘒暳嚖惠𦻇（惠）𢡘（惠）𢞯（惠）①（惠）慧蕙潓憓橞㩨蟪𦒎譓儶鏸繐隋（謂神前所沃灌器名）
tsuɪ1	腄箠㩾追䨨娺嶉檇劑𠜸（劑）臇𤎱㷷𦸺䮔㭰萑隹㮅錐騅鵻𪋇䶆脧𡱥䘒摧嗺
tsuɪ2	#賊（昨則切）
tsuɪ3	濢臎嗺噿㭰觜嘴捶棰箠𦓝沝䮔洅嶊
tsuɪ5	娷諈轛鎚懟墜醉檇惢㠑𤢍惴𦥻𦦇夎綷𢃒晬祽𪓌捘𢃒最𣤜（最）撮𧎹罪𡈚（罪）辠㠑蕞𥳣啜輟𨌸（輟）卂笍腏䄌畷醊錣餟𨮱𧑎㨹蕝𠭥贅𧷌（贅）𧸆（贅）甀垂硾膇縋
tsʰuɪ1	吹炊龡䶴𪛑崔催鏙𨻵𢕘𧽠縗推蓷
tsʰuɪ2	#瘸桘槌顀鎚椎錘鬌甀腄槌錘甀隋隨𨼕（隨）遀（隨）追（隨）遺𥶻崔摧慛槯檇#茄（限 又 ~子）#伽（茄 限 又 ~子）
tsʰuɪ3	趡𨿐踓洒漼璀皠鏙𣿓𣿒䊫𥼺
tsʰuɪ5	翠濢臎萃悴㱖瘁顇綷䆊出吹龡𪛑䶴𥞃摧啐淬焠䃀倅𥨒𦦣𨅎襊脆脃毳㯔膬竁𣃍𧑎韢㓹帨𤂳毳㯔竁𣃍
suɪ1	#靴㗾#鞾葰䅑夊䒘荽荾浽睢濉雖𨾡（雖）？綏奞眭𤗯毸挼䪎蓑𠱗（蓑）𡔤（蓑）嗺尿眭隋（祭食也）
suɪ2	圌篅𥳙垂𠄒（垂）𠣔（垂）倕𠂹陲𡍮𦈼𦉖（𦈼）𨿠脽誰䜅隨（新）？隋（垂下也）#髓
suɪ3	嶲靃𣿂䭉隋（謂神前所沃灌器名）氵水氺蕊橤
suɪ5	粹祟𠭥睟賥誶𢢝邃譢瀡䅗垂菙㥨䅜瑞睡𨿠㽷𥤼啐𤭢碎誶繀𣩡𥕸𥊴櫘歲𢧁（歲）亗（歲）歳𦄑繐彗槥篲𥱵𢅫䵻𪔊軎轊鏏𠻜啜帨涗稅裞䬽䭨+說蛻𢄢隧（新）𨽡（隧）穗（新）𦼯（穗）
uɪ1	蟡逶㮃覣䴧委萎𣨙痿蜲倭威𤰴（威）𤱫（威）隇葳㟪楲蝛鰄媁嵔𩗯偎隈揋葨渨椳煨䋿𧤖鰃𤮰烓𧟼
uɪ2	矀𢼸微薇㵟癓䉠䥩危𡵁（危）㕒峗洈巍犩婔囗韋𣍄（韋）𡙝（韋）𡚈（韋）幃𠥎（幃）圍湋違𢾁潿𠆎𩎯闈鍏䙟𧝕𩻟為爲𦥮（爲）𤓸（爲）僞溈鄬䧦潙帷𠥎（帷）𣄧唯惟𢛧（惟）琟蓶維濰䜅𥌰壝𧔥遺𨗮（遺）𨖽（遺）𨗭（遺）䔺䝐𩁌𧲚蠵欈峞桅嵬鮠磑阢#圩囘回
uɪ3	姽𪀗硊頠瓦（屋甃也）#偽#僞磈嵔骫委蜲䍴𠷏蘤𤾸鄬䧦寪蔿薳儰𤺉䦱媁鍏偉𢯷葦愇瑋椲暐煒韙𩘚韡洧䵋鮪痏䲊孈唯蓶㨊踓壝瀢撱䔺䝐芛茟（芛）𤼒䓈䫥顡峞嵬隗頠䃬𨝀㞇嵔猥㛱𥓔㱬腲鍡碨尾𡱕（尾）𡱓（尾）𡲵（尾）浘娓艉䞔䬿亹斖䅏
uɪ5	沬湏（沬）未味𡶎菋苿䊊𩑵鮇犩魏萎𣨙䍴餧畏𤰲（畏）𤰣（畏）尉喂㷉蔚霨犚慰罻餵螱褽䲁𧕈熨彚彙𢑷圍囗（圍）緯𦞅胃𦳢𢍚渭㥜媦煟蝟𦩝緭謂䬑𨾂𩹂爲𦥮（爲）𤓸（爲）位瞶蜼𤀷𢣘䗽𧔥遺𨗮（遺）𨖽（遺）𨗭（遺）𧸽瓗䜜贀纗磑隈𩲄㕈喟𠷝（喟）薉獩穢𢧹（穢）濊饖䮹槥軎熭衛璏衞䘙轊㦣𤜂𥶽𧲔讏𧲝
ʔəuᵝ5	燠灹（燠）𤈰（燠）
xɔŋ2	𤮏？橫𧝒㶇𪏓䬝𢘌彋黌喤瑝䄓蝗鍠韹鐄
kuən3	衮𧚹（衮）袞惃蓘䃂滾緄輥渾（同滾）緷𩩌㯻鯀錕丨𧞢
tsʰuən2	鷷
pɔŋ1	崩𨹹（崩）嘣捠浜𢆸䑫絣繃拼㔙閍𥛱祊嗙騯
pɔŋ3	浜㑟𧚭菶琫𦂌俸
pɔŋ5	泵𥦜堋#蹦倗榜㮄𧻓跰逬迸𩶁併𠊧傡螷蠯鮩甏膨䨻𠊧傡掽菶唪
pʰɔŋ1	漰堋磅亨亯（亨）𠅖（亨）恲烹亯（烹）𠅖（烹）𩱋（烹）澎伻匉抨怦㛁𤘾𤙀（𤘾）砰𨺀（砰）䍬弸閛姘
pʰɔŋ2	甭朋倗堋棚硼鬅鵬錋榜㮄蒡𣂆篣嘭彭棚搒䄘輣澎憉膨𨍩䰃蟚蟛𩡕騯弸㥊棚庄蜂䮾芃𩖛𧚋逢蓬𧓶𥭗篷韸髼龐汎梵堸馮淜（馮）渢𨝭芃
pʰɔŋ3	䣙倗剻皏捧
pʰɔŋ5	逢𦮔𦺑埲
mɔŋ2	甿氓萌鋂（萌）甍蕄𧂛䉚𣞑𥌯𥋝嫇盲虻（同蝱）莔𥭮鄳𨞚蝱䥰𥋝䖟（俗蝱字）
mɔŋ1	蒙
mɔŋ2	朆𦱛蕄瞢䒐罞髳霿冡蒙𢄐䀄𦿏幪濛檬𨢊䑃朦礞矇艨𨣘䴿靀饛䰒𩦺鸏蠓䤓懜霥雺霚瞢𦫰𧲎𨞯夢懜
mɔŋ3	鄳勐猛𠩜（猛）蜢艋錳𥋝鱦濛曚朦鸏𤾬懵蠓𪁪䏵
mɔŋ5	䲛𢅴懜𧀧𨮒鼆䁅黽朚盟𢄾（盟）𧖸𥂗䁅孟霿𢄐艨雺瞢鄸㝱夢䠢
fɔŋ1	封𡉘（封）𡊽（封）㜂葑崶犎篈𡉚風𠙊（風）𠙈（風）凬（風）偑猦楓碸瘋檒飌𧆉丰𫵮（丰）𡴀仹妦肨峯峰𢓱桻㸼烽蜂㷭鋒𧒒蘴蠭莑豐𣍈（豐）𧯮（豐）酆㒥蘴㠦灃寷麷
fɔŋ2	馮
fɔŋ3	覂𢇫#諷
fɔŋ5	封𡉘（封）𡊽（封）葑風𠙊（風）𠙈（風）凬（風）飌（風）檒（風）麷賵𠙒（賵）
tɔŋ1	東𢘐倲埬菄𢔅涷𠍀蝀䍶𩜍䰤鶇鯟𧓕凍崠冬𣆼（冬）𣅈（冬）𠘀（冬）𠘗（冬）苳咚氡𠔙笗𧲴𩂓䳉
tɔŋ3	蝀董𦱦（董）蕫箽懂𢤦䵔𧄓湩踵歱黨
tɔŋ5	涷䍶凍棟㼯腖湩𩭩挏姛硐動㣫（動）𨔝眮酮詷桶侗㓊迵峒洞恫戙胴駧𩐵㗢眮衕絧詷筒慟働奀
tʰɔŋ1	侗恫通𢓶（通）痌蓪𨀜嗵𧳆曈俑炵
tʰɔŋ2	𢥞痋爞鼕+疼𩦶炵𠩁佟彤㠽㤏浵𨜳䂈𧹝赨鉖𢾮鉵䳋䶱罿𪔝蕫侗挏峒洞硐𩦶𪒿仝同𨚯茼哃𢈉𢏕桐砼𤭁烔眮䆚㼧衕𦨴童𦍻絧酮𧱁僮銅𨝯潼橦曈犝㼿瞳穜鮦𦏆𩍅䴀筒筩
tʰɔŋ3	侗垌曈捅桶動㣫（動）𨔝（動）#統
tʰɔŋ5	痛𪎽
lɔŋ1	□（歎字）
lɔŋ2	屸𧙥蘢嚨巃𡃡瀧瓏櫳𪚗曨朧㰍𤮨矓䆍+礱襱龓籠聾蠪𨏠豅谾（豅）𩟭䪊鸗㟅農𦦥（農）𨑇（農）𣊤（農）𨑆（農）𦦤（農）莀（農）辳儂噥㺜𤣜（㺜）憹膿𧗕䢉𨑋𩅽𩟊䃧䥢𣫣㺜𤣜（㺜）濃檂穠襛𨑊𨲳醲𪒬㚅隆癃窿霳𪔳龍竜（龍）𦱉（龍）𢅛（龍）𠊋（龍）𥫈（龍）龒（龍）䰱（龍）蘢𪚝籠𦪽躘𪚠驡鸗龐穠襛茸搑䇯榵穁𥎂髶䩸縟戎𠈋茙𢦦狨㭜𥬪絨駥
lɔŋ3	𨑊巃曨襱龓籠儱攏𢤱竉㙙隴壠壟軵搑穁冗𡦼宂𡊫𢫨𤘻𤘺𣭲䢇𨍷氄𪕎
lɔŋ5	癑齈哢礱𤮨（礱）㢅㳥𢙱梇弄挵𢫨躘儱贚𩉪䩸𩼅#巷（松江音 ~唐）
kɔŋ1	肱𠃋（肱）厷（肱）𠫔（肱）𩉦䍔觥𣘯𩃙觵侊疘釭工𢀚（工）㣉（工）𠜝（工）公㒶（公）㓚功攻蚣愩碽篢玒魟釭攻弓宫躬宮匑躳㴦䢼恭𤱨髸䳍龔廾珙共𦱹（共）卄紅
kɔŋ2	攻
kɔŋ3	獷懭𨥥+礦穬䵃鑛𪍿𠬞廾巩𢪒拱㤨珙㼦㧬𢀜𢭤𠦕拲栱䂬𨋑䡗輁鞏䱋𢸁孒蛬
kɔŋ5	𣹟贛𧆐羾貢䇨㯯㔶𨹁虹龏供？䅃？共？𦱹（共）
kʰɔŋ1	空倥埪𦱇崆𢃐涳悾硿䅝𧌆箜鵼椌匑穹𠫙（穹）焪𢞏𥳎𦵡銎𥳎
kʰɔŋ3	𥉁倥孔𡤿（孔）𢖶恐𦶐
kʰɔŋ5	空倥悾控𤗇鞚𢖶恐𦶐焪䠻䛪
xɔŋ1	薨𠐿𤃫𩖎𩖉𩙛訇揈渹𢝁𥕗𦑟輷䎕鍧轟䎕嚝喤諻謍叿烘焢谾𩗄𩐠魟降（乎攻切）
xɔŋ2	𢎞弘苰鞃𥐪吰宏宖竑耾翃浤紘𧮯紭閎鈜彋嵤嶸䃔㗢𩘎洚烘仜䧆𨹁垬虹䉺洪灴紅𨾊葓葒䫹䪦叿渱谼鉷魟鴻䲨（鴻）訌洚𦏺
xɔŋ3	卝澋嗊𢦅？兇？洶？詾
xɔŋ5	輷轟橫㶇蝗烘戇港烘蕻哄閧鬨䃔㗢汞鴻䲨（鴻）𠳃𧋔澒
ʔɔŋ1	泓汪（同泓）宖𨳮謍翁嗡㮬螉䈵䩺𩔚鶲䱵蓊
ʔɔŋ3	浻奣䁝㴄嗡滃䈵勜塕蓊暡䐥𤌏郺
ʔɔŋ5	𥥈瓮甕罋𦉥𪖵#蕹
tsɔŋ1	㚇堫葼棕嵕㣭猣椶𥓻嵸稯蝬艐翪䗥鬃豵鬉𩮀騣鬷鯼緵宗倧腙中𠁧𠁩𦬕忠舯衷鈡仲樅𧺣𣯨熧磫䡮豵蹤縱𥾞（縱）潨䶱泈柊𣧩終𣊂（終）𤽘（終）𠔾（終）𡦿（終）𢍐（終）𣈩（終）𤽬（終）夊（終）蔠鴤䈺螽𧕠（螽）𧑄鼨䝦𩅧眾𥅫（眾）𠱧（眾）衆𧢸𦬘㕬蚣鈆忪橦伀彸妐炂衳䇗𨳗鍾蹱鐘童（夫~）籦
tsɔŋ3	𢉛蓯緫㷓猣䁓嵸翪𩮀鬷𩱛偬揔惣𢝰傯摠㢔𨍈總𠂳（總）冢塚䙕喠𢃓𢃭㣫歱腫種𥢖（種）𥡰（種）踵
tsɔŋ5	㚇䁓鯼偬傯粽糉緵𠏭𣀒綜䝋錝湩堹諥中𠁧𠁩衷襱鮦重𡍴（重）𢝆緟重𡍴（重）𨉢蟲𩿀瘲縱𥾞（縱）從㓽㼿種𥢖（種）𥡰（種）偅眾𥅫（眾）𠱧（眾）衆
tsʰɔŋ1	匆囪囱忩怱葱𢉛𤧚楤蔥𢊕璁聦樬䗓熜𨍉聰蟌䡯繱騘𦇎驄𨣭𨣼㷓鍯鏓忡浺盅𨤩𦟛䝑𪒒傭蹱𨙦摐𨑪瑽樅暰䐫𥡬鏦從鬆𧺣䗥充茺㳘㤝珫䘪𪎽𠝤𠟍衝憧罿䂌𧘂艟䡴褈潼舂摏憃𧐍蹖𪄻樁
tsʰɔŋ2	潨藂叢𥵫䕺慒𢃏淙悰孮琮㼻誴潨賨鬃沖翀蟲爞烛𦬕盅种褈蝩緟䳯穜重𡍴（重）从從𩀰崇崈㓽𩞉
tsʰɔŋ3	𧼙寵埫慫𨿿喠
tsʰɔŋ5	謥憁𧩪愡憃蹱趥銃
sɔŋ1	㬝忪憽檧䯳鬆㣝娀菘崧𧊕𨱿硹嵩崇（嵩）䯷𪀚倯凇𢔋淞蜙鬆松㮤（松）梥（松）庺（松）
sɔŋ2	淞㮤訟䛦（訟）𧧡（訟）吅（訟）㕬（訟）𩌨慵鱅庸𠆌（庸）
sɔŋ3	檧𣞷䉥𥳺㪌悚𢷜（悚）竦𢷜（竦）𢖗（竦）傱愯駷聳㩳𦄼䙕
sɔŋ5	凇鬆送𨕪（送）𨕩（送）宋訟䛦（訟）𧧡（訟）㕬（訟）頌誦吅𢡹尰瘇𤺄#訴
ʔɔŋ2	㟅
luõ2	南𡴖（南）𡴟（南）
luõ3	擥攬
pɔʔ7	北𧉥𢫯𧟱僰䞳踣䵗垘菔匐𠣵仆菩掰薜檗擘糪蘗𤖟百𦣻（百）佰柏栢伯㼟𦯉湐敀白𦣺𤼽帛𦰬舶鮊𦌠繴䌟欂卜𠁡（卜）轐鳪𡡐䪁𩯏𪇰襆䧤獛濮纀樸蹼暴𣋴（暴）𡕡菐僕㲫𥐁穙䑑䗱樸瀑（飛泉懸水也）曝犦襮𧟊（襮）𪇰轐僕瞨䑑䗱鏷䴆爆（灼也）
pʰɔʔ7	𠣾覆𧕡糪𢶉𠓗𧻙啪怕拍珀敀洦𤖼魄迫廹霸（魄）皛釽骲醭攵濼攴扑𪐙撲噗𪔿墣𥣜䴆曝副#帕幞白
mɔʔ7	冒（密北切 貪也 犯也 人名）𡈘（冒）𡇾（冒）𤲰䁇𢄏墨嘿默𡣫䘃䁿纆艒万百𦣻（百）佰𡠜陌帞㹮袹+蛨𧻙𡖶𧕥嗼貊貉㱳銆𩢷貘驀𢫦洦脉（脈俗字）脈麥衇𧖴嘜霢𧡒覛𧠨眽朷蓩木沐蚞毣楘霂艒𨍎鞪㡔鶩媢瑁㺺（瑁）𤣽（瑁）𣔺萺艒㙁繆坶目𡇡（目）𥃦（目）𥆤（目）苜牧㾇𦱒㣎萺睦𡻲（睦）𡍬鉬穆𢿬（穆）𢿉（穆）𢾓（穆）𥟟（穆）帕（集韻莫白切 帕腹）
fɔʔ7	愎偪楅葍幅福畗（福）蝠輻踾𦿁鶝𠋩腹複輹鍑𥳇菐䪁㙏蕧䔰蝮𥨍覆𩯅鞴𨋩伏𦨈服𣍞（服）茯畐洑栿菔虙匐棴絥𥪋箙𨌥𩊙澓𩎧𩢰𩋟鵩𪃃复㚆𠰞（㚆）復（房六切 方六切）𢕛（復）𠣸（復）𡕴𡕨㚆𠣾椱𤸑蕧輹𥨍馥鰒袱襆蔔（菔俗字）
tɔʔ7	啄濁豰剢𣫔𡰪竺啄𢽴䐁𧞐𪇆㾄𤟩獨匵𨽍䢱瀆嬻瓄櫝殰𦢌（殰）犢牘皾䫳髑豄贕讀韣䮷韇黷讟㒔襡儥碡罜督𥓍裻𧛔錖𧝴𧞶𤬂篤焯𡰪竺瑇𢃶纛毒𦸕（毒）𧉉（毒）𡹆𡴛𦺇蝳碡#濁
tʰɔʔ7	𣬜禿秃𢬳䛢鵚
lɔʔ7	犖䮽𨞻鄜𥪋谷角（獸不童也）龣磟甪录彔鹿渌淥娽琭禄祿㪖碌睩𤽺盝𣿍摝蔍𧌍箓廘漉䎑趢𨌠㼾𥛞䚄㯟𥉶䍡𥂖螰𦌟簏𦪇轆簶麓𩅄鏕騼𨏔觻濼𥂇耨傉搙褥濼肭朒沑忸䂇恧䖡衄𦗂蓼六磟𡴆坴陸𤱒（陸）淕𥚊𦸐稑僇剹勠𠝧（勠）𧌉䡜踛戮𡠢（戮）𦐱（戮）穋𦾷𩣱鵱鯥菉渌淥逯娽㫽㪖碌趢醁䟿𧨹䚄録錄騄䱚籙氯緑綠鮞衄朒肉宍（肉）辱𢟲（辱）鄏𪑾蓐嗕溽媷㦺褥縟𩱜入
kɔʔ7	蟈國囗（國）囶（國）圀（國）𢧌（國）䆐（國）馘膕𢼛虢㶁𧭣唬嘓蟈䂸摑聝幗𧖻漍慖䬎馘𢹖𩪐膕讗埻𧾛唂轂𨍔（轂）䜼谷𣨍䀰𧣡榖䐨穀糓濲瀔𪕸𪇗𥆌瑴𤞞+吿+告郜祰䧼䶜梏牿䧊䅵鵠？骨角（古祿切）
kʰɔʔ7	𧍕𠠎䍍䧊哭㲄𪍠𣫓䵈㲉𡷥告吿焅𥞴酷嚳硞縠觳
xɔʔ7	斡𢃤𥇙或𢈿（或）𡿿𢃎惑䰥蜮硅諕砉漷湱𢝇謋𦒧焃劃𠟱（劃）𢄶繣㩇剨䦝捇掝㖪湱𦑌㦎䐸䬉𥊮𤁹𨐶礊𠜻𤷇鱯畫𤱪（畫）𨽶（畫）𤲯（畫）劃𠟱（劃）嫿咟㗲獲彠嚄濩𡄴豰𦞦熇㷤𣪥𧹲鍙嚛嗀䶜斛焀𣹬蔛槲𣫈螜䈸㽇𧂔礐熇嚛臛歊翯㿥𤌍𨴬頶？鵠隺礐
ʔɔʔ7	䪝蒦擭握𦥆（握）齷喔屋𦤿（屋）𦤼𡲃剭𪑱䑁𨜘鱟䁷沃䮸鋈䑁觷
tsɔʔ7	㩇䟄䞰鎐鏃傶𣪻錊𢒔瘃𤷚孎欘斸钃𥴁竹⺮竺茿筑築蠋躅𨄃（躅）蠾䠱䙘㗤踧噈𦟠縬蹙蜡蹴顣𥷛𠴫殧槭摵𣢰𧑙𣤶足疋（足）𤴕（足）哫𣤶縬𡎺琡+喌粥柷祝𥘱（祝）韣属屬鸀㰲噣燭蠋䟉蠾䌵矚？蜀#卒（俗又音）蓫篴柚妯軸碡逐𢄘（逐）舳蓫𧏿䮱鱁筑
tsʰɔʔ7	趗蔟䃚瘯簇梀銼鑿𨰒（鑿）族㞺（族）𥎩（族）𥎼（族）𥏁（族）𧼙亍豖㙇𢒔𥹵梀畜嘼（畜）傗鄐搐滀竹矗苖荲敊諔蓄稸㹱促數趣趨𤗁趗誎𦠁鼀蹴殧珿䎌𧯩𨴖矗𪘏觕歜臅觸𧢻（觸）#齪
sɔʔ7	𢷾棴𨄞嗽㑛速涑梀殐𡖯蔌遬數僳觫樕餗𧐒𣫎藗簌𧫣𪋝𩱖裻洬玊夙𣦽（夙）𠈇㑉𠉦㓘𤥔肅𦘡（肅）䏋（肅）𢙻（肅）㩋潚璛橚䑿㪩䃤䎘𪂸𪄑𩘹驌鱐鷫蟰宿（㝛俗字）㝛蓿玊涑粟𥾄（粟）𥸫（粟）𥹟（粟）𠧼（粟）䅇（粟）㔄𥻆憟𣯼俗圱（俗）藚𩌮續賡（續）摵嗖𧽏謏樎𧼭㩋𧐴謖蹜䎘𩘹摍縮莤襩韣㒔㯮属蜀㻿襡屬䙱欘蠾鐲淑孰婌塾熟𡒒（熟）䃞璹𠩱（璹）𨷙尗叔𡭫（叔）𠁮（叔）𢆑（叔）倏倐掓菽𨁀跾𢞣鮛㶖虪儵透翛束㑛䴰贖𩌮囑
ʔɔʔ7	𤛹
kʰuən3	𩑔捆悃梱硱稇裍壼稛綑𡈋閫齫
suəʔ7	㲞窣𪌯𪍛𪅄𪖶㞕
tsʰɔʔ7	俶埱琡𣥹柷
pw1	逋峬庯晡鈽𧻷誧𥂈鵏抪餔秿陠鯆
pw3	補𢒏（補）
pw5	部伏復𢕛（復）𠣸（復）椱𢕒𤸑複𨺅覆布㱛（布）佈抪𠜙𧉩怖悑部簿鞴捕哺鵏步𨛒荹捗埠𩢕餔𤸵𩣝䒀鮬
pʰw1	誧豧𥠵陠𢼹痡𨁏鋪䮒𧱹鯆𩹲墲
pʰw2	浮包荹捗匍菩葡蒱蒲蜅䔕酺䈻樸鳧
pʰw3	圃譜潽誧埔浦烳普溥氆鐠甫父鯆莆脯簠𠤱（簠）𦻌（簠）黼郙俌𥙳（俌）蜅輔
pʰw5	誧𤸵鋪舖步
fw1	不𠀚（不）𠙐（不）紑鴀哹䍍紑𡫺肧衃醅秠䬌夫邞伕呋㠸妋玞肤䃿䄮衭趺拊胕𧿤跗鈇鳺膚𩵩𩿧𧀴扶𢻳（扶）𢱿（扶）簠𠤱（簠）𦻌（簠）柎𩬙䒀姇荂㕊怤䓏尃㲗𥹃紨䓵蓲稃筟𨞻鄜豧桴孵麩敷旉（敷）䎔㩤糐𧀮麱䱐𣞒孚𤓽（孚）泭俘郛𡎽（郛）莩桴罦郙秿殍痡鋪？誣#婦#𢽰（婦）
fw2	棓䍌䱐芣枹罘𢀼𦮹哹䍖浮琈桴烰涪罦蜉艀鉜𡦄粰䨗𥰛䳕掊瓿夫𣘧扶𢻳（扶）𢱿（扶）芙𢺻苻枎泭玸枹𦔾蚨胕符𧥱𤱽鳧颫𢞦榑𣻜𦽏𦑹𣿆坿𣻥巫𢍮（巫）𢀣（巫）誣莁
fw3	㕮斧府俯捬𥒰腑蚥𧉊頫𢻬拊弣𠛺俌𥙳（俌）𠟌䋨撫𨑟（撫）䌗䯽䞤殕䪔㕮𨥏釜（𨥏俗字）釡（釡俗字）滏輔腐䩉鬴嫵娬
fw5	輻富䔰鍑㤱副𤸑褔覆𩯅仆阜𠻰（阜）𨸏⻖⻖負𨹺𦰺偩婦𢽰（婦）萯服㷆𧌈蝜䘀𪃓䧞菩阝搏付仅咐陚傅𩬙賦䞳豧簠𠤱（簠）𦻌（簠）赴䟔訃婏䞯𠓗仆䎷父蚥㾈秿䭸𩾿𩒺拊捬跗胕附坿祔袝蚹䠵駙𠪻鮒賻
təuᵝ1	都𨛷（都）𦘴嘟（美詞）醏闍𥳉𧷿䩲
təuᵝ	□（鳴笛音）
təuᵝ3	楮堵帾暏睹覩賭土肚𥀁㕆䁈琽肚杜渚
təuᵝ5	秅奼𦘴妒㓃宅詫咤𤴱妬橐秺㓃螙殬蠹斁𤬪杜肚荰𡍨靯𥀁𢾖土度𡧪（度）㡯（度）渡𥯖鍍塗斁
tʰəuᵝ1	𡸂䞮嶀㻬㻯捈庩㻌梌稌䩣悇#塗（限 ）
tʰəuᵝ2	啚𠴿（啚）𣘻鍍𨑒余䣄捈荼土杜徒𠫠（徒）峹途涂梌𤙛屠㭸蒤筡嵞瘏塗䣝酴圖𡈖（圖）𡇴（圖）廜䅷䤅䖘𤺈駼鵌鷵菟
tʰəuᵝ3	芏稌土圡吐釷杜（限 ~狗子）
tʰəuᵝ5	吐兔堍菟鵵#唾
ləuᵝ1	□（免職）
ləuᵝ2	擼嚕㭔𧆨玈𧇄𤴅（𧇄）盧𦿊壚攎蘆嚧獹瀘𢐸瓐櫨𤮧㪭爐矑㿖蠦罏籚艫纑轤鑪顱髗䰕鸕鱸黸㢚廬（限 ~山）蘆㠠𡫽蒘如𨚴茹銣𨾵蕠鴽𥨲洳𪋯需懦儒薷嚅獳濡嬬臑襦蠕繻䞕醹顬䰰鱬㼱𠬫（㼱）蔞
ləuᵝ3	㭩鹵虜㔪𢲸蓾滷樐魯𣥐（魯）擄㢚𧀦櫓艣鏀鐪鑥䲐氌𡫽㼋女𠨰（女）茹汝肗𪏮薷醹乳擩鱸
ləuᵝ5	㿖輅賂路蕗潞璐𦌕簵簬𤻱露虂鷺如茹洳𡦗孺擩㹘籲
kəuᵝ1	𡗷咕沽夃（沽）泒孤姑柧㼋罛菰菇蛄辜𢩍（辜）𢻄（辜）𡱨（辜）𡲞（辜）軱酤觚𠷞箍箛嫴鴣橭𧇡䐻䉉𨬟𨬕盬苽笟呱胍𣲖#故（限 無理不~）家𠖔（家）𡩅（家）𡧚（家）
kəuᵝ2	？鼓？𩉲（鼓）
kəuᵝ3	估沽夃古𠖠𡇣𠒂股牯𦙶罟𦊖（罟）苦羖𦍩焸鼓𩉲（鼓）鼔鈷皷𥂩臌瞽盬蠱賈#骨（北語 ~董）？垢離（離瞀 山也）
kəuᵝ5	沽夃（沽）酤固怘（固）故古𠖠𡇣凅㽽崮棝雇頋䍛稒痼僱錮鯝鈷顧𪄮（顧）#過？股
kʰəuᵝ1	軲橭扝刳郀古（~成氏）𠖠𡇣枯㱠跍骷䉐鮬挎㢪𢎰
kʰəuᵝ2	糊
kʰəuᵝ3	苦𥯶
kʰəuᵝ5	苦（困也 姓氏）庫袴絝䔯褲胯跨
xəuᵝ1	苸呼𠰗（呼）烀恗虖軤𧦝雐嘑滹歑幠膴䰧謼葫虍𧇁（虍）戲#乎
xəuᵝ2	䉉𠂞虖狐弧瓳胡壷𠻭（壷）𠴱壺鈷葫猢湖瑚𩑶㾰𧛞𧍵蝴箶衚魱糊𩰯𪍒𪐉䉿𪏹㯛醐𪏻餬鬍鶘𪍒𥶜𪕱瓠䊀𠀒符
xəuᵝ3	虎𧇂（虎）虝（虎）𪊖（虎）𨛵萀琥䗂許滸戽
xəuᵝ5	謼呼戽酤雇戸戶㦿（戶）𣥘（戶）㕆帍昈岵怙戽𡜂祜苦扈𡴱（扈）婟鄠𡻮滬𨛸熩𩿇簄𪄮楛洿芐互冱𦬚枑𦊂䇘𪏳瓠𧥮婟嫭擭濩護䨼韄頀鱯詁冴婦（鄉又音）𢽰（婦）
ʔəuᵝ1	惡亞（惡）扝圬污㢪杇洿烏𤚶（烏）𥾪（烏）釫鄔𦶀嗚㮧歍螐鴮鎢鰞瑦於𣱏（於）𤕘（於）盓汚𢎰#五#𠄡（五）#㐅（五）#務汙
ʔəuᵝ2	膴蝥瞴嘸无𠑶（无）毋𢃀無𣟒（無）𣚨（無）𠘩（無）橆𨼊墲蕪璑鵐䉑譕鷡𢜮憮䍢𦌬胡魚（童語）𤉯（魚）鬍
ʔəuᵝ3	鄔䡧摀瑦𧽋隖𨻑（隖）塢嵨𢄓溩䃖䛩埡毋
ʔəuᵝ5	噁（喑噁）惡亞（惡）肟䜑埡汙汚（汙）嵍蝥敄務㡔婺𦎦𨂣霚䨁霧騖鶩𦆞
tsəuᵝ1	租蒩都䐗豬藸瀦櫫沮𧄗䶥菹𧄔諸𢒕（諸）藷㶆櫧䃴蠩列邾株㦵袾蛛跦誅鴸𪏿鼄搊㑳朱侏咮𤝹珠硃秼絑鴸鮢姝#茱兪
tsəuᵝ3	蒩珇祖𥘲（祖）組䔃靻褚𢁼䘢䍆詝㤖𤲑著貯𡪄陼煑煮䰞丶𪐴拄柱斗枓主宔麈炷砫
tsəuᵝ5	作（後專作做）𢓓（作）做觕粗伹駔麆粗𧇣秨阼胙飵𧃘著箸𣥧（箸）茅宁芧佇苧杼眝竚羜紵𦂂（紵）除（去也）筯箸𣥧（箸）㾻阻俎阻詛𥛜（詛）謯（詛）齟鉏耡助麆𢉙翥𡻠㫂𤳐䬡䭖𤳯䘄亍咮祝（陟慮切）住壴軴註鉒駐𨙔柱跓嵀逗牏住𧱛䝒澍罜㹥注炷𠴦疰祩蛀䎷註馵䪒霔㺛鑄𤎧（鑄）著燭（燭謂照也）䖕
tsʰəuᵝ1	觕𤿚麁麤麆𧆓𥼡摴樗㯉攄筡𠿝嘔
tsʰəuᵝ3	杵処處
tsʰəuᵝ1	𤠾貙芻犓
səuᵝ2	殊𩪍袾䇬
tsʰəuᵝ2	䢐徂𡲂（徂）𡲡（徂）殂𡲂（殂）𣧫（殂）𡲡（殂）𣨖（殂）𣨐除蒢滁篨𦿀躇櫥儲宁涂屠藸著諸㾻蜍𧄔稌裯厨趎廚幮櫥蹰躕媰𦷝䅳雛鶵殊（又）
tsʰəuᵝ3	𧆓蔖楮褚柠楚𣕪濋䙘礎齭𪓐齼憷䑕暑黍鼠𧑓癙數藷（俗新）薯（藷俗字 俗新）
tsʰəuᵝ5	醋酢絮悇㾻楚𣕪儊䖏處処？抒？紓杼𣏗𢨸䦌𨳳䜴䐢菆處
səuᵝ1	甦酥穌蘇蘓㢝𣩷𣩕釃𦌿疋⺪𤕟𥿇疎疏㽰綀踈䟽𨛭書除紓舒俆荼𦺗鵨瑹橾兪㡏毹螋樞鄃輸隃#粟（限 蘆~ 御蘆~）#𥾄（粟）#𥸫（粟）#𥹟（粟）#𠧼（粟）#䅇（粟）楚𣕪
səuᵝ2	𠘧殳𢎦杸軗朱陎殊㼡㸡𦤂洙銖
səuᵝ3	齭疋䝪𠩄糈盨籔數蔬（粒也）
səuᵝ5	泝𤤐素𦃃傃索（蘇故切）蘇蘓訴㨞塐嗉塑遡溯愫膆愬𤢘䛾𧪜蔬疎疏踈䟽捒㫹墅野埜（野）𡐨（野）杼（常恕切）𣏗署薯（俗藷字）曙糬藷恕㣽（恕）庶𤈲（庶）𠦜（庶）𠪌（庶）𠩽（庶）𠪛（庶）㵂樜㡏捒數裋竪豎樹𡬾（樹）𣕒（樹）𣚤（樹）𦒸𠊪尌澍樹𡬾（樹）𣕒（樹）𣚤（樹）权輸戍㲓兪腧𧼯䠼䩱隃
ʔəuᵝ2	鋘牙吴吳𡗿（吳）𡗾（吳）郚䓊唔㹳浯娪珸㻍梧祦𧋋蜈𦨳𪁙鯃鼯牾𦨼峿麌齬湖
ʔəuᵝ3	五𠄡㐅午伍仵旿膴䍙瞴嘸𤍍𣞤武母侮㑄（侮）㚢（侮）𢘃（侮）珷𢜮碔倵舞𦐀（舞）㒇廡潕憮甒儛䳇𢋑鵡𦌬䒉敄？悟#語#吾#𠮣（吾）
ʔəuᵝ5	遻迕忤捂啎牾逜悟𢛤（悟）悮悞晤𣅎（晤）焐痦䎸誤寤窹娛#戊
nʉ2	蒘帤挐𣭠袽𣖹璷蘆㠠廬臚䰕閭䕡𤁵𢣻藘𥶆驢䮉櫖爈瞜婁𡜰（婁）𡇔（婁）𡝨（婁）𡝤䣚蔞㺏慺𢡌（慺）膢䝏䱾摟㟺瘻鏤鹿氀𤗬鷜魚（限 木~）𤉯（魚 限 木~）
nʉ3	𡳐履（𡳐之譌）𡲟（履）𩕎（履）女𠨰（女）籹釹吕呂郘侣侶𢈚梠㭚旅𣥏（旅）𣃨（旅）魯（旅）𣥐（旅）祣絽鋁膂𥰠儢穭僂𨻻蔞慺𢡌（慺）謱嶁漊簍𦳭㜢𪈜
nʉ5	女𠨰（女）絮𦊼慮勴𡾅濾櫖𩥆𥶌鑢𠣊𡀿
ʔʉ1	唹淤箊扵唹（囎唹（そお）は鹿兒島縣の地名）
ʔʉ2	蜍擧鵌伃余除妤𤰩舁𦥠（舁）狳畬艅雓餘㺞嬩璵輿歟旟𧾚𤄕㶛𩦡予與𢌱（與）𦦲（與）𠔔（與）藇㦛𢗓（㦛）譽鸒𪋮愈（容朱切）癒瘉#圍（限 又 ~巾）#囗（圍）眙（限 又 盱~）？如#於#𣱏（於）#𤕘（於）#語吁舒
ʔʉ3	𢮁𩩘
ʔʉ5	汙𡫽鄔菸淤瘀𢮁棜飫秗（飫）𩜏醧愈（以主切）䱷䰻
tɕʉ1	苴沮且𠀇（且）𠀃（且）蛆車𠦴（車）居㞐（居）㝒（居）𦱅崌涺𡨢琚椐腒裾蜛䝻鶋据㖩𡸨娵陬掫諏嗺俱岣拘捄枸眗痀跔𥇛駒𨞜鮈㪺仇䀠𥗫俥（くるま）懼
tɕʉ3	苴咀䃊？柜䢹去弆莒𧺹筥舉𥴧櫸𠢈枸椇䅓蒟聥踽𦐛萭楀
tɕʉ5	沮怚𧽟咀沮怚袓跙椐倨豦踞𧣻據据（居御切 手病也 又通據）鋸澽䱟鐻巨𢀑（巨）㠪（巨）𠫕（巨）拒苣岠歫炬𦊐秬粔距𧣒詎鉅矩榘虡𧇆（虡）駏𧇽䶙鐻𦼫詎勮遽澽醵緅足疋（足）𤴕（足）聚鄹埾聚蒟句拘邭䀠𥉁䈮屨怐絇瞿窶𧂜貗具埧犋颶懼愳（懼）𢡔（懼）臞
tɕʰʉ1	椐去阹䒧㭕胠祛袪𥬔𢴮㠊魼圩虚趍趨取鯫嘔
tɕʰʉ2	余䣄俆徐蒣䍱腒𥴧豦懅醵鐻渠淭蕖璖𨞙𦼫磲螶𧝔璩㯫蟝𦄽䝣䆽蘧𠙢（蘧）䟊𨎶籧𪆫蚼眗句拘劬枸朐斪𠣪𡱺翑絇䞤葋軥鴝𪁖（鴝）𩿩（鴝）𩢳翵瞿𪓞鼩蘧𠙢（蘧）忂灈欋戵氍𥃔臞𥗫癯蠷衢𧾱躣蠼鑺鸜姁䧁
tɕʰʉ3	𥅗弆𧉧+去麮𥿇取娶
tɕʰʉ5	坥蜡䏣刞䁦覷覰䒧胠去呿㰦㧁𩿟麮鼁趣𤛐驅敺（驅）
ɕʉ1	胥𦙃（胥）揟㥠楈稰蝑䈝諝䱬湑藇虚虛𣦄歔噓𥛳魖驉𪋯娶繻緰須需𩂉（需）蕦𢄼嬃𥪥𩓣鬚鑐隃荂𥈸虖𠌶吁𠮲（吁）𢖳旴盱㽳姁欨㰭嘔訏𧙆𥈈𣚏𦀒扜䣿雩䩒于墟綏夊（綏）
ɕʉ3	㥠楈稰諝𥚩糈醑湑許鄦𦄼䅡𠳲咻姁欨䧁珝栩冔𦀒詡喣煦祤數繏
ɕʉ5	胥𦙃（胥）彗蔧𥝩遺㒸遂𨒉（遂）𨔱（遂）𨓸（遂）𨔲（遂）𣔾隧𨽡（隧）𦼯澻𤎩𦂁璲檖燧𤑾（燧）穗穟䉌襚旞䡵鐆鐩𩏚𤓫𨎥絮抒序𡱣敘漵緒𥎗𨣦鱮藇嶼𡲁嘘噓尠姁呴昫+酗煦𧏺+續（辭屢切 續靷也）賡（辭屢切 續）壻婿
tɕʰʉ1	䢸苴狙砠疽雎𣻐沮坥趄伹䏣蛆𡳆蒩岨摳區䧢嶇敺軀驅鰸
tɕʰʉ3	踽竘齲
ʔʉ1	蓲䙔迂扜㝼陓虶紆䨕䣿䩽䩒#芋（又音）
ʔʉ2	齵禺娛𨜖隅堣嵎湡虞𠈌（虞）吳（虞）愚㷒𧍪澞鍝髃𪃍鰅𩦢鸆䴁𠌶迂䣿于亏亐邘汙汚（汙）玗杅盂竽𧘘䢓𦏴𦱃雩釪䩒骬謣芋鄃䩱舀𦥝㤤㻀㬰𤜹臾兪茰俞𦚤萸𥑷㳛㥚隃𤧙堬揄楰崳𢔢逾㢏（逾）腴渝愉婾媮瑜楡榆𥔢牏㼶歈𣤏（歈）䛕𦺮𥯮窬褕蕍蝓諛羭䜽踰覦𢋅𨵦螸騟𧃠萮瘐瘉#豫#𠄛（豫）䱷衙魚𤉯（魚）䰻䁩𩺰𩼪鋙齬衙#漁吾𠮣
ʔʉ3	歟与予𢌱與𦦲（與）𠔔（與）藇㦛𢗓（㦛）俁噳麌噢迂傴頨聥栩宇穻（宇）羽雨𠕒（雨）𠕘（雨）𠕲（雨）𩁼（雨）㲾（雨）䣁禹𢁰（禹）𥜼（禹）祤鄅萭㝢瑀楀䨞抌㤤㥚楰𦺮𢈔㼌庾𦳅斞瘐𥦠窳貐圄敔圉語鋙蘌䥏齬篽籞語
ʔʉ5	語馭御𢓷（御）𢕜（御）禦𡱣悇輿歟𩦡與𢌱（與）𦦲（與）𠔔（與）藇忬悆預蕷𡒊澦𣝑穥礜譽鸒𪋮禺遇𠓱（遇）庽寓媀𤸒䴁嘔蓲嫗饇噢吁𠮲（吁）羽雨𠕒（雨）𠕘（雨）𠕲（雨）𩁼（雨）㲾（雨）芋䨒覦喻裕+欲（兪戍切）𠕦𣈯䘱諭？籲+漁
nya1	+𦣛
tɕʰya1	
ɕya1	+𢪎+㗾
ya1	“+𦚢+𠏃
tɕyeʔ7	絕𢇍（絕）𠤉（絕）鱖撅噘𠄌孒氒欮厥𬇌（厥）𨈑（厥）𨈐（厥）𣅞（厥）劂𠢤𧼞蕨獗瘚橛橜𥕲蟨蟩𧽸蹶𨇮𧣸𧱝蹶䞵罬赶鱖撅亅掘𣖬䞷橛橜憠蹷𧤼𨬐𩪜鷢丨夬叏𣲺𢎹决抉芵決玦闋㭈䏐䀗疦𦯊蚗赽趹觖訣鈌駃鴃潏憰鴂吷（古穴切 鳥聲）𧝃𧤾譎鐍觼𣬎騤狊郹𠋬湨犑鶪鼳啐卒𣨛㰵䱣捽誶崒綷踤𦙮𦺖橘𣎛𧽻䤎𧾣繘𦇹（繘）𦈇（繘）倔屈𡕜（屈）𡲶（屈）揭孑
tɕʰyeʔ7	膬敠絟𥕹𦁐㵐闕缺蒛湀喹缺𨴒闋？𢔠？𥄎䠐闃焌黢屈𡕜（屈）𡲶（屈）詘𧌑倔怯
ɕyeʔ7	㨹㡜雪䨮鱈𧋍㿱踅㞽狘泧䎀䬂䟠㤜怴㨝楔揳屑偰𥝁（偰）𦵱僁榍𦞚㴽糏𨆳𨇨吷決泬疦瞲血坹䒸𥅧䆝䦑䛎䆷穴𥤢（穴）袕䋉坹𠷾侐洫𤷇𦑍䦗𧹭𥄎㰲𪑝淢緎閾𨵨𡕥？𥆛？瞁砉規狊𥍟殈𥆛瞁焱𧪞戌卹㖅恤珬欰𣸃𧊥訹怵㺷𨜿賉𥚋銊䳳？欻？𦱧？𠦪？䬍？𩙤（䬍）？𩘐？烼？㗵？獝辥薛辪躠？噱烕隙悉
yeʔ7	𦘹扤鈅月囝刖抈玥枂軏𧿁跀？噦𩚴𡡕黦妜𧊎熭璏泧曰戉𨒋𡛟𣐋蚏𥩡䋐越𦈭（越）𧻂（越）粤粵鉞樾兌䓲說娧蛻恱悅銳閱𧀲抉妜焆𥈾䆕䆢𪑝域㽣（域）䧕（域）𢨊（域）𦱂㚜淢琙棫罭蜮𦈸緎魊䮙𪂉坄役𠈿（役）炈疫䓈𧈻垼豛鈠𩂹𪁛𩷍觱䬑抭㧒𢯮𢔥䁌汩汨淿（汨）𦳯𣅕𡿯㧒䫻
tɕyeʔ7	𨼎㔢蕝
tɕʰyɪ̃3	犬犭
ɕyɪ̃1	梋鋗𩢺駽矎㘣𧾣仙秈
ɕyɪ̃2	還㔯㘣㳬琁旋蜁漩嫙璇𤩅䁢檈䴉䗠璿𤩡（璿）𣟳𤫀鏇圓痃𢛆𧼏
ɕyɪ̃5	㳬旋𢳄漩嫙𦛔镟縼䍻鏇𧾩絃夐駽讂㧦眴絢
ɕyɪ̃5	𤂳選𦌔䠣渲䍻𤂿繏
yɪ̃1	囦剈𠜟（剈）𠝃弲𨓯㾓淵𣶒（淵）蜎鼘䨊
yɪ̃5	䏍肙裫䬼噮
tɕyiŋ1	冂冋坰扃𢇺（扃）𣕄駉駫𪕍冋絅宭君𠱩（君）𠱭（君）軍𡗽（軍）莙桾皸鮶䇹旬均汮袀鈞銞（鈞）汮莙麇麏麕頵呁𧥺
tɕyiŋ3	炅𠖷炯𩚱煛𧍮㯋熲+窘僒
tɕyiŋ5	俊晙焌畯儁餕寯㕙駿𤮪𪕞㼱𠬫（㼱）睃俊𧱝皸捃䝍攈蔨莙菌㖥㻒䐃蜠箘箟（箘）郡珺
tɕʰyiŋ1	蜠箟箘𡈋𧋕囷峮輑
tɕʰyiŋ2	禽𢄕（禽）擒㸪脣䫃（脣）滣䔚漘紃宭帬裙𧛬（裙）裠羣群𤸷尋（新）𡬻（尋）
tɕʰyiŋ3	冂絅褧顈苘檾烓𦄐𧼐
ɕyiŋ1	？垶？𤙡？觪？騂葷焄勛熏勲薫勳薰獯曛臐燻纁醺
ɕyiŋ3	詗
ɕyiŋ5	冂冋迥泂炯𦳖陖埈峻浚晙𡺲鵔鵕迅迿𢏤奞濬𣽊（濬）䜭（濬）𧸩鐼薫薰臐爋𤑕訓𧥥（訓）馴（訓）揮
yiŋ1	奫蝹頵贇
yiŋ2	揘榮（書）嶸蠑瑩瀅禜醟筠囩縜荺員𪔅云䢵芸沄妘𡤀（妘）耘耺紜雲鄖𦓷愪𧶊蕓澐𦔐橒篔䉙溳貟勻匀昀畇
yiŋ3	永栐濙瀠䫟抎𪏚𤸫愪荺隕溳殞磒霣𩆆（霣）䨶（霣）尹𢃵（尹）𢃹（尹）𢃁（尹）𢃂（尹）允㽙（允）狁玧𧉃𡴞䪳馻
yiŋ5	咏泳詠禜醟緷忶鶤員云（員）暈𧶊貟鄆運𨔪（運）韵䲰𤸫𧡡䚋餫䩵韗韻均（韻）#匂
tɕyɪ̃1	勬娟姢捐𦮌㳙𦮻涓䅌鞙䳌鵑蠲睊焆
tɕyɪ̃3	卷𠨟𨹵捲菤𦶘（菤）錈埢韏詃埍罥羂𡿨汱𤰝畎甽（畎）蕊
tɕyɪ̃5	雋𦼱𤺻隽吮𥸭勬𠨟𢍊（𠨟俗字）卷捲帣弮𢍏桊眷䖭絭𨤑+𥆞睠𧯦飬犈觠狷鄄絹𣚓䚈㯞絭卛卷𧯦菌圈蔨圈萒蜎倦淃𣜨韏襈圈懁瓹䣺狷睊罥㢾䡓獧𦌾讂毽券（去願切）劵（渠卷切）
tɕʰyɪ̃1	𠛮峑恮悛駩鐉佺荃硂痊筌絟輇詮𠥙團銓縓拴謜繏譔弮圈棬㒽鬈𨟠#𥆞
tɕʰyɪ̃2	㒰全𠓴（全）泉洤（泉）牷䀬葲𧍭醛仝卷捲𥁠拳𢮙（拳）㩲（拳）婘𥆗犈𤷄觠蜷踡鬈𢑆孉權䑏齤蠸䟒䠰顴𪈻狋
tɕʰyɪ̃3	裷䅚䊎綣𪐂虇
tɕʰyɪ̃5	縓𥆊諯絭綣虇韏勸絭飬𥛁䠣？圈
ɕyɪ̃1	宣𡨈𡩦揎愃瑄㩊𡈣䳦𩕖𩓧頨儇嬛蠉𩙽翾？𩙽𦐽𧾎譞䴉𥌭弲讙貆吅萱喧愋暄䚙煖暖煊䁔蝖翧諼諠䳦䚭塤壎坃（壎）壦（壎）喛
ɕyɪ̃2	伭𠛑弦胘𢮂𦱁蚿舷婱訇䙲盷𠆺胘縣𤣥玄妶玹𧟨䮄懸眩𥌭玆
ɕyɪ̃3	選𦌔𦌻𥶷𧡩咺愃䁔諼烜暅𧾣蠉癬
ɕyɪ̃5	𩋢楥韗䭴繯𦇏鞙埍妶䀏泫𨹆䧎㻆琄𨊼𩉥鉉䩙𥌭贙寰玹䀏炫眩袨眴衒䝮𧗳𩑹贙姰迿
tɕyɪ̃1	剶鋑鐫朘
tɕyɪ̃3	臇𤎱𧕣
yɪ̃1	裷蜿宛𡟰㠾眢冤葾惌蒬𣹠䡝鴛𩝸䥉鵷䩩怨𢘖（怨）𠨝（怨）𢛪（怨）𢘔（怨）𢘈（怨）悁潫嬛𡷡蜎𡣬潫嬽
yɪ̃2	阮元邧芫沅杬原𠪥（原）𨘡（原）𠪰（原）蚖䬧蒝獂源嫄榞㹉螈羱黿謜邍騵𨙅𧔞厵洹垣𡋡爰袁援猨媛𧻚園猿溒榬蝯轅鶢𩫧圜員云（員）圎湲圓貟鈆鉛𦛔+㳂+沿鳶蝝縁緣𦿂櫞䱲閻
yɪ̃3	朊邧𠒜𡯱䖤睕蜿箢宛倇菀婉琬晼𤗍畹䘼踠𩎺惌䛄䩩𩌑夗苑逺遠𨖸（遠）𢕱（遠）𩔃㕣𧮲（㕣）抁沇沿（沇）兖兗萒𢯻渷𦁙𩘍馻
yɪ̃5	傆愿願𩕾䛄怨𢘖（怨）𠨝（怨）𢛪（怨）𢘔（怨）𢘈（怨）援媛褑院瑗逺遠𨖸（遠）𢕱（遠）縁緣掾𢐄䬇
xoʔ	活
kəʔ7 la1	角
taŋ ŋa	大
