pa	pa	夫玞砆鳺邞鈇
paʔ	paq	斧蚥甫{男子美稱；大；開始}父{甫}簠黼脯㕮
pah	pah	賦傅
pʰa	pha	敷郙
pʰaʔ	phaq	撫俌
ba	ba	夫扶芙枎榑
baʔ	baq	父釜窰{釜}滏輔鬴{釜}秿
bah	bah	賻
ma	ma	無无蕪巫誣莁𨼊璑
maʔ	maq	武鵡舞潕廡甒儛膴{美厚}憮{悵然失意}𢜮
m̥a	mha	吁{憂}
m̥aʔ	mhaq	鄦許{國名；姓}
ta	ta	諸櫧遮
taʔ	taq	渚陼煑煮䰞褚{囊袋}者赭
tah	tah	翥柘𢱋{柘、樜}蔗鷓炙{煮熟的肉食}
sta	sta	書奢奓
staʔ	staq	緒暑
stah	stah	庶
tʰaʔ	thaq	處杵
tʰah	thah	處{名詞，處所}厈䞣{抵拒}
da	da	蜍{蟾蜍}
daʔ	daq	社
dah	dah	署曙藷薯
na	na	如茹{根；茹藘，茜草}𩶯鴽𨚴洳{潮濕}
naʔ	naq	汝茹{喫}
nah	nah	茹{柔軟；猜度}洳{沮洳，低濕之地}𣹤
n̥ah	nhah	恕絮{粗絲綿}赦
tsa	tsa	且{多；也且；紀月地支；專名}苴{鞋中草墊}蛆{蝍蛆}䪶罝瘥{病愈}
tsaʔ	tsaq	咀飷
tsah	tsah	沮{沮洳，低濕之地}唶借{借出；假如}
tsʰa	tsha	沮{河名}狙砠疽雎鴡䢸
tsʰaʔ	tshaq	且
dza	dza	豠
dzaʔ	dzaq	沮{阻止；毀壞；恐懼}
dzah	dzah	藉{草墊}
sa	sa	胥蝑
saʔ	saq	湑諝糈稰胥{才智；小官}
la	la	余餘畬{熟田}雓狳䳜{鵸䳜}
laʔ	laq	予野壄
lah	lah	豫{安樂、喜悅}預悆畬{治理熟田}射{射干，木名}
l̥a	lha	舒荼{玉器}賒
l̥aʔ	lhaq	鼠癙黍舍{舍棄；赦免；施舍}
l̥ah	lhah	舍舎捨騇涻
slaʔ	slaq	寫瀉序{廂房；學校}敘{次序；記敘}漵紓芧{橡子}
sla	sla	徐䣄
slah	slah	榭謝㴬
mlaʔ	mlaq	墅野{東漢中原方言}抒杼{櫟；汲出，排泄}
mlah	mlah	射䠶
ra	ra	藘廬驢慮{思考，謀劃}
raʔ	raq	旅膂呂侶鋁
rah	rah	慮勴濾
C.ra	C.ra	閭臚
C.raʔ	C.raq	儢
ja	ja	輿譽{讚譽}璵旟歟𪋮耶瑘琊鎁鋣邪{語氣助詞}
jaʔ	jaq	與冶
jah	jah	譽{聲譽}與{參與}鸒{鸒斯，鳥名}礜藇{藷藇}蕷豫{猶豫}赦夜射{僕射、射姑}鵺
j̊a	jha	車
kjaʔ	kjaq	舉
kjah	kjah	舉{自舉；飛起}
sja	sja	邪{不正}衺斜
sjaʔ	sjaq	藇{酒美}鱮
ka	ka	琚裾倨据崌鶋居{句末助詞；居居，安靜貌}
kaʔ	kaq	柜矩榘萭
kah	kah	椐鋸鐻{樂器}
kʰa	kha	祛阹
kʰaʔ	khaq	麮去{除}墟{大丘}
kʰah	khah	去{離}呿袪
ga	ga	渠蕖蚷腒懅籧蘧鐻{耳環}醵
gaʔ	gaq	巨姖鉅拒詎秬岠苣歫距炬虡簴
gah	gah	遽豦
ŋa	nga	魚漁{捕魚}吾{吾吾，疏遠貌}衙{衙衙，行走貌}
ŋaʔ	ngaq	語圉圄禦篽敔御{馭手；近侍}
ŋah	ngah	御馭漁{漁夫}語{告訴}
ŋ̊aʔ	nghaq	許
ha	ha	虛噓魖𧴆歔
haʔ	haq	所{所所}許{許許}
kwa	kwa	𥇛㪺
kwaʔ	kwaq	楀聥踽鄅
kwah	kwah	瞿{瞿瞿，驚視不安；勤謹貌}
kʰwaʔ	khwaq	齲
gwa	gwa	瞿{戟類兵器}衢躣鸜灈
gwah	gwah	懼
ŋwa	ngwa	虞{官名；祭名；國名}澞娛
ŋwaʔ	ngwaq	俁{俁俁，大}噳{噳噳，多}麌
ŋwah	ngwah	虞{猜測，憂患；欺詐；驚}
wa	wa	于竽玗盂雩謣邘迂杅粵
waʔ	waq	雨羽宇禹偊䣁瑀
wah	wah	芋雨{及物動詞}羽{箭杆上的翎毛}雩{虹}
ẘa	wha	吁盱荂雩{雩婁}
ẘaʔ	whaq	栩詡訏{訏訏，廣大}冔
ẘah	whah	訏{大}
ʔa	qa	於
ʔah	qah	淤{動詞}菸𡌧棜瘀𩜏
ʔwa	qwa	紆陓汙{誇大；迂曲}扜
pra	pra	膚
praʔ	praq	甫{國名}
tra	tra	豬潴瀦
traʔ	traq	貯褚{棺飾}𤲑
trah	trah	著{顯著；成就；記載}箸
tʰra	thra	㯉樗
dra	dra	躇藸著{著雍}儲
draʔ	draq	宁佇羜紵竚
drah	drah	著{大門與屛風之間的地方}
nra	nra	挐蒘袽帤
nraʔ	nraq	女籹
nrah	nrah	女{將女子嫁人}
n̥ra	nhra	絮{調味}
tsra	tsra	菹葅
tsraʔ	tsraq	阻俎
tsrah	tsrah	詛
tsʰra	tshra	初
tsʰraʔ	tshraq	楚濋
dzra	dzra	苴{麻子}鋤鉏{鋤}
dzraʔ	dzraq	助{幫}鉏{鉏鋙}
dzrah	dzrah	助{支持，促進；助法，一種勞役租賦制度}耡麆
sra	sra	疋疏疎踈梳蔬
srah	srah	疏{疏通意旨的文字。謂分條記錄或分條陳述}
lra	lra	除{使動}篨蒢
lraʔ	lraq	杼{機杼；削尖；帝}伃{帝杼}芧{三棱草}
lrah	lrah	除{自動，避免；給予；過去}
r̥a	rha	攄
kra	kra	車居凥
kraʔ	kraq	莒筥
krah	krah	踞據居{踞坐；安居；居所；處理；居居，不相親近}
kʰra	khra	墟
graʔ	graq	粔
ŋraʔ	ngraq	鋙
ŋ̊raʔ	nghraq	所
pˤa	p'a	逋餔晡
pˤaʔ	p'aq	補
pˤah	p'ah	布圃{園；茂盛}
pʰˤa	ph'a	鋪痡
pʰˤaʔ	ph'aq	浦溥普
pʰˤah	ph'ah	怖
bˤa	b'a	蒲莆匍酺
bˤaʔ	b'aq	簿蓴{簿}蒲{蒲柳，即水楊}
bˤah	b'ah	步薄{動詞}捕哺
mˤa	m'a	嫫𡠜膜{拜}
mˤaʔ	m'aq	莽{草叢；茂盛}募
mˤah	m'ah	莫{暮；晚}暮慕墓慔摹{規劃；求取}謨摸{謨}
m̥ˤa	mh'a	膴{無骨的干肉}幠憮{大、粗}
tˤa	t'a	都闍
tˤaʔ	t'aq	覩睹堵帾楮
tˤah	t'ah	妬妒秅㓃
tʰˤa	th'a	㻬
tʰˤaʔ	th'aq	土吐芏
dˤa	d'a	徒跿圖{不及物，圖畫；思慮；謀取}瘏屠䣝
dˤaʔ	d'aq	杜圖{及物，規劃；推測}
dˤah	d'ah	度渡圖{名詞，計策；抱負}
nˤa	n'a	奴砮帑孥駑
nˤaʔ	n'aq	弩怒{氣勢強盛，威勢勃發；激怒；努}
nˤah	n'ah	笯怒{憤；譴責}
tsˤa	ts'a	租蒩
tsˤaʔ	ts'aq	祖組
tsˤah	ts'ah	作{生長、萌發；顯現、發作}
tsʰˤa	tsh'a	粗{糙米；粗糙}麤觕
tsʰˤah	tsh'ah	錯{措}措酢醋
dzˤa	dz'a	徂殂虘
dzˤaʔ	dz'aq	駔粗{大}蔖
dzˤah	dz'ah	祚胙阼
sˤa	s'a	蘇{扶蘇；姑蘇；蘇蘇}
sˤah	s'ah	素嗉傃
lˤa	l'a	塗荼涂途蒤嵞鵌鷋駼鷵菟{於菟，虎}筡
lˤah	l'ah	斁{敗壞}途{途徑，路途}
l̥ˤaʔ	lh'aq	稌兔
l̥ˤah	lh'ah	菟鵵
rˤa	r'a	盧蘆壚鸕顱攎蠦櫨玈艫轤鱸瀘
rˤaʔ	r'aq	魯鹵滷蓾櫓
rˤah	r'ah	璐賂輅簬簵
C.rˤa	C.r'a	鑪爐黸纑
C.rˤaʔ	C.r'aq	虜
C.rˤah	C.r'ah	路露鷺潞
kˤa	k'a	姑辜沽{買賣；水名}酤{沽酒}鴣蛄橭嫴
kˤaʔ	k'aq	股羖古罟𦊟沽{粗劣}盬賈蠱䀇故{事；故交}苦{粗劣；止息}楛{粗劣}
kˤah	k'ah	固故詁錮痼
kʰˤa	kh'a	枯軲
kʰˤaʔ	kh'aq	苦𩇵
kʰˤah	kh'ah	庫䔯
gˤa	g'a	乎㝬胡瑚湖葫鶦鶘餬糊鬍魱𪏻𧛞
gˤaʔ	g'aq	岵怙祜酤{酒}楛{木}芐{地黃}苦{地名}
gˤah	g'ah	互枑嫮嫭沍
ŋˤa	ng'a	吾梧郚鼯浯
ŋˤaʔ	ng'aq	五伍午迕仵窹寤{睡醒；覺悟}
ŋˤah	ng'ah	忤悟{察覺；啟發}牾啎𠵦𧺴蘁晤逜捂遻
ŋ̊ˤa	ngh'a	蘇
ŋ̊ˤah	ngh'ah	愬訴泝溯遡𧪜
hˤa	h'a	呼虖嘑淲{滹沱河}
hˤaʔ	h'aq	滸虎俿{虎}琥箎𨝘
hˤah	h'ah	呼{號}謼
kwˤa	kw'a	孤觚軱泒菰苽罛柧
kwˤaʔ	kw'aq	鼓皷瞽顧{眷顧、照顧、理會}
kwˤah	kw'ah	顧{回看；還；反省}呱僱
kʰwˤa	khw'a	刳挎鮬郀
kʰwˤah	khw'ah	袴褲絝
gwˤa	gw'a	壺弧狐
gwˤaʔ	gw'aq	户戶扈鳸鄠
gwˤah	gw'ah	護韄䨼瓠穫{焦穫，地名}
ŋwˤa	ngw'a	吳𩶭鋘
ŋwˤah	ngw'ah	誤悞
wˤaʔ	w'aq	雽
ʔˤa	q'a	於歍烏嗚惡{疑問代詞；歎詞}
ʔˤaʔ	q'aq	鄔{鄭地}隖
ʔˤah	q'ah	惡{憎；誹謗；畏懼；冒犯}鄔{晉地}
ʔwˤa	qw'a	汙污汚窏洿圬杇鴮
ʔwˤah	qw'ah	汙{玷污}
pˤra	p'ra	巴芭豝鈀
pˤraʔ	p'raq	把
pˤrah	p'rah	霸灞
pʰˤra	ph'ra	葩蚆
bˤra	b'ra	杷
mˤra	m'ra	蟆𢋙䗫
mˤraʔ	m'raq	馬
mˤrah	m'rah	禡罵㾺鬕䣕
tˤrah	t'rah	吒咤
tʰˤra	th'ra	譇
tʰˤrah	th'rah	侘詫{告}
nˤra	n'ra	挐{拏}拏
nˤraʔ	n'raq	䋈
tsˤra	ts'ra	抯柤樝楂
tsˤraʔ	ts'raq	苴{土苴；木名}
tsˤrah	ts'rah	詐
dzˤra	dz'ra	苴{枯草}䣜
dzˤrah	dz'rah	乍咋
lˤra	l'ra	茶梌
kˤra	k'ra	葭豭猳家犌麚
kˤraʔ	k'raq	假{借入}椵瘕榎賈{國名、姓}檟斝嘏
kˤrah	k'rah	稼嫁價假{借出}幏
kʰˤra	kh'ra	加{膠加，乖戾}
gˤra	g'ra	遐霞瑕䪗蕸騢鰕假{嘉美}蝦
gˤraʔ	g'raq	夏下暇{名詞，閒暇；副詞，可能，應該}廈帠
gˤrah	g'rah	芐{蒲萍}暇{形容詞，閒散怠惰}
ŋˤra	ng'ra	牙芽衙{地名}
ŋˤraʔ	ng'raq	雅庌
ŋˤrah	ng'rah	迓訝牙{車輞}御{迎接；面向}輅{迓}
hˤrah	h'rah	嚇罅
kwˤra	kw'ra	瓜
kwˤraʔ	kw'raq	寡
kʰwˤra	khw'ra	夸姱跨誇侉
gwˤrah	gw'rah	槬獲擭
wˤra	w'ra	華{開花；華美；山}嘩驊釫
wˤrah	w'rah	華{剖開；瓊華，美石}
ẘˤra	wh'ra	華{花}花譁
ʔˤra	q'ra	鴉𠜲𢵣{𠜲}
ʔˤraʔ	q'raq	啞
ʔˤrah	q'rah	亞啞{表驚歎}㰳
ʔwˤra	qw'ra	窊
paŋ	pang	方枋牥汸肪鈁邡{什邡}
paŋʔ	pangq	放{效仿；依傍；到；放蕩}昉旊舫方紡{紡紗；捆縛}
paŋh	pangh	放{流放；釋放；放下}
pʰaŋ	phang	芳妨
pʰaŋʔ	phangq	仿紡{紡織品}髣{髣髴，隱約}彷{彷彿，隱約}鶭
pʰaŋh	phangh	訪邡
baŋ	bang	房防坊{防}魴
bak	bak	縛𦇙
maŋ	mang	亡亾忘望朢惘芒{芒芒，廣大遼闊；句芒，木神}莣杗
maŋʔ	mangq	網罔𦉾蝄𣶈{𣶈瀁，水盛貌}輞魍
maŋh	mangh	妄望{聲望，威望}忘{玩忽；健忘}
taŋ	tang	章彰漳璋障樟獐鄣遧瞻{明見；昭示}
taŋʔ	tangq	掌
tak	tak	蹠譕{蹠}摭炙跖斫
staŋ	stang	商螪蔏
staŋʔ	stangq	賞{玩賞，欣賞}
staŋh	stangh	賞{獎；讚；所賞；勸告}
tʰaŋ	thang	昌倡唱猖菖閶
tʰaŋʔ	thangq	敞惝
tʰak	thak	斥尺蚇拆叱
daŋ	dang	常裳徜嘗甞償{酬報，恩惠}鱨尚{崇尚；推舉；佑助；主要；夸耀}
daŋʔ	dangq	上{動詞，升；凌駕；施加}
daŋh	dangh	尚{上；超過；副詞}上{形容詞，上下}償{賠償，償還}
dak	dak	石祏碩鼫䄷
naŋ	nang	攘穰瀼禳讓{謙讓的品德}鬤儴𨟚鑲蘘
naŋʔ	nangq	壤蠰{蠰谿}攘{紛亂}
naŋh	nangh	讓{謙讓、辭讓；責讓；款待}
nak	nak	若鄀箬
n̥aŋʔ	nhangq	曏
n̥aŋh	nhangh	蠰饟
n̥ak	nhak	螫
n̥aŋ	nhang	襄驤纕
tsaŋ	tsang	將漿醬蔣
tsaŋʔ	tsangq	獎槳蔣{國、姓}
tsaŋh	tsangh	將{將領}
tsak	tsak	踖{踖踖，恭敬}借{借入}
tsʰaŋ	tshang	將{願、請；將將，金玉之聲；將將，美盛、整飭；集聚貌}斨鏘瑲槍蹌搶牄鎗{金玉之聲}鶬{以金爲飾；金玉之聲}
tsʰak	tshak	鵲䧿踖{踖陵，地名}碏
dzaŋ	dzang	戕牆薔{蘠}蘠嬙廧
dzaŋh	dzangh	匠
dzak	dzak	籍藉猎踖耤
saŋ	sang	相湘{江}箱廂緗
saŋʔ	sangq	想
saŋh	sangh	相{百官之長；贊禮者；貌；紀月地支}
sak	sak	昔惜腊皵
laŋ	lang	昜陽楊揚瘍鍚颺暘鸉湯{暘}
laŋh	langh	煬
lak	lak	睪譯繹嶧懌斁{厭棄；盛大}驛射{厭棄；無射}奕{奕奕，美盛}
l̥aŋ	lhang	傷觴殤禓䵮湯{湯湯，水流盛大貌}鬺
l̥ak	lhak	釋郝{郝郝，耕地翻土聲}醳𥼶奭襫
slak	slak	舄蕮潟
slaŋ	slang	餳湘{煮}
slaŋʔ	slangq	象像蟓橡
mlak	mlak	射{及物}麝
raŋ	rang	良踉蜋{蜣蜋、蜋蜩}梁量{動詞，測量}糧輬椋掠
raŋʔ	rangq	兩蜽輛緉悢魎
raŋh	rangh	量{名詞，度量衡；數量；佈滿；窪地}
rak	rak	㗉
C.raŋ	C.rang	涼粱
C.raŋh	C.rangh	亮諒
C.rak	C.rak	略
jaŋ	jang	羊洋徉佯痒恙𩰱
jaŋʔ	jangq	養{上育下}瀁{𣶈瀁，水盛貌}癢䖹
jaŋh	jangh	漾養{下奉上，奉養；供奉；役卒}羕
jak	jak	亦奕弈帟腋掖液汐{液}
j̊ak	jhak	赤
kjaŋ	kjang	姜𨜰
kʰjaŋ	khjang	羌
sjaŋ	sjang	詳祥翔𦍙{祥}𨀘庠𦍲洋{水名。即今山東瀰河}
sjak	sjak	夕穸
kaŋ	kang	畺僵疆薑橿繮彊{彊彊，相隨貌}
kaŋʔ	kangq	繈鏹襁
kak	kak	腳
kʰaŋ	khang	蜣
kʰak	khak	卻却
gaŋ	gang	強强
gaŋʔ	gangq	強{勸勉；勤勉；勉強}滰
ŋaŋʔ	ngangq	仰
ŋaŋh	ngangh	仰{依賴}
haŋ	hang	享{享用}鄉饗{宴生人}薌膷香向{周畿內邑}
haŋʔ	hangq	響蠁{肸蠁}
haŋh	hangh	嚮向鄉{向}曏餉
kwaŋʔ	kwangq	獷
kwaŋh	kwangh	誑迋{誑}
kwak	kwak	矍攫玃貜
kʰwaŋ	khwang	匡筐眶邼洭恇
kʰwak	khwak	躩
gwaŋ	gwang	狂
gwaŋʔ	gwangq	俇
gwak	gwak	戄臞
waŋ	wang	王
waŋʔ	wangq	往
waŋh	wangh	往{及物}迋{往}暀旺王{稱王；興盛}
ẘaŋ	whang	貺
ẘaŋʔ	whangq	怳
ẘaŋh	whangh	況軦
ʔaŋ	qang	央殃鉠
ʔaŋʔ	qangq	怏佒鞅柍
ʔwaŋʔ	qwangq	枉
ʔwak	qwak	矱
praŋ	prang	兵
praŋʔ	prangq	丙炳怲邴秉
praŋh	prangh	柄寎
prak	prak	碧
braŋh	brangh	病
mraŋ	mrang	明盟
mraŋʔ	mrangq	皿
traŋ	trang	張粻餦
traŋʔ	trangq	長{年長；生長}
traŋh	trangh	脹帳張{膨脹；張揚}
trak	trak	著{填充；穿、戴，放置，他動}𣃈{鐯}𩁥{鐯}鐯席
tʰraŋ	thrang	倀
tʰraŋʔ	thrangq	悵
tʰraŋh	thrangh	韔鬯
tʰrak	thrak	躇{超越}
draŋ	drang	長{久；擅長；長處}萇
draŋʔ	drangq	丈杖{棍棒、兵器}仗{兵器}
draŋh	drangh	長{多餘；長度}杖{執持；依仗}仗{執持；依仗}
drak	drak	著{附；殷商酒器，已置，自動}蓆
nraŋ	nrang	孃
nraŋh	nrangh	釀
n̥rak	nhrak	婼
tsraŋ	tsrang	莊裝壯{壯大；年輕；加強}
tsraŋh	tsrangh	壯{茁壯；堅實；勇猛}𢎳
tsrak	tsrak	斮
tsʰraŋ	tshrang	創瘡
tsʰraŋʔ	tshrangq	愴㼽
tsʰrak	tshrak	簎
dzraŋ	dzrang	牀床
dzraŋh	dzrangh	狀
sraŋ	srang	霜爽鷞鸘孀
lraŋ	lrang	場腸
l̥raŋh	lhrangh	暢畼
l̥rak	lhrak	㚟
kraŋ	krang	京麖境麠
kraŋʔ	krangq	景
kraŋh	krangh	竟鏡
krak	krak	戟
kʰraŋ	khrang	慶卿
kʰrak	khrak	綌紶{綌}郤郄隙隟𢜭
graŋ	grang	鯨勍黥
graŋʔ	grangq	競
graŋh	grangh	倞
grak	grak	劇臄
ŋraŋ	ngrang	迎
ŋraŋh	ngrangh	迎{往迎，迎親}
ŋrak	ngrak	逆縌
ŋ̊rak	nghrak	朔虩覤
kwraŋʔ	kwrangq	憬
wraŋʔ	wrangq	永泳
wraŋh	wrangh	詠咏
ẘraŋ	whrang	兄
ʔraŋ	qrang	英
ʔraŋʔ	qrangq	影
ʔraŋh	qrangh	詇
pˤaŋh	p'angh	謗
pˤak	p'ak	博簙搏鎛鑮{鎛}猼髆𧽢𩌏
pʰˤaŋ	ph'ang	旁{旁薄}滂雱
pʰˤak	ph'ak	蒪膊胉粕
bˤaŋ	b'ang	旁傍膀彭{彭彭，盛多}彷{彷徉、彷徨}𨜷
bˤaŋh	b'angh	徬
bˤak	b'ak	薄亳泊礡
mˤaŋ	m'ang	芒盲㡛蘉汒茫邙
mˤaŋʔ	m'angq	莽{無邊際}漭蟒
mˤak	m'ak	莫漠幕寞嗼瘼鏌瞙鄚𩌧
m̥ˤaŋ	mh'ang	荒肓衁
m̥ˤaŋʔ	mh'angq	謊慌{恍}怳恍𡧽
tˤaŋ	t'ang	當蟷璫{瓦當}擋{擿擋，鼓聲}襠{坎肩、背心之類}
tˤaŋʔ	t'angq	黨䣊
tˤaŋh	t'angh	瓽當{公正}
tˤak	t'ak	蠹
tʰˤaŋ	th'ang	鏜蝪
tʰˤaŋʔ	th'angq	儻倘曭
tʰˤak	th'ak	託拓托柝橐蚸沰
dˤaŋ	d'ang	堂棠螗螳䣘
dˤak	d'ak	度{動詞，測量；揣測；裝填}剫
nˤaŋ	n'ang	囊蠰{蟷蠰}
nˤaŋʔ	n'angq	曩
nˤaŋh	n'angh	儾
nˤak	n'ak	諾
n̥ˤak	nh'ak	蠚
tsˤaŋ	ts'ang	牂臧贓葬蕆{疑同“臧”}
tsˤak	ts'ak	作迮柞
tsʰˤaŋ	tsh'ang	倉蒼凔滄鶬獊
tsʰˤak	tsh'ak	錯厝剒棤
dzˤaŋ	dz'ang	藏{隱藏；儲藏}奘
dzˤaŋh	dz'angh	藏{儲存東西的地方；寶藏；內藏}臟
dzˤak	dz'ak	怍酢{酬}昨柞{柞格}笮{黥刑}㸲𦁎䣢醋{酬}
sˤaŋ	s'ang	桑喪顙
sˤak	s'ak	索溹
lˤaŋ	l'ang	唐塘鶶榶溏愓餳糖宕踼
lˤaŋʔ	l'angq	璗蕩盪簜𥯕
lˤaŋh	l'angh	碭
lˤak	l'ak	鐸
l̥ˤaŋ	lh'ang	湯薚蕩{水名}
l̥ˤaŋh	lh'angh	湯{燙}
l̥ˤak	lh'ak	蘀籜
rˤaŋ	r'ang	郎朗廊狼浪琅稂𦵧駺蜋{螳蜋}螂桹
rˤaŋʔ	r'angq	朖俍浪{孟浪，疏闊而不精要；荒誕而無邊際}
rˤaŋh	r'angh	埌閬
rˤak	r'ak	洛酪雒駱絡鵅{水鳥名}烙硌鮥𩊚珞笿
C.rˤak	C.r'ak	落
hjak	hjak	郝
kˤaŋ	k'ang	亢岡剛綱犅堈崗𦱌坑{山脊}㼚缸{㼚}
kˤak	k'ak	各閣胳袼{胳}
kʰˤaŋ	kh'ang	康糠穅伉漮
kʰˤaŋʔ	kh'angq	慷忼
kʰˤaŋh	kh'angh	炕閌犺邟
kʰˤak	kh'ak	恪
gˤaŋ	g'ang	行{行列、排列；質量差}頏杭抗桁{刑具}笐迒苀蚢胻航魧亢{喉嚨}
gˤaŋʔ	g'angq	沆
gˤaŋh	g'angh	行{輩分}
gˤak	g'ak	涸貉狢貈
ŋˤaŋ	ng'ang	卬昂
ŋˤak	ng'ak	咢鄂噩愕鍔鶚遌諤腭堮
hˤak	h'ak	壑
kwˤaŋ	kw'ang	光洸胱桄珖茪
kwˤaŋʔ	kw'angq	廣
kwˤaŋh	kw'angh	廣{兵車；直徑}櫎
kwˤak	kw'ak	郭椁槨擴
kʰwˤaŋ	khw'ang	曠{照曠}
kʰwˤaŋʔ	khw'angq	懭
kʰwˤaŋh	khw'angh	壙纊絖曠{空曠}
kʰwˤak	khw'ak	廓鞹鞟漷篧
gwˤaŋ	gw'ang	黃簧璜潢蟥
gwˤaŋh	gw'angh	䌙
gwˤak	gw'ak	檴{檴落}濩穫鑊㦜瓠{瓠落}
ŋwˤak	ngw'ak	瓁
wˤaŋ	w'ang	皇凰煌熿遑韹餭徨惶媓湟蝗葟騜隍篁偟
ẘˤak	wh'ak	霍藿𧆑靃
ʔˤaŋ	q'ang	鴦
ʔˤaŋʔ	q'angq	泱盎坱
ʔˤaŋh	q'angh	㼜
ʔˤak	q'ak	惡{罪；醜；兇暴；惡人；骯髒之物}堊蝁
ʔwˤaŋ	qw'ang	尪汪
ʔwˤak	qw'ak	蠖雘
pˤraŋ	p'rang	祊閍旁{旁旁，強壯有力}傍{傍傍，事務繁劇，忙於奔走應付}
pˤraŋh	p'rangh	榜{槳}
pˤrak	p'rak	百伯柏迫募{水名}佰
pʰˤraŋ	ph'rang	亨{烹；祭祀}享{祭鬼神}烹
pʰˤrak	ph'rak	魄拍
bˤraŋ	b'rang	彭{彭彭，強壯}蒡榜{矯正弓弩的器具}搒
bˤraŋʔ	b'rangq	並{一起；並列}竝
bˤrak	b'rak	白帛鮊
mˤraŋ	m'rang	萌{芽}氓甿虻蝱䖟鄳莔
mˤraŋʔ	m'rangq	猛孟{孟浪，疏闊而不精要；荒誕而無邊際}
mˤraŋh	m'rangh	孟
mˤrak	m'rak	陌貘貊百{一種在祭祀中奏樂的儀式}
tˤrak	t'rak	磔
tʰˤraŋ	th'rang	瞠
tʰˤrak	th'rak	坼䞣{半步}
dˤraŋ	d'rang	棖䟫
dˤrak	d'rak	宅
tsˤrak	ts'rak	笮{盛箭的竹器；屋上的箔席}窄柞{伐木}筰{窄}
tsʰˤraŋ	tsh'rang	鎗{鏗鎗}
dzˤraŋ	dz'rang	傖
dzˤrak	dz'rak	齰蜡矠
sˤrak	s'rak	索{求；選擇；搜查}
lˤrak	l'rak	擇澤檡鸅蠌
kˤraŋ	k'rang	庚更羹賡鶊秔粳
kˤraŋʔ	k'rangq	梗鯁綆{繩}哽郠埂
kˤraŋh	k'rangh	更{副詞}
kˤrak	k'rak	格假{格}茖鉻骼鵅{鵋䳢、鵂鶹}觡挌
kʰˤraŋ	kh'rang	阬坑
kʰˤrak	kh'rak	客喀衉
gˤraŋ	g'rang	行珩衡蘅桁{葬具}
gˤraŋʔ	g'rangq	荇杏莕
gˤraŋh	g'rangh	行{行爲，名詞；實施；品行；巡視}
gˤrak	g'rak	格{抵禦；捍格，堅硬}輅{車前橫木；駕}
ŋˤraŋh	ng'rangh	枊{硬}硬
ŋˤrak	ng'rak	額頟詻
hˤraŋ	h'rang	亨{亨通}
hˤrak	h'rak	赫
kwˤraŋ	kw'rang	觥觵
kwˤraŋʔ	kw'rangq	礦穬
kwˤrak	kw'rak	虢
gwˤraŋ	gw'rang	橫
gwˤraŋh	gw'rangh	橫{橫暴，放縱}
gwˤrak	gw'rak	獲鱯
wˤraŋ	w'rang	喤鍠
ẘˤraŋ	wh'rang	諻嚝
ẘˤrak	wh'rak	謋
ʔˤrak	q'rak	啞{啞啞，笑聲}
paj	paj	陂䎱䥯詖{不正}
pajʔ	pajq	彼柀罷{離開，分散}
pajh	pajh	貱披{喪具}詖{諂佞}跛{斜著站，動詞}被{給予}
pas	pas	廢櫠發{射箭，發射；行動}
pʰaj	phaj	披鈹被{搭衣；穿；依傍；帔，披風；被被，長大貌}鮍
pʰas	phas	㤄{㤄㤄，輕慢}
baj	baj	皮
bajʔ	bajq	被{被子；表面；合}
bajh	bajh	鞁被
bas	bas	茷伐{功勞}
maj	maj	靡{共有；分散；損壞；浪費；靡靡，遲緩}攠縻糜䊳㸏爢穈
majʔ	majq	靡{倒伏；細密；無、非}蘼
m̥aj	mhaj	麾
tas	tas	晢晣晰迣{遮攔}
stajʔ	stajq	誃
tʰajʔ	thajq	侈袲哆鉹袳
tʰas	thas	懘
dajʔ	dajq	恀
das	das	逝筮噬澨遾遰{刀鞘}
tsaj	tsaj	嗟𨲠
tsas	tsas	際瘵{接近}穄傺
dzajh	dzajh	髊
saj	saj	徙{蜀地名}
sajʔ	sajq	徙蓰
sajh	sajh	杫
laj	laj	迆杝柂箷椸酏𨠑釶鉇施{斜；大尺}暆蛇{委蛇}袘迤{逶迤}移迻𤝻簃栘
lajʔ	lajq	扡迤{斜}匜拸也
lajh	lajh	貤施{延伸；改易}
las	las	裔靾泄{泄泄，遲緩；多言}洩呭詍跇絏渫{蒸蔥}
l̥aj	lhaj	施葹䗐
l̥ajʔ	lhajq	豕𨴯弛㢮
l̥ajh	lhajh	施{施以恩惠，施與，施捨}
l̥as	lhas	世貰
slajʔ	slajq	灺
slas	slas	泄
mlaj	mlaj	蛇虵
mlajʔ	mlajq	舐𦧇咶𤜣
raj	raj	離鸝蘺籬灕縭罹醨{薄酒}樆詈
rajʔ	rajq	邐
rajh	rajh	離{去除；相離}
ras	ras	例癘櫔𩢾䅀蠣
C.ras	C.ras	厲礪勵
jas	jas	㵝{溶㵝}
kaj	kaj	奇{奇偶；餘數；詭異不正}掎畸倚{單個；怪僻}
kajʔ	kajq	踦{抵住}剞{剞劂}
kajh	kajh	寄徛
kʰaj	khaj	踦{一足}觭
kʰajʔ	khajq	綺
kʰas	khas	揭{揭衣}
gaj	gaj	奇{稀奇；窮奇}騎{動詞}錡{帶齒的長柄斧}琦鵸
gajʔ	gajq	錡踦{足}
gajh	gajh	騎{名詞，坐騎；車馬；騎兵}
ŋaj	ngaj	義儀䣡轙議宜鸃
ŋajʔ	ngajq	蟻齮錡{姓}
ŋajh	ngajh	義{正義、仁義}誼
ŋas	ngas	乂刈艾{安寧}
ŋ̊aj	nghaj	羲犧䖒戲{專名}巇𤬘
ŋ̊ajh	nghajh	戲
kwaj	kwaj	嬀媯
kʰwaj	khwaj	虧
ŋwaj	ngwaj	僞偽
waj	waj	爲為
wajʔ	wajq	蔿蒍薳寪鄬䦱
ẘas	whas	歲顪
ẘaj	whaj	撝噅
ẘajʔ	whajq	毀毁毇𪑺燬烜{燬，火}檓𡢕
ʔaj	qaj	椅猗旖兮漪禕陭
ʔajʔ	qajq	倚猗{超越}剞{剞閭，氏族名}踦{倚}
ʔwaj	qwaj	蟡委{委蛇}逶蜲
ʔwajʔ	qwajq	骫委
ʔwajh	qwajh	踒
ʔwas	qwas	薉穢饖
praj	praj	羆藣
braj	braj	罷{疲，疲勞；無能}犤疲
tʰras	thras	慸
dras	dras	滯墆
nrajʔ	nrajq	旎{旖旎，多盛美好貌}狔
tsʰraj	tshraj	差敹
tsʰrajh	tshrajh	差{錯}
dzraj	dzraj	㷢𨌅
srajʔ	srajq	屣{鞋}縰纚躧{鞋}蹝{鞋}
sras	sras	殺{裁剪；衰微；等殺；糧食歉收}閷
lraj	lraj	池馳𩚉
lrajʔ	lrajq	阤
lras	lras	彘{豬}
l̥rajʔ	lhrajq	胣
l̥ras	lhras	迣{超越}
r̥aj	rhaj	螭
kraj	kraj	羈羇
kras	kras	罽蘮瀱
kʰras	khras	憩愒{憩}
gras	gras	碣
kwras	kwras	蹶{動亂；感動；蹶蹶，勤勉；蹶蹶，驚動}劌鱖𤜂嶡撅{掀起衣裳}
wras	wras	衛衞讆
ʔras	qras	餲
pˤaj	p'aj	波跛{瘸，形容詞}嶓
pˤajʔ	p'ajq	簸
pˤas	p'as	貝䰽㸬牬狽茇{苕之開白花者；茇茇，飛翔貌}沛{顛沛；疾行}
pʰˤaj	ph'aj	頗
pʰˤajh	ph'ajh	破
pʰˤas	ph'as	霈浿
bˤaj	b'aj	婆
bˤas	b'as	肺{肺肺，茂盛}
mˤaj	m'aj	磨𨟖摩劘
mˤajʔ	m'ajq	麼
mˤajh	m'ajh	磨{石磨}
tˤaj	t'aj	多
tˤajʔ	t'ajq	黟
tˤajh	t'ajh	跢
tˤas	t'as	帶
tʰˤaj	th'aj	嘽{嘽嘽，車馬聲}
dˤaj	d'aj	𧕛
nˤaj	n'aj	那{安閑；奈何}難{茂盛}㔮
nˤajʔ	n'ajq	儺{猗儺，柔美、柔順}
nˤas	n'as	奈柰
tsˤajʔ	ts'ajq	左
tsˤajh	ts'ajh	佐
tsʰˤaj	tsh'aj	磋差{淘洗}
tsʰˤajʔ	tsh'ajq	瑳䰈
tsʰˤas	tsh'as	蔡
dzˤaj	dz'aj	蒫鹺齹瘥
sˤaj	s'aj	莎娑{婆娑，舞貌}傞
lˤaj	l'aj	沱紽佗{佗佗}酡鮀詑訑駝駞地陁{陂陁，臺階}㼠{石㼠，一種深腹鼎}
lˤajʔ	l'ajq	拖拕袉
lˤas	l'as	大汏釱軑汰{水波}
l̥ˤaj	lh'aj	他它佗{他，它}
l̥ˤajʔ	lh'ajq	佗{加；施及}
l̥ˤas	lh'as	泰汰太
rˤaj	r'aj	羅蘿
rˤas	r'as	籟藾
C.rˤas	C.r'as	賴瀨糲
kˤaj	k'aj	柯歌謌
kˤajʔ	k'ajq	哿笴
kˤas	k'as	匄丐蓋葢
kʰˤajʔ	kh'ajq	可軻
kʰˤas	kh'as	礚愒{貪圖；荒廢}㵣㪡
gˤaj	g'aj	河何荷{荷華}苛菏
gˤajʔ	g'ajq	荷{負荷}
gˤajh	g'ajh	賀
gˤas	g'as	害
ŋˤaj	ng'aj	峨俄莪蛾娥鵝睋誐
ŋˤajʔ	ng'ajq	我
ŋˤajh	ng'ajh	餓
ŋˤas	ng'as	艾鴱
ŋ̊ˤas	ngh'as	餀
hˤaj	h'aj	訶苛{訶斥}呵
kwˤaj	kw'aj	過渦濄
kwˤajh	kw'ajh	過{超過；過分；過失}
kwˤas	kw'as	膾會{總計；縫隙}檜旝廥鬠襘禬
kʰwˤaj	khw'aj	薖
gwˤajʔ	gw'ajq	禍旤
gwˤas	gw'as	繪會
ŋwˤaj	ngw'aj	吪訛譌
ŋwˤas	ngw'as	外
ẘˤaj	wh'aj	貨
ẘˤajʔ	wh'ajq	火{中古、《管子》“火”在此，或作“燬”“㷄”}邩
ẘˤas	wh'as	翽噦{噦噦，鈴聲、鳥聲；暗}
ʔˤaj	q'aj	阿妸妿
ʔˤajʔ	q'ajq	猗{猗儺，柔順、柔美}
ʔˤas	q'as	藹靄
ʔwˤas	qw'as	䵳
pˤrajʔ	p'rajq	擺
pˤras	p'ras	敗{破他}
bˤrajʔ	b'rajq	罷
bˤras	b'ras	敗{自破}
mˤraj	m'raj	麻犘䁲
mˤrajʔ	m'rajq	買
mˤrajh	m'rajh	賣
mˤras	m'ras	邁勱
tsˤraj	ts'raj	溠
tsʰˤraj	tsh'raj	差{錯；斜}艖
tsʰˤras	tsh'ras	袃
dzˤrajʔ	dz'rajq	槎
sˤraj	s'raj	沙砂鯊紗
sˤrajh	s'rajh	沙{沙啞}
r̥ˤas	rh'as	蠆𧓽囆
kˤraj	k'raj	加枷{連枷}耞珈痂嘉鴐茄
kˤrajh	k'rajh	駕枷{衣架}架{衣架}
kˤras	k'ras	犗
kʰˤrajh	kh'rajh	疴
hˤrajʔ	h'rajq	閜
kwˤraj	kw'raj	蝸緺
kwˤras	kw'ras	獪
gwˤras	gw'ras	話
ŋwˤrajʔ	ngw'rajq	瓦
ẘˤraj	wh'raj	化
ʔˤras	q'ras	喝{嘶啞}
par	par	藩轓
parh	parh	賁{卦}販
pʰar	phar	番
bar	bar	繁{繁雜}蕃燔璠繙蘩膰羳墦旛𪖇鄱{山東地名}橎
tar	tar	旃{旗；旃蒙}旜
tarʔ	tarq	燀樿
tarh	tarh	戰
tʰarʔ	tharq	闡灛僤{地名}繟嘽{舒緩}
dar	dar	蟬
darʔ	darq	單{國名}
dzar	dzar	泉
kar	kar	建鞬犍腱
karʔ	karq	蹇{語首助詞}𥍹
gar	gar	乾騝{騝騝，健壯}
garʔ	garq	鍵楗揵
garh	garh	健
ŋar	ngar	巘
ŋarʔ	ngarq	甗
ŋ̊ar	nghar	獻
har	har	憲
harʔ	harq	幰
harh	harh	瀗𧾨
ŋwar	ngwar	原{平原；再}邍
war	war	垣
ẘar	whar	宣瑄𧡢
ʔarʔ	qarq	戟
pˤar	p'ar	番{番番，勇武}碆播
pˤarh	p'arh	播{分散；配樂以流傳；施行}
pʰˤar	ph'ar	潘番{番禺}
pʰˤarh	ph'arh	判{判渙，分散}
bˤar	b'ar	蟠皤磻鄱{鄱陽}䐆繁{馬纓}䋣
mˤarh	m'arh	縵{縵縵，頹喪、絕望貌}
tˤar	t'ar	單簞匰襌鄲{沛郡地名，在河南鹿邑}
tˤarʔ	t'arq	僤{盛大；疾速}癉{厚；疸}𤺺疸
tʰˤar	th'ar	嘽{嘽嘽，盛大}
dˤar	d'ar	彈鼉𪓽鼍驒鱓
dˤarh	d'arh	憚譂{憚}顫彈{彈弓}
nˤar	n'ar	那{多}難{困難；敬慎}
nˤarʔ	n'arq	儺
nˤarh	n'arh	難
n̥ˤar	nh'ar	灘歎嘆漢
kˤar	k'ar	乾{燥；竭}漧竿幹榦斡
kˤarʔ	k'arq	秆簳稈皯
kʰˤar	kh'ar	看
gˤar	g'ar	翰韓
gˤarʔ	g'arq	旱悍駻
gˤarh	g'arh	鶾雗螒
ŋ̊ˤar	ngh'ar	獻{濾酒方法；周代雕飾的禮器}
gwˤar	gw'ar	豲
wˤar	w'ar	洹
ẘˤar	wh'ar	歡懽{歡}
ẘˤarh	wh'arh	渙{判渙，分散}
panʔ	panq	反返仮{反}阪坂䡊
pat	pat	發撥
pʰan	phan	翻拚{翻}犿幡
pʰanh	phanh	嬎嬔㛯婏汳
ban	ban	樊蠜礬薠袢蹯𨆌𨟄䫶
bat	bat	罰藅伐瞂㕹墢
man	man	蔓鬗
manʔ	manq	晚娩{柔順、美好}輓挽
manh	manh	萬万䡬𨞼
tan	tan	旃{之，焉}饘𥼷鸇氈
tanʔ	tanq	皽嫸
tanh	tanh	顫{頭不正；顫抖}觶
stan	stan	羶顫{鼻通能辨氣味}
tʰanʔ	thanq	幝
dan	dan	澶{澶淵}嬋𤮜
danʔ	danq	墠蟺善壇{廳堂；清除土地}
danh	danh	擅膳繕㪨鱔䱇禪嬗
nan	nan	然燃
nanʔ	nanq	蹨熯{恭敬}
nat	nat	熱
tsanʔ	tsanq	錢{農具}帴
tsanh	tsanh	籛濺
tsʰan	tshan	遷𨝍
dzan	dzan	錢{錢幣}
dzanʔ	dzanq	踐{陳列整齊；良好}賤{價格低；品質低}餞諓
dzanh	dzanh	賤{地位低；輕視；廢}
san	san	僊仙鮮{水產；新鮮；鮮明}秈
sanʔ	sanq	鮮{少}尟癬廯
sanh	sanh	綫線
lan	lan	延蜒筵郔綖衍{沼澤}
lanʔ	lanq	𧊔
l̥an	lhan	埏扇{扇風}煽傓脠
l̥anh	lhanh	扇{門扇；羽扇}
slat	slat	紲渫緤齥
slan	slan	涎
slanh	slanh	羨
mlan	mlan	鋋
mlat	mlat	舌揲{清點；積；取}
ran	ran	連漣㦁㶌灡
ranʔ	ranq	輦鄻
rat	rat	列{分裂}烈裂茢冽洌鮤鴷蛚
C.ranʔ	C.ranq	璉
kan	kan	飦𩜾餰
kanʔ	kanq	蹇搴攓寋
kat	kat	揭{舉；揭露}羯桀{盛而高}偈{勇武；用力}傑{用力}䅥
kʰat	khat	藒朅偈{疾馳}
gan	gan	赶
ganʔ	ganq	件
gat	gat	揭{揭揭，長}竭{承載}
ŋan	ngan	言
ŋat	ngat	孽{孽孽，華麗}钀
ŋ̊at	nghat	薛
han	han	軒掀鶱嘕
hat	hat	歇
kwat	kwat	厥撅蹶蹷蟨
kʰwanʔ	khwanq	虇
kʰwanh	khwanh	勸
kʰwat	khwat	闕
gwat	gwat	橛闕{侵損}
ŋwan	ngwan	羱
ŋwat	ngwat	月抈
wan	wan	援媛猨袁轅園榬猿爰蝯
wanʔ	wanq	遠
wanh	wanh	援{助}瑗楥遠{動詞，遠離，避開；不接近；違背}褑
wat	wat	曰越鉞熭䋐
ẘan	whan	讙{喧嘩}喧諠萲暖煖萱
ẘanʔ	whanq	咺烜{顯赫}䁔諼
ẘanh	whanh	縓
ẘat	what	狘
ʔan	qan	焉蔫䗡漹
ʔanʔ	qanq	偃鰋鶠蝘鄢郾堰
ʔanh	qanh	嫣匽{廁所}
ʔat	qat	謁暍
ʔwan	qwan	蜿鵷
ʔwanʔ	qwanq	琬畹晼妴惌
ʔwat	qwat	噦{打嗝}
mranʔ	mranq	勉免俛葂冕娩{生子}
mrat	mrat	幭
tran	tran	邅鱣
tranʔ	tranq	展襢紾
dran	dran	廛纏瀍躔鄽
dranʔ	dranq	紾
nranʔ	nranq	蹍跈
tsranʔ	tsranq	醆琖
tsʰranʔ	tshranq	剗鏟羼
dzran	dzran	孱潺
dzranʔ	dzranq	䗃盞僝
sran	sran	山邖
srat	srat	殺煞{殺}榝鎩蔱
l̥ran	lhran	梴㢟
l̥rat	lhrat	屮
kranʔ	kranq	謇藆
krat	krat	訐
kʰran	khran	騫褰攐愆𢢈諐
gran	gran	虔榩騝𨜻
grat	grat	桀竭{盡}傑楬榤
ŋranh	ngranh	彥諺唁
ŋrat	ngrat	孽㜸糵蠥讞
ŋ̊ranʔ	nghranq	產滻
gwran	gwran	權蠸顴䑏
wran	wran	圓圜湲
ʔran	qran	閼{閼逢}
pˤanh	p'anh	半靽絆㪵
pˤat	p'at	襏
pʰˤanh	ph'anh	泮畔判頖牉胖拌{判}
pʰˤat	ph'at	鏺
bˤan	b'an	般{般遊；大}槃瘢蹣{蹣跚}𪄀盤鞶縏媻幋磐
bˤanʔ	b'anq	拌
bˤanh	b'anh	伴叛
bˤat	b'at	茇{草舍；根；植物名}軷魃癹
mˤan	m'an	曼漫{長；瞞；周遍，浸沒；漫漫，眾多}謾墁槾鏝瞞鞔蹣{越過}
mˤanh	m'anh	縵幔悗浼{玷污}漫{汙；爛漫，散亂；澶漫，放縱}鄤
mˤat	m'at	末沫秣妺粖𥽘
tˤan	t'an	丹鄲{邯鄲}殫勯
tˤanʔ	t'anq	癉亶觛
tˤanh	t'anh	旦鴠
tˤat	t'at	怛妲
tʰˤanʔ	th'anq	坦
dˤan	d'an	檀壇{高臺；地基}儃
dˤanʔ	d'anq	但袒潬䵣
dˤanh	d'anh	澶{澶漫，放縱}
n̥ˤanʔ	nh'anq	熯{乾枯}暵
tsˤanh	ts'anh	贊賛𧄽灒
tsʰˤan	tsh'an	餐湌
tsʰˤanh	tsh'anh	粲
dzˤan	dz'an	戔{戔戔，堆積貌}殘㥇
dzˤanʔ	dz'anq	瓚
dzˤanh	dz'anh	囋
sˤan	s'an	珊跚姍𧽾
sˤanʔ	s'anq	散{零散；粗陋、平凡；器名}傘
sˤanh	s'anh	散{分散；亡失；釋放}
sˤat	s'at	𥻦㝮殺{散落；守城據點}蔡{減少；流放}䌨
lˤan	l'an	聅
lˤanʔ	l'anq	誕
lˤat	l'at	達
l̥ˤat	lh'at	達{放恣歡躍}闥撻
rˤan	r'an	瀾籣
rˤanʔ	r'anq	嬾糷讕
rˤat	r'at	剌瘌
C.rˤan	C.r'an	闌欄蘭
C.rˤanh	C.r'anh	爛
kˤan	k'an	干𢫕{干}奸肝玕邗忓
kˤat	k'at	割葛𨞛擖
kʰˤan	kh'an	刊
kʰˤanʔ	kh'anq	侃衍
kʰˤanh	kh'anh	衎衍{豐饒；遊衍，歡樂}
kʰˤat	kh'at	渴
gˤan	g'an	寒虷
gˤanh	g'anh	汗釬旰豻捍扞閈㪋矸
gˤat	g'at	曷害{曷}褐鶡鳱毼𦼵蝎餲{寒具}
ŋˤanh	ng'anh	岸喭犴
ŋˤat	ng'at	蘖櫱枿
hˤanʔ	h'anq	罕䍐
hˤat	h'at	猲
kwˤan	kw'an	觀官
kwˤanʔ	kw'anq	管{管管，無所憑依}痯{痯痯，疲勞}錧
kwˤanh	kw'anh	罐瓘鸛爟觀{示意；玩賞；樓臺}
kwˤat	kw'at	括适聒栝鴰髺萿
kʰwˤan	khw'an	寬
kʰwˤat	khw'at	闊{疏遠；寬闊}
gwˤanh	gw'anh	逭
gwˤat	gw'at	活佸秳秮䄆
wˤan	w'an	丸{丸丸，高大挺直}桓貆峘荁垸獂{地名}
wˤanʔ	w'anq	緩
wˤanh	w'anh	換援𤴯
wˤat	w'at	越{孔洞；越席}
ẘˤan	wh'an	讙{傳說獸名；魯地名}酄驩獾貛𠂄鴅𩿊渙
ẘˤanh	wh'anh	奐𥈉㬇煥嚾
ẘˤat	wh'at	濊
ʔˤan	q'an	安鞍
ʔˤanh	q'anh	按案
ʔˤat	q'at	遏閼{遏制；單閼}頞洝堨齃
ʔwˤan	qw'an	眢
ʔwˤanʔ	qw'anq	碗盌椀
ʔwˤanh	qw'anh	腕捥𢯲
ʔwˤat	qw'at	捾
pˤran	p'ran	般{般師}螌班斑頒肦{頒}
pˤranʔ	p'ranq	板版鈑
pʰˤran	ph'ran	攀扳眅
bˤranʔ	b'ranq	昄反{反反，慎重、和善}
mˤran	m'ran	獌
mˤranʔ	m'ranq	慢{緩}
mˤranh	m'ranh	嫚慢{怠慢；閒散}僈
tˤrat	t'rat	哳
nˤranʔ	n'ranq	赧戁
dzˤranʔ	dz'ranq	棧{棚，閣，道}
dzˤranh	dz'ranh	棧{車}轏
sˤran	s'ran	删刪訕潸疝狦
sˤranh	s'ranh	汕
r̥ˤat	rh'at	獺
kˤran	k'ran	姦菅葌蕑{蘭，一說菅}
kˤranʔ	k'ranq	諫
kˤranh	k'ranh	澗
kʰˤran	kh'ran	鬜
gˤran	g'ran	閑{柵欄；保衛；大；嫻熟}睅
gˤranʔ	g'ranq	僩僴撊憪
gˤranh	g'ranh	骭
gˤrat	g'rat	舝轄鎋
ŋˤran	ng'ran	顏㘖
ŋˤranh	ng'ranh	鴈雁
ŋˤrat	ng'rat	齾
ŋ̊ˤranh	ngh'ranh	炭
kwˤranh	kw'ranh	串{習慣；串夷，即混夷}貫{學習；熟練}慣矔
kwˤrat	kw'rat	刮
gwˤranh	gw'ranh	宦
gwˤrat	gw'rat	姡
wˤran	w'ran	鍰垸{鍰}
ʔˤranh	q'ranh	晏鴳鷃騴
ʔwˤranʔ	qw'ranq	綰
pamʔ	pamq	覂泛{傾覆}
pap	pap	法峜{法}𢚏{法}
pʰam	pham	䒦{水草}
pʰamh	phamh	氾汎泛{汎}
bam	bam	凡帆
bamʔ	bamq	犯范範
bap	bap	乏
mamʔ	mamq	𡕢
tam	tam	詹瞻譫
tap	tap	欇{楓}攝{折疊；攝龜}聶{合攏；肉片}
tʰam	tham	襜幨裧譫{禦矢器}
dam	dam	蟾{蟾蜍}
damh	damh	贍掞{贍}擔{假借}
dap	dap	涉欇{紫藤}
nam	nam	髯呥袡柟{梅}
namʔ	namq	冉染苒媣
nap	nap	讘
n̥am	nham	㾆
tsam	tsam	漸虃熸瀸殲鑯
tsap	tsap	接睫椄菨
tsʰam	tsham	孅
tsʰamh	tshamh	塹
tsʰap	tshap	妾
dzamʔ	dzamq	漸{逐漸、漸進、加重；條件、前提；卦名}蔪
dzap	dzap	捷
sam	sam	纖
lam	lam	炎壛閻鹽
lamʔ	lamq	剡琰棪𤟇掩{埋}
lamh	lamh	豔艷焱燄淡{淡淡，水流平滿貌；澹淡，水波動蕩貌}鹽{用鹽醃物}
lap	lap	葉鍱揲{箕舌}
l̥amʔ	lhamq	陝𡟨覢欻
l̥amh	lhamh	煔掞
l̥ap	lhap	葉{地名}韘
slam	slam	爓燅
ram	ram	籢
ramʔ	ramq	蘞羷
ramh	ramh	獫
rap	rap	獵鬣躐犣擸
C.ramʔ	C.ramq	斂
C.ramh	C.ramh	斂{征收；賦稅；入殮}殮
kam	kam	僉
kamʔ	kamq	檢
kamh	kamh	劍劒
kap	kap	劫袷跲衱
kʰam	kham	嶔{嶔巖，外傾的山岩}
kʰamh	khamh	欠
kʰap	khap	怯胠
gam	gam	鉗鈐箝拑黚
gamʔ	gamq	儉芡
gap	gap	拾
ŋam	ngam	嚴巖{嶔巖，外傾的山岩}
ŋamʔ	ngamq	隒儼{恭敬，莊嚴}顩
ŋamh	ngamh	驗
ŋap	ngap	業鄴
ŋ̊amʔ	nghamq	玁獫{獫狁}
hamʔ	hamq	險嶮憸
hap	hap	脅嗋魼
wam	wam	熊{熊熊，火光盛}
wap	wap	曄燁㷸爗饁
ʔam	qam	淹崦醃
ʔamʔ	qamq	奄黭{突然}掩{掩匿}弇渰揜閹
ʔap	qap	浥𩋊腌裛
pramh	pramh	窆
nrap	nrap	聶躡喦
tsramʔ	tsramq	斬
tsʰrap	tshrap	臿插鍤疀㛼
dzram	dzram	毚讒儳巉纔{方才，剛剛}酁
srap	srap	箑𥵳歃泏{歃}
l̥ramʔ	lhramq	諂
tˤam	t'am	擔儋甔
tˤamʔ	t'amq	紞膽𪆻薝黵
tˤamh	t'amh	擔{所擔}簷{所擔；量詞，猶“石”}
dˤamʔ	d'amq	憺
dˤamh	d'amh	澹詹{滿足}
nˤam	n'am	聃{國名}
n̥ˤam	nh'am	聃
dzˤam	dz'am	慚慙
dzˤamʔ	dz'amq	槧
dzˤamh	dz'amh	暫蹔
lˤam	l'am	談惔㶣餤倓郯錟炎{炎炎，言論美盛貌}
lˤamʔ	l'amq	噉啖啗
lˤamh	l'amh	淡
lˤap	l'ap	闒蹋
l̥ˤamʔ	lh'amq	緂菼
l̥ˤap	lh'ap	鰈
rˤam	r'am	灆濫{地名}礛
rˤamʔ	r'amq	覽擥攬濫{浸漬水果}
rˤamh	r'amh	濫{泛濫}嚂㜮懢
rˤap	r'ap	臘
C.rˤam	C.r'am	藍
kˤam	k'am	甘泔
kˤamʔ	k'amq	敢
kˤap	k'ap	蓋
kʰˤamh	kh'amh	瞰闞
kʰˤap	kh'ap	榼
gˤam	g'am	邯酣甝
gˤamh	g'amh	矙譀{誇誕}
gˤap	g'ap	盍闔嗑
ŋˤamh	ng'amh	儑
hˤam	h'am	歛憨
ʔˤap	q'ap	𤸱
dzˤram	dz'ram	鑱漸{漸漸，山石高峻貌}欃
dzˤramh	dz'ramh	儳{摻入，插話；輕賤、不莊重}
sˤram	s'ram	芟{除草}纔{淺青，微黑}縿
sˤramʔ	s'ramq	摲
sˤramh	s'ramh	芟{鐮刀}
sˤrap	s'rap	翣翜唼
kˤram	k'ram	監
kˤramh	k'ramh	鑒鑑監{主管監察的官員}
kˤrap	k'rap	甲
kʰˤram	kh'ram	嵌嵁
gˤram	g'ram	銜嗛{銜}
gˤramʔ	g'ramq	檻壏㯺濫{泉水湧出；水名}
gˤrap	g'rap	狎柙匣押{柙}
ŋˤram	ng'ram	巖嵒
hˤrap	h'rap	嗑{笑聲}
ʔˤramʔ	q'ramq	黤
paw	paw	麃{耕耘；麃麃，勇武貌}鑣儦穮
pawʔ	pawq	表
pʰaw	phaw	鄜
maw	maw	苗
mawh	mawh	廟庿
taw	taw	昭鉊釗招
tawh	tawh	照𨹸炤詔
tʰaw	thaw	弨
tʰawk	thawk	綽婥
daw	daw	軺韶柖昭{宗廟制度，在始祖廟之左者，昭穆}
dawʔ	dawq	袑紹{夭紹，輕盈多姿貌}
dawh	dawh	邵劭卲召{國}
dawk	dawk	芍{芍藥}
tsawʔ	tsawq	剿勦劋鄛
tsʰawh	tshawh	峭
saw	saw	消銷綃硝逍縿{縑帛}
sawh	sawh	肖
law	law	䔄遙瑤謠謡鰩榣愮媱鷂{青質五彩的野雞}𡺯姚
lawh	lawh	筄曜耀燿鷂{鷹}
lawk	lawk	藥濼櫟{櫟陽}爚
l̥awk	lhawk	爍鑠
l̥aw	lhaw	笑{嘲笑}
l̥awh	lhawh	笑
raw	raw	燎
rawh	rawh	燎{美好}
kaw	kaw	驕鷮憍簥蕎橋{汲水用具}
kawʔ	kawq	矯敿撟蟜譑蹻{蹻蹻，強盛}
kawk	kawk	蹻屩鞽{屩}繑{屩}
kʰaw	khaw	趫橇
gaw	gaw	喬橋僑䱁毊嶠鐈轎
gawk	gawk	蹻{蹻蹻，驕慢；壯武}
ŋawk	ngawk	虐瘧
ŋ̊aw	nghaw	囂䖀虈
ŋ̊awk	nghawk	謔
haw	haw	枵呺歊藃獢
waw	waw	鴞
ʔaw	qaw	夭{草木茂盛貌；和舒貌}𡝩妖祅訞
ʔawʔ	qawq	殀夭{夭折；災禍；夭紹，輕盈多姿貌}
brawʔ	brawq	藨
traw	traw	朝{朝日；初始；日、天}
tʰraw	thraw	怊超
tʰrawk	thrawk	踔
draw	draw	朝潮
drawh	drawh	召朝{朝堂；官署、崗位}
tsraw	tsraw	罺
dzraw	dzraw	巢轈
lrawʔ	lrawq	兆旐狣肇
pˤawk	p'awk	襮
bˤawh	b'awh	暴虣
bˤawk	b'awk	暴{曬、暴露}曝
mˤaw	m'aw	毛旄氂髦{動物頭頸上的長毛；選拔}
mˤawh	m'awh	耄眊芼旄{獸毛厚而長}
m̥ˤawh	mh'awh	秏耗
tˤaw	t'aw	刀忉舠
tˤawh	t'awh	到倒
tʰˤaw	th'aw	叨{叨懫，暴戾}饕
dˤawk	d'awk	悼
tsˤawʔ	ts'awq	澡璪藻薻䲃繅
tsˤawh	ts'awh	躁趮
tsˤawk	ts'awk	糳鑿
tsʰˤaw	tsh'aw	操
tsʰˤawʔ	tsh'awq	懆
tsʰˤawh	tsh'awh	鄵操{操守；志節}
dzˤawk	dz'awk	鑿
sˤaw	s'aw	臊鱢繅{繅絲}繰
sˤawʔ	s'awq	燥
sˤawh	s'awh	噪譟
lˤaw	l'aw	桃逃洮{盥手；魯地名}駣咷鼗鞉
lˤawʔ	l'awq	洮{水名}
lˤawh	l'awh	盜䌦
l̥ˤaw	lh'aw	挑{挑達，放恣歡躍}洮{晉水名、曹地名}𠬢
rˤaw	r'aw	勞蟧澇{水名}
rˤawʔ	r'awq	潦澇{潦}橑䕩轑簝
rˤawh	r'awh	樂{喜愛}
rˤawk	r'awk	樂{歡}犖𪇱濼{草名，貫衆}擽
kˤaw	k'aw	高膏{滋潤；甘美}鶮{地名}
kˤawʔ	k'awq	槀稾稿藁杲
kˤawh	k'awh	高{尊崇；高度}膏{脂肪}縞
kʰˤawʔ	kh'awq	槁薧
kʰˤawh	kh'awh	犒
gˤaw	g'aw	號{叫；稱號；記號}𨚙豪壕濠譹皜
gˤawʔ	g'awq	鎬滈薃鰝𧇼搉{揚搉，約略，舉其大要}
gˤawh	g'awh	號{號令}号
gˤawk	g'awk	鶴
ŋˤaw	ng'aw	敖嗸嗷遨蔜摮獒鷔熬鼇謷螯滶驁{駿馬；驁夏}隞
ŋˤawh	ng'awh	敖{戲謔}傲驁{馬怒；傲}奡鏊𢕟
ŋ̊ˤaw	ngh'aw	撓
hˤaw	h'aw	蒿毫
hˤawk	h'awk	熇謞嗃鄗{晉、趙地名；齊地名}臛
ʔˤawʔ	q'awq	芺䴠镺夭{動植物之初生者}
ʔˤawk	q'awk	沃鋈
pˤrawk	p'rawk	駁駮嚗𦢊𪈚
bˤraw	b'raw	麃
bˤrawk	b'rawk	懪犦𤜌謈
mˤraw	m'raw	貓
mˤrawk	m'rawk	藐{茈草；藐藐，冷漠；盛美}
tˤrawh	t'rawh	罩鵫箌菿
tˤrawk	t'rawk	卓倬逴
tʰˤrawk	th'rawk	卓{卓鷙，謂行爲乖戾獨特}
dˤrawk	d'rawk	淖
sˤraw	s'raw	梢{水流衝擊}旓蛸{蠨蛸，即蟢子}
lˤrawk	l'rawk	濯{濯濯，光明、清朗、肥澤、光禿}
kˤraw	k'raw	郊茭鮫蛟教{使；令；讓}
kˤrawʔ	k'rawq	狡姣{姣好}佼烄
kˤrawh	k'rawh	教{教育；教化；告訴}較{較量；概略}
kˤrawk	k'rawk	較
kʰˤraw	kh'raw	敲鄗{山名}
kʰˤrawk	kh'rawk	確傐{確}搉{敲擊；壓榨}
gˤraw	g'raw	肴殽崤餚爻洨恔淆
gˤrawʔ	g'rawq	茭{草根}
gˤrawh	g'rawh	傚效{傚，模仿}校{學校}
gˤrawk	g'rawk	翯
ŋˤraw	ng'raw	磝
ŋˤrawk	ng'rawk	樂{音樂}䮤
hˤraw	h'raw	嚆鵁{水鳥}
pe	pe	卑萆{萆薢}裨{益；補}
peʔ	peq	俾{使；從；俾倪，城上短牆}髀
peh	peh	臂
pes	pes	蔽
pʰe	phe	䇑
pʰeʔ	pheq	諀吡
pʰeh	pheh	譬
be	be	埤脾裨{禮服}蜱陴郫庳{雌鵪鶉}
beʔ	beq	庳婢
beh	beh	避
bes	bes	敝幣弊斃獘獙
me	me	彌鸍
meʔ	meq	弭葞渳瀰芈羋敉
mes	mes	袂
te	te	禔祇{大；適，恰；但，只}
teʔ	teq	紙{質量較次的絲織物}扺
tes	tes	制製
steh	steh	翨啻
tʰes	thes	痸
de	de	提軝軧
deʔ	deq	是氏諟
des	des	誓
ne	ne	唲{嚅唲}
neʔ	neq	爾邇尒
n̥e	nhe	䌳
n̥eʔ	nheq	璽
tse	tse	訾貲髭觜䖪𨚖㰣
tseʔ	tseq	紫茈訿呰訾{詆毀}
tseh	tseh	積{積聚的物件}訾{厭恨}
tses	tses	祭{祀}
tsʰe	tshe	雌姕{姕妓，婦女貌；一說婦女不美}
tsʰeʔ	tsheq	此泚跐𧺼
tsʰeh	tsheh	刺{諷刺；揭發；採取；殺；芒刺}𪑟庛
dze	dze	疵飺骴
dzeh	dzeh	眥漬胔柴{積聚}
se	se	斯廝厮蟴蟖蜤析{草名，形似燕麥；脾析，牛胃}
seʔ	seq	佌𠈈
seh	seh	澌{浮冰}
le	le	易{和悅}螔匜
leh	leh	易{容易、輕易；蔓延}
les	les	曳勩枻栧𢘽𤵺
sle	sle	虒禠鼶榹㾷㴲
sleh	sleh	賜錫{賜}澌{盡}
mles	mles	忕
re	re	驪酈
res	res	栵
C.re	C.re	劙
ke	ke	支枝肢只榰胑卮巵梔疻
keʔ	keq	咫軹𣲵枳䳅鳷
keh	keh	忮翅觗
kes	kes	瘈觢
kʰeʔ	kheq	企跂
kʰeh	kheh	蚑
kʰes	khes	掣摯{搏擊，攫取}
ge	ge	歧疧蚔伎岐{岐嶷}跂{歧；多出的腳趾}
geh	geh	豉敊
ŋe	nge	兒
ŋes	nges	埶蓺藝秇槸峚
ŋ̊es	nghes	勢
kwe	kwe	規鬹
kweh	kweh	瞡
kʰwe	khwe	闚窺
kʰweʔ	khweq	頍跬蹞嫢
weʔ	weq	𤼒
ẘes	whes	繐
ẘe	whe	觿鑴
ẘeh	wheh	孈
wes	wes	彗篲鏏
ʔeh	qeh	縊
ʔweh	qweh	恚㜇
pre	pre	碑
tre	tre	知蜘䵹
treh	treh	智𢜔{智}
dre	dre	踟
tsreh	tsreh	𧙁
tsres	tsres	瘵祭{祭伯}
lre	lre	篪褫
lreʔ	lreq	䚦
lres	lres	彘{地名}
sre	sre	釃
sreʔ	sreq	灑矖
kre	kre	妓{姕妓，婦女貌；一說婦女不美}
kreʔ	kreq	庋{置放}
kres	kres	猘
kʰre	khre	崎{崎嶇}陭{崎嶇}㩻{崎嶇}欹{傾斜}
kʰres	khres	甈
gre	gre	岐{山}鬾{小兒病}
greʔ	greq	技
greh	greh	芰鬾{壽衣}
ŋres	ngres	劓㓷
kwreʔ	kwreq	庪{埋藏}
wres	wres	軎轊槥
ʔres	qres	瘞
pʰˤe	ph'e	錍
pʰˤeʔ	ph'eq	䫌
pʰˤeh	ph'eh	㵺
bˤe	b'e	鼙椑{橢圓}㼰鞞
bˤeh	b'eh	嬖薜萆{萆荔；萆挈}
mˤe	m'e	麛
mˤeʔ	m'eq	蔝
tˤe	t'e	鞮堤隄
tˤeh	t'eh	帝諦
tˤes	t'es	蔕蒂疐{蔕}蝃{蝃蝀，彩虹}螮{螮蝀，彩虹}
tʰˤeʔ	th'eq	緹醍
tʰˤeh	th'eh	裼揥
dˤe	d'e	提題騠鯷媞偍折{折折，安舒}䱱蝭𥶛
dˤeʔ	d'eq	忯
dˤeh	d'eh	提{提提，安舒}締禘
dˤes	d'es	遰{去往}
nˤe	n'e	臡
nˤeʔ	n'eq	檷薾濔{濔濔，多}
tsʰˤeʔ	tsh'eq	泚玼
tsʰˤes	tsh'es	蔡{草}
dzˤeʔ	dz'eq	鮆
sˤe	s'e	撕𢪬嘶𤺊
sˤeʔ	s'eq	𧬊鮮{美善，𧬊}
sˤeh	s'eh	細𣳦些{語辭}
lˤe	l'e	蹏蹄嗁啼
lˤeʔ	l'eq	遞
lˤeh	l'eh	地{《韓非子》、秦文}墬髢踶
lˤes	l'es	杕䲦
l̥ˤe	lh'e	鷉
l̥ˤeh	lh'eh	剔{剃去毛髮}
rˤeʔ	r'eq	蠡欐
rˤeh	r'eh	麗攦儷丽荔䬅㿛攭
C.rˤes	C.r'es	隸
kˤe	k'e	鷄雞笄筓枅蚈稽{卜問}
kˤeh	k'eh	繼㡭{繼}檵繫{連綴；拘禁}蘻轚檕係
kˤes	k'es	薊葪
kʰˤe	kh'e	谿溪鸂䀘
kʰˤeʔ	kh'eq	启啟啓開䡔䏿綮棨晵
kʰˤeh	kh'eh	罊蟿
kʰˤes	kh'es	契
gˤe	g'e	奚蒵鼷貕螇榽蹊傒騱豯
gˤeʔ	g'eq	徯謑
gˤeh	g'eh	繫{懸掛、繫辭、世系}系
gˤes	g'es	妎瘛
ŋˤe	ng'e	倪婗蜺{寒蟬}鯢郳麑猊齯輗
ŋˤeʔ	ng'eq	掜堄䘽
ŋˤeh	ng'eh	睨盻羿
hˤe	h'e	醯橀
kwˤe	kw'e	圭珪閨邽袿𦓯鮭
kwˤeh	kw'eh	桂筀
kʰwˤe	khw'e	茥奎刲觟{觟陽，複姓}䖯{蝎子一類毒蟲}
gwˤe	gw'e	畦
wˤe	w'e	巂攜觿{觜觿}嶲{觜嶲}蠵酅驨
wˤes	w'es	慧
ʔˤe	q'e	嫛
ʔˤes	q'es	翳瘱𠣗㝣
ʔwˤe	qw'e	烓
pˤreʔ	p'req	捭
pʰˤreh	ph'reh	𥿯派
bˤre	b're	螷
bˤreʔ	b'req	猈
bˤreh	b'reh	粺稗
nˤre	n're	誽
tsˤreh	ts'reh	債責{債}
tsʰˤres	tsh'res	察{察看；考察；體察}
dzˤre	dz're	柴㧘祡
dzˤreh	dz'reh	柴{編木維護；覆蓋、阻隔}眦{睚眦}
lˤreʔ	l'req	豸
kˤre	k're	佳街
kˤreʔ	k'req	解{分解；離散；脫落}薢
kˤreh	k'reh	懈繲解{消解、免除；禳除；停止}
kˤres	k'res	介个价玠芥魀恝疥界蚧
kʰˤreh	kh'reh	喫{喫詬，傳說中的大力士}
gˤre	g're	膎
gˤreʔ	g'req	解{理解、通徹；卦；地名}蟹嶰獬
gˤreh	g'reh	邂解{物體連接處；縫隙}
gˤres	g'res	齘
ŋˤre	ng're	厓崖涯嘊
ŋˤreh	ng'reh	睚觟
kwˤreh	kw'reh	卦掛詿
kwˤres	kw'res	夬{卦；堅決}
kʰwˤreh	khw'reh	絓
kʰwˤres	khw'res	快
gwˤre	gw're	鮭{鮭蠪，神鬼名}
wˤre	w're	哇{哽塞}
wˤreʔ	w'req	纗
wˤreh	w'reh	畫{繪畫}
ʔˤre	q're	哇{嘔吐}娃唲{唲嘔}
ʔˤreh	q'reh	阸阨{扼制；險要}
ʔwˤre	qw're	洼窐漥蛙鼃
peŋ	peng	并{合併；州}𥩵{并}
peŋʔ	pengq	屏{隱藏、退避}鉼餅綆{輪輻近軸處的突出部分}庰
peŋh	pengh	并{兼併}屏{放逐、摒棄}摒偋{摒}
pek	pek	辟{君主；消除}璧躄綼躃
pʰeŋh	phengh	聘娉
pʰek	phek	僻澼{腸澼，痢疾}
bek	bek	辟{法治；便辟，諂媚}闢擗
meŋ	meng	名
meŋh	mengh	名{命名}
teŋ	teng	正{謂詞}征鉦
teŋʔ	tengq	整
teŋh	tengh	正{動詞，匡正、制止；自正}政証
tek	tek	隻
stek	stek	適
deŋ	deng	成城誠郕盛{盛大；華美；極、甚}
deŋh	dengh	盛{眾多；稱讚}晟
tseŋ	tseng	精菁旌鶄箐蜻婧
tseŋʔ	tsengq	井𨙷
tsek	tsek	脊跡迹積蹟鰿𧐐䳭鯽
tsʰeŋ	tsheng	清瀞
tsʰeŋʔ	tshengq	請
tsʰeŋh	tshengh	凊請{請求，要求，名詞}倩{請；借取}
tsʰek	tshek	刺{尖銳物刺入或穿過物體}𧻕
dzeŋ	dzeng	情晴請{詢問}靜
dzeŋʔ	dzengq	靖竫妌阱穽
dzeŋh	dzengh	靜{沉著冷靜；穩重，美善}靚淨
dzek	dzek	塉瘠膌
seŋʔ	sengq	省
seŋh	sengh	姓性胜{胜遇，鳥名}
leŋ	leng	盈楹桯贏嬴籯瀛溋浧{盈}
leŋʔ	lengq	郢
lek	lek	易{交易、《周易》}埸蜴
l̥eŋ	lheng	聲
l̥eŋh	lhengh	聖
reŋʔ	rengq	領
C.reŋ	C.reng	令{春秋晚期以後，使令}
C.reŋh	C.rengh	令{春秋晚期以後，法令、月令；美善}
keŋʔ	kengq	頸
keŋh	kengh	勁
kʰeŋ	kheng	輕
kʰeŋh	khengh	鑋輕{輕率；輕易}
geŋ	geng	葝
geŋʔ	gengq	痙
kʰweŋ	khweng	傾
kʰweŋʔ	khwengq	頃㩩
gweŋ	gweng	睘{睘睘，孤獨}煢焭瓊藑嬛{嬛嬛，孤獨}𨍶
weŋ	weng	塋營巆謍
weŋʔ	wengq	潁穎
wek	wek	役疫垼
ẘeŋ	wheng	觪騂{赤紅}觲
ẘeŋh	whengh	敻{搜尋；推究；尋訪}讂詗{偵查}
ʔeŋ	qeng	嬰纓蘡攖𤣎
ʔeŋʔ	qengq	癭𩖍𨟙
ʔek	qek	益膉嗌齸𪕶
ʔweŋ	qweng	縈褮儇{以巾覆蓋}
breŋ	breng	平苹評泙
mreŋ	mreng	鳴命{春秋晚期以後，王命；天命}
mreŋh	mrengh	命{春秋晚期以後；生命；命運}
treŋ	treng	貞楨禎湞
tʰreŋ	threng	虰
tʰreŋh	threngh	偵𠏄{偵}
dreŋh	drengh	鄭㽀
drek	drek	擲擿躑䵂
sreŋ	sreng	生牲笙鼪甥狌猩
sreŋʔ	srengq	省{減}眚渻胜{省}
lreŋ	lreng	酲程裎挰
l̥reŋ	lhreng	逞珵檉
l̥reŋʔ	lhrengq	騁
r̥eŋ	rheng	䞓赬竀
kreŋ	kreng	驚荆荊蟼
kreŋʔ	krengq	警䜘儆憼
kreŋh	krengh	敬
kʰrek	khrek	𨒅{𨒅曲：曲折，屈曲}
greŋ	greng	檠擏{檠}擎
grek	grek	屐
wreŋ	wreng	榮瑩蠑
wreŋh	wrengh	禜
pˤeŋʔ	p'engq	鞞
pˤek	p'ek	壁
pʰˤeŋ	ph'eng	甹{甹蜂，牽挽、扶持}荓頩{面色光潤}
pʰˤeŋʔ	ph'engq	頩{憤怒變色貌}
pʰˤek	ph'ek	霹澼
bˤeŋ	b'eng	屏{障}瓶缾荓蓱萍郱蛢洴鵧𤳊䶄
bˤeŋʔ	b'engq	併{並列；聚集、合併}并{並列；兼有；普遍，一同}軿
bˤek	b'ek	辟{內棺}甓椑{內棺}
mˤeŋ	m'eng	銘冥瞑螟覭鄍
mˤeŋʔ	m'engq	溟{涬溟}
mˤeŋh	m'engh	暝
mˤek	m'ek	幦覓幭霢{霢霂，小雨}霡{霡霂，小雨}蓂冪鼏幎塓汨
tˤeŋ	t'eng	丁釘
tˤeŋʔ	t'engq	鼎薡頂葶{葶䔭}靪
tˤeŋh	t'engh	顁定{星名，即營室；額頭}
tˤek	t'ek	滴適{滿足；美善；歸順；辟領}蹢嫡甋樀豴
tʰˤeŋ	th'eng	町艼汀
dˤeŋ	d'eng	亭停葶{葶藶}䇡{亭}
dˤeŋh	d'engh	定
dˤek	d'ek	敵
nˤeŋ	n'eng	寍寧濘鸋𨚶
nˤeŋʔ	n'engq	䔭
nˤeŋh	n'engh	甯
tsˤeŋ	ts'eng	菁{菁菁}
tsˤek	ts'ek	績
tsʰˤeŋ	tsh'eng	青
sˤeŋ	s'eng	星腥
sˤeŋʔ	s'engq	醒
sˤek	s'ek	析晳皙蜥淅㭊菥
lˤeŋ	l'eng	庭{院}霆莛鼮筳娗
lˤeŋʔ	l'engq	挺梃蜓鋌鉒{鋌}
lˤeŋh	l'engh	廷{朝廷}
lˤek	l'ek	荻
l̥ˤeŋ	lh'eng	聽
l̥ˤeŋʔ	lh'engq	珽頲脡鋌{疾走貌}
l̥ˤeŋh	lh'engh	聽{審察，斷決；等候；任憑}
l̥ˤek	lh'ek	剔{分解骨肉}鬄逷踢狄惕悐逖
slˤek	sl'ek	錫裼緆
rˤeŋ	r'eng	靈蘦蛉鴒𩵀麢櫺酃𩆚𦉢軨
rˤeŋʔ	r'engq	冷
rˤek	r'ek	厤歷{歷錄，文采貌}瀝靂磿藶櫪
C.rˤek	C.r'ek	鬲䰛蒚歷曆酈
kˤeŋ	k'eng	涇經鵛弳
kˤeŋʔ	k'engq	剄
kˤeŋh	k'engh	徑俓逕經{懸吊；整理絲線使成經線}
kˤek	k'ek	擊墼
kʰˤeŋʔ	kh'engq	謦
kʰˤeŋh	kh'engh	磬罄
gˤeŋ	g'eng	形刑型邢鉶侀硎陘鈃娙䣆
gˤeŋʔ	g'engq	婞涬悻
gˤeŋh	g'engh	脛
gˤek	g'ek	奊覡
ŋˤek	ng'ek	鷊鶂鶃鷁虉
ŋ̊ˤek	ngh'ek	鬩
hˤeŋ	h'eng	蛵馨
kwˤeŋ	kw'eng	熲駫駉坰
kwˤeŋʔ	kw'engq	炯扃
kwˤek	kw'ek	鶪湨溴郹鵙狊犑鼳鼰
kʰwˤeŋʔ	khw'engq	褧絅
kʰwˤek	khw'ek	闃
gwˤeŋʔ	gw'engq	迥泂
wˤeŋ	w'eng	熒滎螢䁝
ẘˤeŋʔ	wh'engq	詗{了悟}
ẘˤek	wh'ek	砉殈
ʔwˤeŋh	qw'engh	鎣
pˤreŋ	p'reng	絣拼㔙
pˤreŋh	p'rengh	迸
pˤrek	p'rek	蘗擘繴捭{使分裂}
pʰˤreŋ	ph'reng	抨怦伻荓{使}姘
pʰˤrek	ph'rek	糪
mˤreŋʔ	m'rengq	鼆黽{黽塞}澠{澠塞}
mˤrek	m'rek	脉脈覛
tˤreŋ	t'reng	丁{丁丁，伐木聲}朾
tˤrek	t'rek	摘謫讁瓋
dˤreŋ	d'reng	楟
dˤrek	d'rek	適{譴責；天象變異}
nˤreŋ	n'reng	薴儜
tsˤreŋ	ts'reng	爭{紛爭，爭論，爭端}箏猙䋫埩{耕種}綪
tsˤreŋh	ts'rengh	諍爭{爭奪、競爭；競相}
tsˤrek	ts'rek	責簀嘖
tsʰˤrek	tsh'rek	冊柵𩒄策皟䶦幘茦莿
dzˤreŋ	dz'reng	崝{崝嶸，深}崢{崢嶸，深}淨{水名}
dzˤrek	dz'rek	賾
sˤrek	s'rek	梀
kˤreŋ	k'reng	耕𣚣
kˤreŋʔ	k'rengq	耿
kˤrek	k'rek	隔膈搹鞷
kʰˤreŋ	kh'reng	牼硜誙
gˤreŋ	g'reng	莖
gˤreŋʔ	g'rengq	幸倖
gˤrek	g'rek	翮塥
ŋˤreŋ	ng'reng	俓{急切}
gwˤrek	gw'rek	嫿
wˤreŋ	w'reng	嶸{崢嶸，深}
wˤrek	w'rek	畫{劃分；謀劃；停止}劃
ẘˤreŋ	wh'reng	轟輷
ẘˤrek	wh'rek	騞
ʔˤreŋ	q'reng	櫻嚶罌罃鶯鸚
ʔˤrek	q'rek	厄戹隘阸阨{險要處}豟䝈軛軶扼蚅搤𩚬
pen	pen	鞭鯾編箯便{地名，屬桂陽}
penʔ	penq	褊
pet	pet	鼈蟞龞鱉鷩虌𡐞鄨䳤
pʰen	phen	偏翩{疾飛}篇媥
pʰenʔ	phenq	萹
ben	ben	便楩緶平{辨}
benʔ	benq	楩䡢
benh	benh	便{有利；適宜；便捷}
men	men	媔緜綿矊矏櫋蝒
menʔ	menq	湎偭緬勔黽{黽池}澠{澠池}沔𩋠
menh	menh	面
met	met	滅搣
m̥et	mhet	烕
tet	tet	折{折斷}裚浙
det	det	折{斷}
n̥enʔ	nhenq	獮
tsen	tsen	煎
tsenʔ	tsenq	翦剪鬋戩揃
tsenh	tsenh	箭葥
tset	tset	蠽
tsʰenʔ	tshenq	淺
dzenʔ	dzenq	踐俴
set	set	禼契{商祖}
let	let	逸{逸逸，有序}
ret	ret	列{陳列，行列；各；陳述}
ket	ket	孑
kʰenʔ	khenq	遣繾
kʰenh	khenh	譴遣{遣策；將葬時祭奠}
ŋ̊et	nghet	設褻𣊓暬
kwenh	kwenh	絹鄄狷
kʰwet	khwet	缺蒛
gwenʔ	gwenq	蜎{孑孓}
wen	wen	捐鏇鳶旋璇琁還{旋，旋轉；立即}璿
ẘen	when	儇翾
ẘenʔ	whenq	蠉
ẘet	whet	吷
ʔwen	qwen	嬽娟蜎{彎曲}
pret	pret	別{分解、辨別，他動}
brenʔ	brenq	辨辯諞
bret	bret	別{差別；離別，自動}
trenʔ	trenq	輾
tret	tret	哲
tʰret	thret	硩
tsret	tsret	札蚻
dzren	dzren	虦
lret	lret	撤轍澈徹{撤、毀；轍；田稅制度}
l̥ret	lhret	徹{通、達、顯明；治理}
ŋret	ngret	臬闑槷
gwren	gwren	鬈卷{美好}
pˤen	p'en	邊籩編蝙甂
pˤenʔ	p'enq	扁惼
pˤenh	p'enh	遍徧
pʰˤen	ph'en	猵
pʰˤenh	ph'enh	片
pʰˤet	ph'et	嫳
bˤen	b'en	胼跰楄
bˤenʔ	b'enq	扁{扁鵲}辮
bˤet	b'et	蹩蛂癟
mˤen	m'en	䰓
mˤenh	m'enh	眄麪
mˤet	m'et	蔑鱴薎篾蠛𥾝䁾
tˤenʔ	t'enq	蕇
tʰˤenʔ	th'enq	靦
tsˤen	ts'en	湔淺{淺淺，水流疾}𢃬
tsʰˤet	tsh'et	竊
dzˤen	dz'en	前
dzˤet	dz'et	截
sˤen	s'en	𨇤{跰𨇤}
sˤenh	s'enh	霰
sˤet	s'et	躠
lˤenʔ	l'enq	蜓{蝘蜓}
rˤenh	r'enh	萰煉楝僆
C.rˤen	C.r'en	蓮
C.rˤenh	C.r'enh	練鍊湅
kˤen	k'en	肩猏菺豜𪊑鳽鈃{人名}
kˤenʔ	k'enq	繭襺蠒趼𢆞
kˤenh	k'enh	見
kˤet	k'et	潔鍥
kʰˤen	kh'en	汧岍雃
kʰˤenh	kh'enh	俔
kʰˤet	kh'et	挈契{刻}栔㼤
gˤen	g'en	肩{肩肩，瘦小細長}
gˤenʔ	g'enq	睍{睍睆，鳥聲清和圓轉}蜆峴垷俔{間諜}
gˤenh	g'enh	見現晛
gˤet	g'et	緳絜
ŋˤen	ng'en	研鳽
ŋˤenʔ	ng'enq	齞
ŋˤenh	ng'enh	𤜵硯趼{獸腳前面著地}
ŋˤet	ng'et	霓蜺{蜺虹}齧嚙
ŋ̊ˤet	ngh'et	楔{楔子}
hˤen	h'en	詽
hˤenʔ	h'enq	顯韅
kwˤen	kw'en	涓睊睘{驚視貌}蠲䅌
kwˤenh	kw'enh	懁獧
kwˤet	kw'et	決玦駃訣䏐䦼夬{鉤弦用的扳指}趹袂
gwˤen	gw'en	懸縣𠐴
gwˤenʔ	gw'enq	鞙琄䧎
gwˤenh	gw'enh	縣{郡縣}
wˤenʔ	w'enq	繯
ẘˤen	wh'en	鋗
ẘˤenh	wh'enh	駽
ẘˤet	wh'et	決{迅疾}
ʔˤen	q'en	燕{國}
ʔˤenh	q'enh	燕鷰宴讌觾酀驠
ʔwˤen	qw'en	蜎{蜎蜎，昆蟲蠕動爬行狀}悁
ʔwˤenh	qw'enh	噮
ʔwˤet	qw'et	抉妜焆
pˤret	p'ret	八
bˤrenh	b'renh	辨瓣辦
dˤrenh	d'renh	綻
tsˤrenʔ	ts'renq	棧{小鐘}
tsʰˤret	tsh'ret	察{嚴苛；彰明；清白；深；至}
dzˤrenʔ	dz'renq	棧{編木制成的墊子}
kˤren	k'ren	間{中間；頃刻；近來}蕑
kˤrenʔ	k'renq	簡柬揀㶕
kˤrenh	k'renh	間覸鐗𧙧見{棺衣}瞷{窺視；偵伺}
kˤret	k'ret	揳楔
kʰˤren	kh'ren	顅
gˤren	g'ren	閑{閑閑，眾多}閒瞷癇嫺
gˤrenh	g'renh	莧䨘
wˤren	w'ren	環寰還圜鐶轘㡲䭴闤
wˤrenh	w'renh	還{擊退，使退卻}環{圍繞、包圍}擐
ʔˤret	q'ret	窫䝟揠
tem	tem	占
temh	temh	占{上報；登記}
tep	tep	懾
stem	stem	苫痁
step	step	攝{執、夾、捉；攝生；衣緣}
tʰem	them	㚲
nem	nem	蛅
n̥ep	nhep	攝{輔助；代理；收斂；安定}囧冏臩
lem	lem	阽
l̥ep	lhep	偞
slem	slem	銛
rem	rem	廉簾𢅏薕鎌蠊
remʔ	remq	䭑
ʔem	qem	厭{滿足；合適}饜{飽；滿足；盛}懕
ʔemʔ	qemq	黶
ʔemh	qemh	厭{厭煩；使滿足、信服；美盛}饜{使滿足；止}
ʔep	qep	猒厭{壓；堵塞；迫近；降低}靨
prem	prem	砭
premʔ	premq	貶
trem	trem	霑沾{染}
trep	trep	輒
tʰrem	threm	覘佔{佔畢}
nrem	nrem	黏
nrep	nrep	籋
tˤemʔ	t'emq	玷點
tˤemh	t'emh	檐簷坫
tʰˤem	th'em	沾{添；水名}
tʰˤep	th'ep	鉆帖怗
nˤep	n'ep	苶
n̥ˤemh	nh'emh	𨸱
sˤep	s'ep	踥躞
lˤem	l'em	恬甜
lˤep	l'ep	牒蝶諜蹀堞褋
l̥ˤemʔ	lh'emq	餂
rˤem	r'em	溓磏礦{磏}鬑
kˤem	k'em	兼蒹鶼縑
kˤep	k'ep	莢頰鋏䛟
kʰˤem	kh'em	謙
kʰˤemʔ	kh'emq	慊{遺憾}嗛歉
kʰˤemh	kh'emh	傔
kʰˤep	kh'ep	愜篋慊{滿足}
gˤem	g'em	嫌
gˤemʔ	g'emq	鼸㺌
gˤep	g'ep	挾協俠勰
hˤem	h'em	䵌
ʔˤemʔ	q'emq	檿
ʔˤep	q'ep	擫擪
kˤrep	k'rep	夾郟筴梜䀹
gˤrep	g'rep	狹陜浹
ʔˤremʔ	q'remq	黶{人名}
ʔˤrep	q'rep	壓
pew	pew	猋贆標熛蔈摽{驅逐}飆杓{勺柄}
pewʔ	pewq	剽{末梢}
pʰew	phew	漂嘌飄嫖{輕}𣿖
pʰewʔ	phewq	縹皫
pʰewh	phewh	爂僄
bew	bew	瀌瓢剽{鐘}
bewʔ	bewq	剽摽{捶擊；采集}
mewʔ	mewq	淼杪渺眇鈔{眇}訬{狡猾}篎藐
mewh	mewh	妙
tew	tew	盄
tewh	tewh	約{簡；貧困}
tewk	tewk	約灼酌妁礿
stewʔ	stewq	少{多少}
stewh	stewh	少{幼年；副職}
tʰew	thew	紹{緩慢}
dewʔ	dewq	紹
dewk	dewk	勺汋杓{勺}
new	new	橈{船槳}
newʔ	newq	撓{揮動}
newk	newk	弱蒻溺{軟弱}
tsew	tsew	焦椒蕉𨶲噍{聲音急促}鷦
tsewʔ	tsewq	𨙹湫{春秋楚地}
tsewh	tsewh	灂潐僬爝醮
tsewk	tsewk	雀爵燋
tsʰewʔ	tshewq	愀悄
tsʰewh	tshewh	哨{不正}
dzew	dzew	譙樵憔
dzewh	dzewh	噍{咀嚼}誚譙{譴責}
dzewk	dzewk	釂
sew	sew	宵霄痟肖{細微；衰微}
sewʔ	sewq	小
sewh	sewh	削{小刀}鞘
sewk	sewk	削
lew	lew	窯䠛銚珧搖徭
lewk	lewk	龠籥禴鑰躍蘥瀹鸙
rewʔ	rewq	僚{美好}爒
rewh	rewh	療
kewʔ	kewq	沼
kewk	kewk	繳
kʰew	khew	趬
gew	gew	翹荍
ŋew	ngew	蕘饒蟯襓
ŋewʔ	ngewq	繞
ŋ̊ew	nghew	燒{自燃}
ŋ̊ewh	nghewh	燒{點燃}
ʔew	qew	要腰葽喓䳩邀
ʔewh	qewh	要{要害、重要；賬本；恰當；關閉}
ʔewk	qewk	葯
brewʔ	brewq	𣧶殍
drewʔ	drewq	趙
tsrewk	tsrewk	穛穱
srew	srew	筲䈰
srewh	srewh	稍
lrewʔ	lrewq	鮡
tˤew	t'ew	刁貂䂏
tˤewh	t'ewh	釣瘹
tˤewk	t'ewk	的馰魡靮杓{標準}芍{鳧茈}
dˤew	d'ew	芀苕祒鞀
dˤewh	d'ewh	掉
nˤewʔ	n'ewq	嬈嬲
nˤewh	n'ewh	尿溺{尿}
nˤewk	n'ewk	嫋溺{溺水}
sˤew	s'ew	萷箾{樂名；韶箾}揱捎{除；芟}蛸{蜱蛸、螵蛸，螳螂的卵塊}梢{流水衝激，梢溝}
lˤew	l'ew	跳挑{撓挑，宛轉循環貌}
lˤewʔ	l'ewq	窕誂挑{挑戰}
lˤewh	l'ewh	藋鑃
lˤewk	l'ewk	翟狄{戎狄}糴䊮
l̥ˤew	lh'ew	恌祧佻𠝡𣂁挑{叉取；挖掘}
l̥ˤewʔ	lh'ewq	宨
l̥ˤewh	lh'ewh	眺糶頫覜
l̥ˤewk	lh'ewk	趯籊
rˤew	r'ew	遼瞭繚{纏}僚寮鷯嵺膋膫鐐轑{轑陽，地名}
rˤewʔ	r'ewq	繚{趙繚，長}憭
rˤewh	r'ewh	料獠蟧{蝭蟧，蟬}𧔉
rˤewk	r'ewk	櫟礫躒䟏皪轢
kˤew	k'ew	梟儌憿澆𣻏徼{遮攔，截擊；求取；抄襲；激發}僥{僥倖，貪求}
kˤewʔ	k'ewq	皎晈敫皦曒嬓
kˤewh	k'ewh	徼{邊界；巡邏；要塞}噭獥
kˤewk	k'ewk	激鸄
kʰˤew	kh'ew	鄡
kʰˤewh	kh'ewh	竅撽
gˤewʔ	g'ewq	皛
gˤewk	g'ewk	檄獥薂䚫
ŋˤew	ng'ew	堯僥{僬僥，部族名}
ŋˤewh	ng'ewh	嘄
ŋ̊ˤew	ngh'ew	嘵憢膮
ŋ̊ˤewʔ	ngh'ewq	曉
ʔˤewʔ	q'ewq	杳窅㝔宎窈葽{葽繞，草名}
ʔˤewh	q'ewh	窔
pˤrewh	p'rewh	豹
pʰˤrew	ph'rew	摽{拋棄}
bˤrewk	b'rewk	瓝彴
mˤrewh	m'rewh	貌䫉
mˤrewk	m'rewk	邈
tˤrew	t'rew	鳭
nˤrew	n'rew	呶怓鐃譊
nˤrewh	n'rewh	橈
nˤrewk	n'rewk	搦䚥
tsʰˤrew	tsh'rew	訬{輕捷}
sˤrewk	s'rewk	𦂗箾{舞者所執之竿；象箾}
lˤrewh	l'rewh	櫂濯{洗沐後的髒水}
lˤrewk	l'rewk	濯擢鸐
kˤrew	k'rew	交鵁
kˤrewʔ	k'rewq	絞
kˤrewh	k'rewh	校
kʰˤrew	kh'rew	磽墝骹{小腿}
gˤrew	g'rew	筊絞{蒼黃色；斂屍用的束帶}姣{淫亂}
gˤrewʔ	g'rewq	骹
gˤrewh	g'rewh	效{盡力，效勞；呈現；進獻；授予}効校{呈現；愉悅}
gˤrewk	g'rewk	覈{果覈；覈實（？）}
ŋˤrewʔ	ng'rewq	咬
hˤrew	h'rew	髐
hˤrewh	h'rewh	詨
ʔˤrew	q'rew	咬{哀切之聲}
ʔˤrewk	q'rewk	箹
piʔ	piq	匕妣秕粃朼枇{勺}比{比較}
pih	pih	䃾𦸣比{輔助（及物）；每；先前；成例；比及}
pis	pis	蔽{蔽芾，小而茂密}畀痹痺庇疪
pʰiʔ	phiq	仳疕
pʰih	phih	庀
bi	bi	膍芘毗毘阰魮貔肶蚍㮰仳{仳倠，醜女}枇{枇杷}
biʔ	biq	牝
bih	bih	比篦
bis	bis	紕鼻
mis	mis	寐
tiʔ	tiq	厎砥㕄
tih	tih	至贄摯
tis	tis	鷙䲀桎侄郅
tʰi	thi	鴟𩿨
tʰih	thih	痓
diʔ	diq	視{看；教導}眂眡
dih	dih	視{比；生存；接納}示{主動示人，顯現；告知；教導}寘
nis	nis	二貳樲
tsi	tsi	咨資澬姿粢諮齎齍齊{長衣下擺；喪服}
tsiʔ	tsiq	秭姊𡛷
tsih	tsih	資{鋒利；極、最}
tsis	tsis	恣次{榆次}
tsʰi	tshi	郪次{次且，猶豫}𡰾
tsʰih	tshih	佽
tsʰis	tshis	次絘䳐
dzi	dzi	茨薋餈蠐{蝤蠐}瓷
dzih	dzih	嫉
dzis	dzis	自
li	li	伊荑痍鮧彝跠
l̥i	lhi	尸{主掌}屍{死屍}鳲屎{殿屎，呻吟}瞚䀢
l̥iʔ	lhiq	屎矢
l̥is	lhis	呬
sliʔ	sliq	死兕
slis	slis	四泗柶駟
ri	ri	梨棃犂鵹𢤂
ris	ris	利
C.riʔ	C.riq	履
ki	ki	脂
kiʔ	kiq	旨{美好}指耆{致使，達到；進獻}
kih	kih	旨{旨意}
kʰis	khis	棄㞓
gi	gi	祁{盛大}鮨耆{老；強；憎惡}
gih	gih	示{展示；安置}嗜
hi	hi	蓍
kwiʔ	kwiq	癸
kwis	kwis	季
gwi	gwi	葵䳫鄈
gwiʔ	gwiq	揆
gwis	gwis	悸
wi	wi	維惟唯濰
wiʔ	wiq	唯{應答}鷕蜼趡
ẘi	whi	雖睢倠{仳倠，貌醜}
wis	wis	穗蔧韢
ʔi	qi	伊{代詞；助詞；伊尹}咿蛜
ʔiʔ	qiq	殹
prih	prih	祕毖閟泌秘柲䀣
pʰris	phris	濞
briʔ	briq	㠲
bris	bris	贔奰
mri	mri	麋蘪眉楣
mrih	mrih	䉋娓{順從}
triʔ	triq	黹
trih	trih	致質{抵質、人質}駤鷙{抵}
tris	tris	躓疐懥輊
tʰri	thri	絺脪
tʰrih	thrih	𦥊懫
dri	driq	泜{槐河，陳餘死處}
driʔ	driq	泜{滍水，在河南，入汝}
drih	drih	緻
nris	nris	膩
n̥rih	nhrih	杘
tsriʔ	tsriq	笫胏
dzriʔ	dzriq	柹
sri	sri	師
lri	lri	墀
lriʔ	lriq	雉薙
l̥rih	lhrih	𩳁
l̥ris	lhris	訵
kriʔ	kriq	𪊨䢳
gri	gri	鬐鰭
gwri	gwri	戣
wri	wri	帷
ʔrih	qrih	欭懿
ʔris	qris	饐鷧
pˤi	p'i	蓖螕狴
pˤis	p'is	閉{關閉，動詞}箅
pʰˤi	ph'i	枇
pʰˤis	ph'is	媲淠
bˤi	b'i	笓玭
bˤiʔ	b'iq	陛蜌梐
mˤi	m'i	迷
mˤiʔ	m'iq	米眯㝥
tˤi	t'i	氐低羝䢑袛
tˤiʔ	t'iq	底詆抵弤邸菧泜{泜河，在常山}
tˤih	t'ih	柢
tˤis	t'is	嚏
nˤiʔ	n'iq	苨禰泥{泥泥，柔順；茂盛}
n̥ˤih	nh'ih	替
tsˤi	ts'i	齎{託付}齌䪠䪡虀櫅𩐋韲齏
tsˤiʔ	ts'iq	濟{停止；濟濟，眾多}䮺䍤
tsˤih	ts'ih	霽擠濟{渡河；救助；成就}
dzˤi	dz'i	齊{人名}懠蠐{蠐螬}臍
dzˤiʔ	dz'iq	薺
dzˤih	dz'ih	癠
sˤis	s'is	壻婿
lˤi	l'i	稊蕛綈
lˤiʔ	l'iq	弟
lˤih	l'ih	第睇
l̥ˤiʔ	lh'iq	涕{眼淚}
l̥ˤih	lh'ih	洟{鼻涕}
slˤi	sl'i	犀
rˤi	r'i	犁鯬邌
rˤiʔ	r'iq	禮醴鱧澧
r̥ˤiʔ	rh'iq	體
C.rˤi	C.r'i	黎{國名}
kˤi	k'i	稽{稽留；滑稽}
kˤih	k'ih	稽{法式；准則}
kˤis	k'is	計髻{髮髻}紒
kʰˤiʔ	kh'iq	䭫稽{稽首；至}
gˤi	g'i	郋
ŋˤis	ng'is	詣
kʰwˤi	khw'i	睽藈
wˤis	w'is	惠蕙譓蟪潓
ẘˤis	wh'is	嘒嚖
ʔˤi	q'i	鷖繄
ʔˤis	q'is	嫕殪曀豷
kˤri	k'ri	階
kˤriʔ	k'riq	皆偕
kˤris	k'ris	屆
kʰˤriʔ	kh'riq	楷
hˤris	h'ris	㞒
kwˤri	kw'ri	乖
wˤri	w'ri	淮
pik	pik	必珌鮅
pʰik	phik	匹疋鵯
bik	bik	怭邲苾
mik	mik	謐
tiŋ	ting	真眞磌
tik	tik	質鑕蛭晊
stik	stik	室
tʰiŋ	thing	瞋謓
diŋh	dingh	㐨
dik	dik	實
niŋ	ning	人仁
niŋh	ningh	認
nik	nik	日
n̥iŋ	nhing	身
tsiŋ	tsing	進津
tsiŋh	tsingh	晉㬐鄑搢縉
tsik	tsik	即卽堲{燭灰}蝍
tsʰiŋ	tshing	親
tsʰik	tshik	桼漆䰍柒
dziŋ	dzing	秦螓
dziŋh	dzingh	藎贐賮
dzik	dzik	疾衋槉蒺堲{疾}
siŋ	sing	辛新薪信
siŋh	singh	訊迅信{相信；聽任，及物}
sik	sik	悉怷{悉}膝
liŋ	ling	寅蔩夤
liŋh	lingh	演{推演}
lik	lik	溢鎰逸佚軼
l̥iŋ	lhing	呻
l̥ik	lhik	失
riŋ	ring	粼旍轔
rik	rik	栗慄鷅麜瑮溧
C.riŋ	C.ring	令{春秋晚期以前，使令}
C.riŋh	C.ringh	令{春秋晚期以前，美善}
kwik	kwik	橘繘
gwik	gwik	𧽻
wik	wik	驈潏{水中土石工程}遹鷸鱊噊鴥
ẘik	whik	恤卹
ʔiŋ	qing	姻婣
ʔik	qik	臆肊
prik	prik	鉍潷
brik	brik	駜
mriŋ	mring	命{春秋晚期以前}
mrik	mrik	宓密蔤
triŋ	tring	鎮
triŋh	tringh	鎮{基礎；山鎮；鎮服；填星}
trik	trik	窒挃銍庢
tʰrik	thrik	鷙{卓鷙，謂行爲乖戾獨特}
driŋ	dring	填{久}
nrik	nrik	衵
tsriŋ	tsring	臻𧽕溱榛蓁
tsrik	tsrik	櫛
tsʰriŋh	tshringh	櫬襯瀙
sriŋ	sring	峷侁甡阠
srik	srik	瑟螅蝨虱璱
lrik	lrik	秩紩翐柣{門檻}祑袠豑
l̥rik	lhrik	抶
kriŋ	kring	矜
ẘrik	whrik	淢洫侐
ʔrik	qrik	抑
bˤiŋ	b'ing	骿駢
tˤiŋ	t'ing	顛蹎巔瘨齻傎癲滇
tʰˤiŋ	th'ing	瑱
tʰˤik	th'ik	蛈
dˤiŋ	d'ing	闐填窴鷏搷
dˤiŋh	d'ingh	奠
dˤik	d'ik	絰咥垤耋臷姪恎
nˤiŋ	n'ing	年佞
nˤik	n'ik	涅
tsˤik	ts'ik	節楶癤
tsʰˤiŋ	tsh'ing	千阡芊
tsʰˤiŋh	tsh'ingh	倩蒨綪茜絤{茜}輤
tsʰˤik	tsh'ik	漆{漆漆，恭敬謹愼}
sˤik	s'ik	僁
lˤiŋ	l'ing	田甸畋佃
lˤik	l'ik	跌迭瓞佚{佚宕，放肆爲禍}泆軼{迭}苵驖眣昳镻胅凸𥥌戜鴩柣{桔柣門}
l̥ˤiŋ	lh'ing	天
l̥ˤik	lh'ik	鐵
rˤiŋ	r'ing	呤鈴瓴苓坽零泠齡囹伶翎舲聆玲魿令{令支；令狐}
C.rˤiŋ	C.r'ing	憐{同情，愛惜}矜{同情，愛惜}瘝
gˤik	g'ik	桔{桔柣門}
kwˤik	kw'ik	譎鐍觼潏{水名}憰芵鴂鴃
kʰwˤik	khw'ik	湀
wˤik	w'ik	矞穴袕
ẘˤiŋ	wh'ing	敻{遠}
ẘˤik	wh'ik	血泬瞲
ʔˤik	q'ik	噎㖶{噎}
ʔwˤiŋ	qw'ing	𣶒淵鼘
kwˤrik	kw'rik	劀鱊
pin	pin	賓賔濱儐{尊敬}檳瀕
pinh	pinh	擯殯鬢儐{引導賓客；陳列}
pit	pit	畢韠鞸罼彃縪觱蹕篳䟆熚
pʰin	phin	翩{飄揚；翩翩，往來貌}繽
bin	bin	頻蘋嚬薲矉嬪顰
binʔ	binq	臏髕
min	min	民泯氓{民}
minʔ	minq	黽{黽勉}
mit	mit	蠠蜜
m̥it	mhit	戌
tsinʔ	tsinq	盡{盡量}
tsʰit	tshit	七
dzinʔ	dzinq	燼盡
kin	kin	甄𪃋籈薽
kinʔ	kinq	緊
kinh	kinh	挋
kit	kit	吉拮
kʰinh	khinh	菣
kʰit	khit	詰蛣
gin	gin	臣茞䢻
ginʔ	ginq	腎𦜜
ŋit	ngit	馹篞
kwin	kwin	均鈞袀
kwinh	kwinh	𧥺
gwin	gwin	惸{無兄弟；憂貌}
win	win	勻匀旬畇䘩
winʔ	winq	尹
wit	wit	僪聿
ẘin	whin	荀詢眴洵恂珣郇橁畇𣖼栒
ẘinʔ	whinq	隼鶽筍笋芛
ẘinh	whinh	濬迿筍{竹輿}
ẘit	whit	獝
winh	winh	殉徇侚𢓈睿叡
ʔin	qin	因茵裀絪湮禋歅諲闉堙䃌
ʔinh	qinh	印
ʔit	qit	一壹
tsʰrinʔ	tshrinq	齔齓
srit	srit	蟋
grit	grit	佶姞
ŋrin	ngrin	嚚
wrin	wrin	筠
wrinʔ	wrinq	荺
wrinh	wrinh	韻
ʔrin	qrin	駰
ʔrit	qrit	乙鳦
pˤit	p'it	閉{封閉，形容詞}虙
pʰˤit	pʰ'it	覕
bˤin	b'in	蠙
bˤit	b'it	飶批
mˤin	m'in	眠
tsʰˤit	tsh'it	切
l̥ˤinʔ	lh'inq	蚕{蜸蚕，蚯蚓}
kˤin	k'in	堅鰹
kˤit	k'it	結袺桔𡔢髻{竈神}
kʰˤin	kh'in	牽掔
kʰˤinʔ	kh'inq	蜸
gˤin	g'in	賢弦誸絃蚿胘
gˤinʔ	g'inq	顈
gˤinh	g'inh	賢{車轂一端的大孔}
gˤit	g'it	頡襭𤢺
ŋˤit	ng'it	隉{杌隉，動搖不安}臲{臲卼，動搖不安}
kwˤinʔ	kw'inq	甽汱
kwˤit	kw'it	闋{闋廣，回毛在背的馬}
kʰwˤinʔ	khw'inq	犬畎
kʰwˤit	khw'it	闋
gwˤin	gw'in	玄眩玆{玄}
gwˤinʔ	gw'inq	鉉泫
gwˤinh	gw'inh	炫昡衒
wˤin	w'in	盷
wˤinʔ	w'inq	贙
ẘˤinh	wh'inh	絢
ʔˤin	q'in	咽珚煙
ʔˤinh	q'inh	咽{吞咽}
ʔˤit	q'it	𢓨
pʰˤrinh	ph'rinh	盼{美目~兮}
kˤrit	k'rit	戛秸鞂鴶揩{揩擊，打擊樂器}
kʰˤrin	kh'rin	鏗硻
kʰˤrit	kh'rit	硈劼
gˤrinʔ	g'rinq	䁂
gˤrit	g'rit	黠
kwˤrin	kw'rin	矜{老而無妻}鰥{老而無妻}鱞{老而無妻}
gwˤrinh	gw'rinh	幻{惑亂；幻怪}
ʔˤrit	q'rit	軋
tip	tip	執
nim	nim	恁{思念}
nimʔ	nimq	飪稔腍棯
n̥imʔ	nhimq	諗淰
tsip	tsip	蓻
tsʰim	tshim	駸
tsʰimʔ	tshimq	寢
kim	kim	針鍼箴葴
kip	kip	汁
gip	gip	十什拾{取}
ʔim	qim	愔
ʔip	qip	揖挹俋
trip	trip	縶馽慹
drip	drip	蟄
nrip	nrip	孴{謹慎}
tˤimh	t'imh	墊
nˤimh	n'imh	念
nˤip	n'ip	敜
tsˤimh	ts'imh	僭{僭越}
lˤimʔ	l'imq	簟驔
lˤip	l'ip	褶
l̥ˤim	lh'im	忝
slˤip	sl'ip	燮
gˤip	g'ip	叶
tiw	tiw	周輖椆賙週婤{婤姶，人名}
tiwk	tiwk	粥{半流質食物；粥粥，柔弱無能}鬻{粥}
stiwk	stiwk	叔鮛埱
tʰiwk	thiwk	諔俶{善；詭異}
diwk	diwk	淑
tsiw	tsiw	啾揫蘸𡧯湫{清淨}
tsʰiw	tshiw	秋湫楸鰍鱃萩鶖篍𥭳緧
siwh	siwh	繡{繡組；錦繡}
siwk	siwk	肅鏽{肅}鱐鷫蟰潚
liw	liw	攸悠{長久；飄動貌，游動貌}浟滺峳鯈由䍃櫾繇逐{逐逐，連綿不絕}
liwh	liwh	柚{木}鼬貁狖
l̥iwk	lhiwk	倏儵虪
sliw	sliw	修脩𩛢
sliwʔ	sliwq	滫
riw	riw	翏摎{交結}漻{漻然，謂變化}鏐蟉疁
riwh	riwh	鷚雡飂{國名}
C.riw	C.riw	勠僇
C.riwk	C.riwk	戮
kiw	kiw	㽱赳
kiwʔ	kiwq	糾糺
giw	giw	虯虬
hiw	hiw	收
ʔiw	qiw	幽呦怮
ʔiwʔ	qiwq	黝泑
ʔiwh	qiwh	幼
priw	priw	彪
briw	briw	淲滮
mriw	mriw	繆{絞結；綢繆}
mriwh	mriwh	謬繆{錯誤}
mriwk	mriwk	穆
triw	triw	啁{啁噍，鳥蟲鳴聲}
tʰriw	thriw	惆
driw	driw	綢稠
tsriwh	tsriwh	甃
dzriw	dzriw	愁
lriw	lriw	盩𥂕盭
lriwh	lriwh	籀繇{占辭}冑胄逐{賽跑}
lriwk	lriwk	逐鱁柚{織機部件}
l̥riwk	lhriwk	苖
r̥iw	rhiw	瘳
kriw	kriw	樛朻
griw	griw	璆觓觩
tˤiw	t'iw	雕鵰彫{雕}琱{雕}錭{雕}凋𥮐䘟瞗鯛
tˤiwʔ	t'iwq	鳥蔦
tˤiwh	t'iwh	弔吊
tˤiwk	t'iwk	弔{至；善}
tʰˤiwk	th'iwk	倜
dˤiw	d'iw	調蜩
dˤiwh	d'iwh	調{樂調}
dˤiwk	d'iwk	踧{踧踧，平坦}
nˤiwʔ	n'iwq	褭
nˤiwk	n'iwk	惄愵
tsʰˤiwk	tsh'iwk	戚{一種兵器；姓}
dzˤiwk	dz'iwk	寂𠴫
sˤiw	s'iw	蕭簫瀟蠨橚櫹
sˤiwʔ	s'iwq	䃤謏
sˤiwh	s'iwh	歗嘯
lˤiw	l'iw	條鰷䱔𧌁鞗鋚
lˤiwh	l'iwh	蓧{除草農具}
lˤiwk	l'iwk	迪篴笛滌
l̥ˤiw	lh'iw	蓧{即蓨，羊蹄草}條{砍伐；采摘}
l̥ˤiwk	lh'iwk	蓨
slˤiw	sl'iw	翛
slˤiwʔ	sl'iwq	篠
rˤiw	r'iw	漻聊廖
rˤiwʔ	r'iwq	蓼鄝
C.rˤiw	C.r'iw	寥
kˤiwh	k'iwh	叫呌訆嘂
hˤiw	h'iw	䫞𨶅{撤除（祭品）}
ʔˤiw	q'iw	么幺狕
ʔˤiwʔ	q'iwq	鴢
ʔˤiwh	q'iwh	穾
tˤriw	t'riw	啁
kˤriw	k'riw	膠𦫶
kʰˤriw	kh'riw	膠{膠加，乖戾}
hˤriw	h'riw	嘐
ʔˤriw	q'riw	坳
ʔˤriwʔ	q'riwq	拗
pə	py	不鴀
pəʔ	pyq	否{不}
pəh	pyh	富䔰
pʰə	phy	紑衃
pʰəʔ	phyq	𢜳
pʰəh	phyh	副
bə	by	芣罘涪
bəʔ	byq	負婦萯偩
bəh	byh	伏{伏兵；孵蛋}
mə	my	謀{動詞}
məʔ	myq	母拇踇畝䳇毋謀{具體名詞，策略，方案}某
məh	myh	姆謀{抽象名詞，才智}
tə	ty	之芝志{目標，志向}
təʔ	tyq	止址畤趾阯沚洔誌
təh	tyh	志織{名詞}
stə	sty	詩邿
stəh	styh	試{任用}識{標記、記住、識別}幟
tʰə	thy	蚩
tʰəʔ	thyq	齒
tʰəh	thyh	熾
də	dy	時塒榯蒔鼭旹
dəʔ	dyq	恃市畤時{順承；此；善}
dəh	dyh	侍寺
nə	ny	而陑栭鴯鮞耏胹聏
nəʔ	nyq	耳䋙餌洱駬珥
nəh	nyh	䎶佴衈刵餌{給人喫}咡
tsə	tsy	茲兹滋鎡嵫嗞鰦鼒仔{仔肩，勝任}孜孳{孳孳，同“孜孜”，勤勉}
tsəʔ	tsyq	子耔梓
tsəh	tsyh	子{待如己子；慈愛}
dzə	dzy	慈鶿磁
dzəh	dzyh	字孳牸茡
sə	sy	絲思緦偲{偲偲，互相勉勵}
səʔ	syq	葸諰
səh	syh	思{名詞；悲傷；謂道德完備}僿
lə	ly	飴怡瓵台{我；何}
ləʔ	lyq	以苡佁㠯苢
ləh	lyh	貽詒咍
l̥əʔ	lhyq	始枲
l̥əh	lhyh	試{嘗試；比試}始{副詞，桃~華}弑司{官吏；執掌}伺笥
l̥ə	lhy	司{職守}
slə	sly	辭{言詞；道歉；告訴；告辭；記載}祠詞
sləʔ	slyq	似鈶枱𤹇姒
sləh	slyh	嗣食{餵食；供品；宴請；給俸祿；利誘}飼辭{辭別，推辭，迴避}
rə	ry	釐厘犛漦斄嫠剺梩𢟤
rəʔ	ryq	里㾖理李裏裡悝俚鯉𨛋吏
C.rə	C.ry	貍狸
jə	jy	頤熙{廣闊；興盛}圯顊㺿异{舉；任用。一說停止}㺇弬
jəʔ	jyq	已{停止；罷免；過分}俟熙{興盛；嬉戲}攺
jəh	jyh	異已{已經；不許；句首語氣詞}宧
j̊əʔ	jhyq	茝芷
j̊əh	jhyh	𩟄
kjə	kjy	姬䇫
mjəʔ	mjyq	俟涘竢挨{俟}騃
sjəʔ	sjyq	巳汜祀耜{起土器}洍戺
kə	ky	基箕萁𦮼期{動詞，按時循環一次}朞稘諆
kəʔ	kyq	己紀記妀
kəh	kyh	䢋記{記載，典籍；標識}
kʰə	khy	欺倛僛娸
kʰəʔ	khyq	起杞屺峐芑
kʰəh	khyh	亟{迅捷，形容詞；屢次}
gə	gy	其亓期旗騏騹麒祺琪璂淇䳢鶀棊綦藄碁棋濝鯕
gəʔ	gyq	跽邔忌{敬畏；顧忌}
gəh	gyh	忌{憎惡，怨恨；猜忌；忌諱}惎鵋誋{忌}
ŋə	ngy	疑嶷{九嶷}觺
ŋəʔ	ngyq	擬儗薿
ŋəh	ngyh	譺
hə	hy	熺僖嘻禧譆嬉誒
həʔ	hyq	喜{快樂}娭饎糦
həh	hyh	憙{喜歡，喜愛}喜{喜歡，喜愛，喜事}
kwəʔ	kwyq	久玖
kwəh	kwyh	疚灸
kʰwə	khwy	丘邱蚯
gwə	gwy	裘俅莍
gwəʔ	gwyq	臼舊{長久；成例；故人}
gwəh	gwyh	柩舊{陳舊；往昔}
ŋwə	ngwy	牛
wə	wy	尤肬訧疣郵
wəʔ	wyq	有友右侑䳑
wəh	wyh	又佑祐右{佑；祐；親近}宥姷𩑣䀁
ʔə	qy	噫醫㿄抑{助詞}
ʔəʔ	qyq	矣
ʔəh	qyh	意{想法；意思；猜測}鷾
prəʔ	pryq	鄙
pʰrə	phry	丕駓銔伾㔻
pʰrəʔ	phryq	秠嚭
brə	bry	邳䲹魾坯{土丘}
brəʔ	bryq	岯否{閉塞、困厄}痞{凝滯、鬱結}
brəh	bryh	備𣖾糒服{駕，乘}
mrəʔ	mryq	敏𤛎
trəʔ	tryq	徵{五音}
trəh	tryh	置
tʰrəʔ	thryq	祉
drə	dry	持荎
drəʔ	dryq	峙庤痔跱偫滍
drəh	dryh	植值
n̥rəʔ	nhryq	恥耻𦖷
tsrə	tsry	淄緇菑{開墾，耕耘}錙輜鶅椔甾
tsrəʔ	tsryq	滓
tsrəh	tsryh	胾事{立置、插入}倳菑
tsʰrəh	tshryh	廁
dzrə	dzry	茬
dzrəʔ	dzryq	士仕事{官職，職責，職守；侍奉}
dzrəh	dzryh	事
srəʔ	sryq	史使駛
srəh	sryh	使{出使；使者}
lrə	lry	治{理、爲，主動動詞}
lrəh	lryh	治{已治（天下治），用作名詞（法度）、形容詞（太平）；設置治所；求取；匹敵}
l̥rə	lhry	笞齝
l̥rəh	lhryh	眙
r̥ə	rhy	漦{滲流；涎沫}
kwrə	kwry	龜
wrəʔ	wryq	洧鮪痏
pˤə	p'y	杯桮
pˤəh	p'yh	背{脊背；後面；上面}
pʰˤə	ph'y	胚阫坏{坯}
bˤə	b'y	培坏{培}陪䣙
bˤəʔ	b'yq	倍菩
bˤəh	b'yh	佩珮背{違背}偝邶
mˤə	m'y	莓梅鋂媒禖煤膴{法則}
mˤəʔ	m'yq	每畮脢脄挴
mˤəh	m'yh	痗{病}
m̥ˤəʔ	mh'yq	海悔{悔過，過失，災禍}晦賄痗{悔}
m̥ˤəh	mh'yh	誨悔{改悔；翻悔；《易》卦的外卦，即上三爻}𠧩{《易》卦的外卦，即上三爻}
tˤəʔ	t'yq	等
tˤəh	t'yh	戴
dˤə	d'y	臺
dˤəʔ	d'yq	待
dˤəh	d'yh	待{對待，處置；供給；防備}
nˤə	n'y	能
nˤəʔ	n'yq	迺乃疓鼐
nˤəh	n'yh	能{耐}耐
n̥ˤə	nh'y	台{三台}
n̥ˤəh	nh'yh	態
tsˤə	ts'y	災哉栽烖渽
tsˤəʔ	ts'yq	宰載{年；祀；助詞}
tsˤəh	ts'yh	載{記載；開始；施行；成功；平安}再災{危害，動詞}𩛥
tsʰˤə	tsh'y	偲猜
tsʰˤəʔ	tsh'yq	采彩綵採㥒
tsʰˤəh	tsh'yh	菜寀䰂
dzˤə	dz'y	才材財裁
dzˤəʔ	dz'yq	在
dzˤəh	dz'yh	載{事業；筑牆長版}栽{筑牆長版}酨裁{名詞，樣式，體裁}
sˤə	s'y	䚡腮
sˤəh	s'yh	塞{要塞}賽㥶
lˤə	l'y	駘菭苔炱怠{懈怠，倦}
lˤəʔ	l'yq	殆怠{怠慢}紿迨䈚箈詒{欺騙}
lˤəh	l'yh	代岱黛玳䒫
l̥ˤə	lh'y	台{台背，老人；地名}胎邰鮐
l̥ˤəh	lh'yh	詒{誒詒}貸{借出}
rˤə	r'y	來{助詞}萊庲淶騋鯠崍郲𤦃
rˤəh	r'yh	賚睞
C.rˤə	C.r'y	來{過來；將來，過去}
C.rˤəh	C.r'yh	來{回來，返回；勤勞}
kjəʔ	kjyq	改
kˤə	k'y	該畡荄賅侅晐胲豥陔垓祴郂
kʰˤəʔ	kh'yq	肯肎
kʰˤəh	kh'yh	欬輆
gˤə	g'y	孩咳豥頦
gˤəʔ	g'yq	亥
gˤəh	g'yh	㤥
ŋˤəʔ	ng'yq	礙閡
ŋˤəh	ng'yh	懝
kʰwˤə	khw'y	恢
wˤə	w'y	蚘蛕蛔
ẘˤə	wh'y	灰
ẘˤəʔ	wh'yq	醢
ʔˤə	q'y	埃唉欸
ʔˤəʔ	q'yq	毐
ʔˤəh	q'yh	誒{誒詒}
bˤrəh	b'ryh	憊
mˤrə	m'ry	埋俚{埋}霾薶
dzˤrə	dz'ry	豺
kˤrəh	k'ryh	誡戒{準備；戒除；命令；告請}
gˤrə	g'ry	骸
gˤrəʔ	g'ryq	駭絯駴
gˤrəh	g'ryh	械
ŋˤrəʔ	ng'ryq	癡
kwˤrəh	kw'ryh	怪
ʔˤrəh	q'ryh	噫{飽食氣}
pək	pyk	福輻幅葍蝠楅鶝
bəŋ	byng	馮{地名}
bək	byk	服箙伏茯絥
məŋ	myng	夢㝱
məŋh	myngh	鄸
mək	myk	牧坶
təŋ	tyng	烝蒸
təŋh	tyngh	證烝{熏蒸}
tək	tyk	騭織{動詞}職樴膱蘵䐈{黏}
stəŋ	styng	升陞昇
stək	styk	識{了解，知識}
tʰəŋ	thyng	稱偁
tʰəŋh	thyngh	稱{符合；美好}
dəŋ	dyng	承丞拯抍𨋬脀巹卺騬
dək	dyk	植{直；剛強；種植}殖埴𡑌湜{湜湜，清澈}寔
nəŋ	nyng	陾仍扔{牽引，不及物}艿
nəŋh	nyngh	扔{牽引，及物}
n̥əŋ	nhyng	勝{戴勝}
tsəŋh	tsyngh	甑䰝
tsək	tsyk	稷
dzəŋ	dzyng	橧{豬圈及豬睡的墊草}繒驓鄫
sək	syk	息鄎蒠熄
ləŋh	lyngh	媵賸䞉
lək	lyk	弋芅杙釴黓仂𢓀
l̥əŋ	lhyng	勝
l̥əŋh	lhyngh	榺勝{勝利、超過；興盛、美好}
l̥ək	lhyk	式拭軾飾
mləŋ	mlyng	乘椉{乘}塍
mləŋh	mlyngh	乘{軍賦之單位；晉國史書}椉{乘}
mlək	mlyk	食蝕
rəŋ	ryng	陵䧙凌淩鯪㥄菱蔆䔖綾
C.rək	C.ryk	力朸
jəŋ	jyng	蠅蝇孕𣎜
jəŋh	jyngh	鱦
jək	jyk	翼瀷趩𠥦廙潩翌
mjəŋ	mjyng	繩澠憴
hjəŋ	hjyng	興
hjəŋh	hjyngh	興{喜愛；由一物引起另一物，譬喻}
kəŋ	kyng	兢
kək	kyk	亟{迅捷，副詞；急}殛悈
gək	gyk	極
ŋək	ngyk	嶷{幼小聰慧}凝{凝凝，水凍；嚴酷}軳
ŋ̊ək	nghyk	赩
kwəŋ	kwyng	弓
kʰwəŋ	khwyng	穹
wəŋ	wyng	雄
wək	wyk	囿
ʔəŋ	qyng	應{符合，適應；應該；國名}鷹
ʔəŋh	qyngh	應
ʔək	qyk	意{意志、志向；思念}億憶醷檍薏繶澺
ʔwək	qwyk	彧郁栯
prəŋ	pryng	冰掤
prək	pryk	逼偪湢幅{綁腿布}
pʰrək	phryk	副{割裂、剖分}疈堛揊𩜰
brəŋ	bryng	馮憑
brək	bryk	煏
trəŋ	tryng	徵
trək	tryk	陟稙
tʰrək	thryk	淔
drəŋ	dryng	澄懲徵{懲；地名}
drək	dryk	直犆{鑲邊}䐈{直腸}
nrək	nryk	匿暱恧
n̥rək	nhryk	恜
tsrək	tsryk	側仄昃
tsʰrək	tshryk	測惻畟
dzrək	dzryk	萴
lrəŋh	lryngh	朕眹
l̥rək	lhryk	敕{整飭；治，理}飭侙
r̥ək	rhyk	勑{告誡}敕{告誡}
krək	kryk	棘襋蕀
ŋrəŋ	ngryng	凝
ŋ̊rək	nghryk	色嗇穡薔繬
wrək	wryk	域緎棫罭䮙
ẘrək	whryk	閾窢
ʔrəŋ	qryng	膺
pˤəŋ	p'yng	崩
pˤəŋh	p'yngh	塴
pˤək	p'yk	北
pʰˤəŋʔ	ph'yngq	䣙{國名}
bˤəŋ	b'yng	朋傰倗鵬
bˤək	b'yk	匐僰踣菔蔔
mˤəŋ	m'yng	瞢儚
mˤək	m'yk	墨纆默嘿蟔冒{冒犯；貪；嫉妒}
m̥ˤəŋ	mh'yng	薨{諸侯死}𪈘
m̥ˤək	mh'yk	黑㱄
tˤəŋ	t'yng	登燈簦鐙
tˤəŋh	t'yngh	隥
tˤək	t'yk	得德{性質；品德}
dˤəŋh	d'yngh	鄧
dˤək	d'yk	特犆{特}
n̥ˤək	nh'yk	慝
tsˤəŋ	ts'yng	曾矰增憎罾竲譄橧{用柴薪堆造的住處}
tsˤək	ts'yk	則
dzˤəŋ	dz'yng	曾{曾經}層
dzˤəŋh	dz'yngh	贈
dzˤək	dz'yk	賊鰂載
sˤək	s'yk	塞{阻}
lˤəŋ	l'yng	滕騰縢鰧謄幐
lˤək	l'yk	𧎢蟘螣
l̥ˤək	lh'yk	忒貸{借入；忒，變化、差錯}貣
rˤəŋ	r'yng	薐
rˤək	r'yk	扐阞泐玏
C.rˤək	C.r'yk	來{小麥；歸順、招致}徠勒
kˤəŋ	k'yng	緪{繩子拉緊}
kˤəŋh	k'yngh	堩㮓亙緪{窮盡}
kʰˤək	kh'yk	刻克剋
gˤəŋ	g'yng	恒恆姮
gˤək	g'yk	劾
kwˤəŋ	kw'yng	肱
kwˤək	kw'yk	國
gwˤəŋ	gw'yng	弘鞃
wˤək	w'yk	或蜮惑
ẘˤəŋ	wh'yng	薨{薨薨，擬聲詞，猶轟轟}
pˤrəŋ	p'ryng	繃
bˤrəŋ	b'ryng	棚
mˤrəŋ	m'ryng	甍萌{萌發；鋤去；萌萌，保全、存在}
mˤrək	m'ryk	麥
kˤrək	k'ryk	革戒{警戒；齋戒}愅
gˤrək	g'ryk	核{核實；果核}
kwˤrək	kw'ryk	馘蟈膕
gwˤrəŋ	gw'ryng	宏閎紘竑
ẘˤrək	wh'ryk	繣掝
ʔwˤrəŋ	qw'ryng	泓
pəj	pyj	非飛扉匪{非}誹餥
pəjʔ	pyjq	匪{篚；斐；彼}𠏿{匪，彼}篚棐𩇹蜰
pʰəj	phyj	妃婓菲{菲菲，香氣盛}騑霏
pʰəjʔ	phyjq	菲悱斐朏
pʰəjh	phyjh	屁䊧
pʰəs	phys	髴{髣髴，隱約}
bəj	byj	肥腓𩇯痱{中風}
bəjʔ	byjq	陫
bəjh	byjh	萉蜚翡厞剕䠊屝黂蟦
bəs	bys	𥝋狒㵒怫
məj	myj	微薇溦癓
məjʔ	myjq	尾娓
məs	mys	未味沬菋
m̥əj	mhyj	徽鰴
təj	tyj	祗祁{昭餘祁}䓜
dəj	dyj	祁{祁縣；祁祁，多、盛；舒緩、和順}祇{神祇}
səj	syj	私
ləj	lyj	夷銕{夷，鋤類農具}姨桋侇
ləs	lys	隶殔肄
l̥əj	lhyj	尸{神主牌；陳列；楚月名}
sləs	slys	肂貄蕼𧳙肆{陳列；店肆}
mləs	mlys	諡謚
rəs	rys	淚
kəj	kyj	幾{征兆；庶幾}譏璣機饑鞿禨{征兆}磯鐖刉刏
kəjʔ	kyjq	幾{若干，多少}穖
kəjh	kyjh	禨{沐後飲酒}
kəs	kys	既旣旡
kʰəjʔ	khyjq	豈
kʰəs	khys	氣
gəj	gyj	畿蟣圻蚚頎{修長}玂幾{副詞，幾乎；器物上的凹凸線紋}𧰙鬿
ŋəjʔ	ngyjq	螘顗
ŋəs	ngys	毅藙𧅙顡
həj	hyj	希稀晞睎欷豨莃悕鵗
həjʔ	hyjq	狶唏
həs	hys	氣餼愾{滿}忥塈{休息；取}
kwəj	kwyj	歸
wəj	wyj	韋違圍幃闈湋
wəjʔ	wyjq	葦偉韡煒韙瑋䍷
wəjh	wyjh	緯
wəs	wys	胃𦝩蝟猬謂渭媦彙
ẘəj	whyj	楎褘
ẘəjʔ	whyjq	虺螝{雙頭怪蛇}虫
ẘəjh	whyjh	諱
ẘəs	whys	芔卉
ʔəj	qyj	衣依郼
ʔəjʔ	qyjq	扆偯依{譬喻}
ʔəjh	qyjh	衣{穿衣}
prəj	pryj	悲
prəjʔ	pryjq	俷
prəs	prys	轡費{地名}
brəjʔ	bryjq	圮
mrəj	mryj	湄郿覹黴
mrəjʔ	mryjq	美媺
mrəjh	mryjh	媚
mrəs	mrys	魅𥘯
trəj	tryj	胝
drəj	dryj	坻沶阺貾蚳
nrəj	nryj	尼怩{忸怩}
nrəjʔ	nryjq	柅
lrəj	lryj	遲謘
lrəjh	lryjh	稚稺穉遲{等待}
krəj	kryj	飢肌机
krəjʔ	kryjq	几麂
krəjh	kryjh	冀驥覬
kʰrəs	khrys	器
grəs	grys	塈{以泥塗屋頂}暨蔇鱀
ŋrəj	ngryj	狋{齗狋}
kʰwrəj	khwryj	巋
kʰwrəs	khwrys	喟㕟嘳
gwrəj	gwryj	騤
pˤəjh	p'yjh	輩
pʰˤəjh	ph'yjh	配
bˤəj	b'yj	徘裴𨛬
mˤəj	m'yj	枚攴{枚}玫
mˤəs	m'ys	妹眛味{光澤}
m̥ˤəjʔ	mh'yjq	火{《詩》“火”在此，或作“𤈦”}
m̥ˤəs	mh'ys	頮靧
nˤəj	n'yj	泥
nˤəjʔ	n'yjq	泥{滯留，不變通；泥泥，濃重}昵
nˤəjh	n'yjh	迡
tsˤəj	ts'yj	躋隮
tsˤəjʔ	ts'yjq	濟{濟濟，莊敬、整齊；濟水；彌補}泲
tsˤəjh	ts'yjh	穧{禾束}
tsʰˤəj	tsh'yj	妻萋淒凄悽緀
tsʰˤəjh	tsh'yjh	妻{嫁給；娶妻}
dzˤəj	dz'yj	齊
dzˤəjh	dz'yjh	嚌穧{收割}齊{調劑；調味；差別；合金}劑𨣧
sˤəj	s'yj	棲栖
lˤəj	l'yj	鵜𪁐{𪁐胡，即鵜鶘}
lˤəjʔ	l'yjq	弟{兄弟（詩經西土）；豈弟，和樂平易}悌{愷悌，和樂平易}娣
lˤəjh	l'yjh	悌{孝悌}
l̥ˤəj	lh'yj	梯剃{梯}
l̥ˤəs	lh'ys	曃
rˤəj	r'yj	黎黧藜蔾
rˤəs	r'ys	戾䓞綟悷𤟑
kˤəj	k'yj	剴
kˤəs	k'ys	溉概槩摡
kʰˤəj	kh'yj	闓
kʰˤəjʔ	kh'yjq	凱塏愷
kʰˤəjh	kh'yjh	鎧
kʰˤəs	kh'ys	慨嘅愾{慨歎；恨怒}
gˤəs	g'ys	瀣
ŋˤəj	ng'yj	磑
kwˤəj	kw'yj	瑰瓌
gwˤəs	gw'ys	潰
wˤəj	w'yj	回徊迴洄佪
wˤəjʔ	w'yjq	匯
wˤəjh	w'yjh	詯
ʔˤəj	q'yj	哀
ʔˤəs	q'ys	愛薆僾曖
bˤrəj	b'ryj	排俳
mˤrəs	m'rys	𩎟
tsˤrəj	ts'ryj	齋
dzˤrəj	dz'ryj	儕
kˤrəj	k'ryj	喈{快；喈喈，鳥聲、鈴聲、和洽}鶛
kʰˤrəjʔ	kh'ryjq	鍇
gˤrəj	g'ryj	湝{湝湝，水流貌}諧
gˤrəs	g'rys	䪥薤
hˤrəs	h'rys	齂
ẘˤrəs	wh'rys	躗
pən	pyn	分昐
pənʔ	pynq	粉
pənh	pynh	奮僨瀵分{分給；散發}
pət	pyt	茀{婦女首飾；茀茀，強盛}笰
pʰən	phyn	紛{絲帶；爭執}芬氛雰翂𢁥帉
pʰənʔ	phynq	忿
pʰət	phyt	刜彿
bən	byn	幩肦{大頭}頒{大頭}枌妢鼢羒豶羵鼖
bənʔ	bynq	弅蚠魵憤膹墳{土質肥沃}扮{握}
bənh	bynh	分{名分；界限}秎
bət	byt	咈
mən	myn	文蚊蟁蚉鳼鴍鼤
mənʔ	mynq	吻㖧刎呡亹{亹亹，勤勉；行進}䐇{吻}
mənh	mynh	汶紊免{喪服；物之稚弱者}絻脕文{修飾；掩飾}
mət	myt	芴
m̥ənh	mhynh	釁{縫隙；爭端；獸奮力奔跑}舋
m̥ət	mhyt	忽
tən	tyn	振震𨌑畛娠
tənʔ	tynq	疹軫䡩賑袗眕裖縝鬒稹黰胗
tənh	tynh	𧣨
dən	dyn	慎脣唇辰晨宸麎䣅
dənʔ	dynq	蜃脤蜄
nən	nyn	刃軔
nənʔ	nynq	忍荵涊{水名}
nənh	nynh	牣訒肕韌仞
sənh	synh	顖囟
lənʔ	lynq	引蚓螾鈏夤{脊肉}戭胤演{濕潤；水長流}
lənh	lynh	酳朄引{以引之繩}靷
lət	lyt	佾逸{逸豫}
l̥ən	lhyn	申伸紳柛𢘊
l̥ənʔ	lhynq	矧弞哂
mlən	mlyn	神䰠{神}
rən	ryn	麟麐驎磷𧲂瞵
rənh	rynh	躪甐遴獜燐
C.rən	C.ryn	鄰隣鱗橉
C.rənh	C.rynh	藺吝閵
kən	kyn	斤釿筋蘄{縣}
kənʔ	kynq	菫蓳謹槿
kənh	kynh	靳肵斤{斤斤，明察}
kət	kyt	扢訖吃
kʰənʔ	khynq	螼
kʰət	khyt	芞
gən	gyn	旂芹蘄祈勤懃瘽
gənʔ	gynq	近
gənh	gynh	近{接近；親近，動詞}慬{僅}蓳{烏頭}
ŋən	ngyn	沂齦䴦
ŋənh	ngynh	垽
ŋət	ngyt	仡
hən	hyn	欣訢昕忻
hənh	hynh	焮
hət	hyt	汔乞迄汽
kwən	kwyn	軍
wən	wyn	云芸雲妘耘紜運餫員鄖䢵溳沄鶤圓愪曋{暉（運）}
wənʔ	wynq	抎𤸫
wənh	wynh	暈鄆韗芸{花草枯黃貌}
ẘən	whyn	熏{灼燒；熏熏，和悅}燻焄薰勛勳獯翬葷揮輝暉煇纁臐壎塤
ʔən	qyn	殷慇
ʔənʔ	qynq	隱蘟檃讔殷{雷聲}㶏
ʔənh	qynh	隱{憑依}
prən	pryn	邠豳汃彬份
brən	bryn	貧
brət	bryt	佛{佛肸}
mrən	mryn	閩痻旻旼䃉碈瑉珉玟{瑉}鴖暋{煩悶}眉{老}
mrənʔ	mrynq	浼{浼浼，水盛貌}閔憫簢愍暋慜湣
m̥rənh	mhrynh	釁{血祭；征兆；塗，熏}衅
m̥rət	mhryt	肸{肸蠁}
trən	tryn	珍
tʰrən	thryn	疢
tʰrənʔ	thrynq	辴螴
drən	dryn	塵診𧭉
nrən	nryn	紉
nrət	nryt	䵑
dzrət	dzryt	𪗨
srən	sryn	詵駪莘
lrən	lryn	陳敶
lrənʔ	lrynq	䏖紖絼
lrənh	lrynh	陣
krən	kryn	巾
grən	gryn	矜{威勢；矛柄}覲
grənʔ	grynq	堇墐
grənh	grynh	饉瑾僅殣廑
ŋrən	ngryn	垠銀狺誾泿鄞圁
ŋrənʔ	ngrynq	齗{齗狋}
ŋrənh	ngrynh	憖猌
gwrət	gwryt	屈{狂屈}
wrən	wryn	縜
wrənʔ	wrynq	隕損殞磒霣
wrət	wryt	汩{疾行}
pˤən	p'yn	䴅
pˤənʔ	p'ynq	畚
pʰˤən	ph'yn	噴歕
pʰˤənh	ph'ynh	湓
bˤən	b'yn	盆葐
bˤənʔ	b'ynq	獖
bˤət	b'yt	勃浡{勃}渤郣艴𩣡
mˤən	m'yn	門亹
m̥ˤən	mh'yn	閽
m̥ˤət	mh'yt	笏曶匫
tˤənʔ	t'ynq	典
tˤənh	t'ynh	殿{居後；鎮守}
tʰˤənʔ	th'ynq	腆
tʰˤət	th'yt	餮
dˤən	d'yn	臀
dˤənʔ	d'ynq	殄沴
dˤənh	d'ynh	殿澱淀{澱}
nˤənʔ	n'ynq	撚
tsˤənh	ts'ynh	薦
dzˤən	dz'yn	存𨚲
dzˤənh	dz'ynh	荐洊栫袸
sˤən	s'yn	西先
sˤənʔ	s'ynq	洒銑先{在……前，引導；誘發}洗跣姺毨燹
lˤənh	l'ynh	電
l̥ˤən	lh'yn	吞
slˤət	sl'yt	屑
rˤən	r'yn	憐
kˤən	k'yn	根
kˤənʔ	k'ynq	䫀
kˤənh	k'ynh	艮
kʰˤənʔ	kh'ynq	墾豤頎
gˤən	g'yn	鞎
gˤənʔ	g'ynq	很狠佷
gˤənh	g'ynh	恨
gˤət	g'yt	齕紇
kwˤənʔ	kw'ynq	緷
kwˤət	kw'yt	汩{治}骨滑{治；亂；滑稽}抇{亂}蓇鶻
kʰwˤət	khw'yt	搰{搰搰，用力貌}
gwˤət	gw'yt	汩{湧波}
wˤən	w'yn	魂䮝𤟤
ʔˤən	q'yn	恩
pʰˤrən	ph'ryn	盼
kˤrən	k'ryn	艱
gˤrən	g'ryn	蛝
gˤrənʔ	g'rynq	限
ŋˤrənʔ	ng'rynq	眼
kwˤrən	kw'ryn	鰥
gwˤrət	gw'ryt	猾滑䱻螖
ʔˤrən	q'ryn	殷{深紅}
pəm	pym	風楓
pəmh	pymh	諷
bəm	bym	鳳渢芃
təm	tym	斟
təmʔ	tymq	枕䪴
təmh	tymh	枕{以頭枕物}
tʰəmʔ	thymq	瀋
dəm	dym	煁{爐}湛{河名}
dəmʔ	dymq	甚
nəm	nym	壬任衽紝
nəmʔ	nymq	荏{白蘇；軟}𦷺
nəmh	nymh	任{所負，責任、任務；任俠；委任；役使；任憑}絍
nəp	nyp	入
tsəm	tsym	祲
tsəmʔ	tsymq	寖
tsəmh	tsymh	浸
tsəp	tsyp	㗱
tsʰəm	tshym	侵綅浸{浸淫，濡染}
tsʰəmʔ	tshymq	梫鋟
tsʰəp	tshyp	緝葺
dzəm	dzym	鬵潛灊涔
dzəp	dzyp	集輯楫檝
səm	sym	心沁{水名}
ləm	lym	淫鐔鷣𨟏
ləp	lyp	熠
l̥əmʔ	lhymq	瞫㜤
l̥əp	lhyp	溼濕
sləm	slym	尋鄩𨼔燂燖蕈潯
sləp	slyp	習謵槢騽𪄶襲隰鰼
rəm	rym	林淋琳霖
rəmʔ	rymq	懍懔廩稟菻
rəp	ryp	立苙鴗颯
C.rəp	C.ryp	笠粒
kəm	kym	金汵𪑙
kəmʔ	kymq	錦
kəp	kyp	給芨汲{打水；汲汲，急切}伋{思考敏捷}觙級急㽺
kʰəm	khym	欽{欽欽，憂貌；鐘聲}衾
kʰəmʔ	khymq	坅
kʰəp	khyp	扱
gəm	gym	琴芩靲耹庈
gəmh	gymh	紟
ŋəm	ngym	岑琌
ŋəmʔ	ngymq	儼{美豔}
ŋəp	ngyp	圾岌馺趿業{業業，高大雄壯}
həm	hym	歆廞
həp	hyp	翕歙潝闟吸𨝫
wəm	wym	熊
ʔəm	qym	音
ʔəmʔ	qymq	喑
ʔəp	qyp	邑悒
prəp	pryp	鴔{鵖鴔}
pʰrəmʔ	phrymq	品
brəp	bryp	鵖{鵖鴔}
trəm	trym	椹
trəmʔ	trymq	戡
trəmh	trymh	揕
tʰrəmʔ	thrymq	趻
drəm	drym	鈂莐
drəmh	drymh	鴆
nrəm	nrym	鵀
nrəmh	nrymh	賃
tsrəmh	tsrymh	譖
tsrəp	tsryp	戢濈
tsʰrəm	tshrym	僭{差失；虛僞}
tsʰrəmh	tshrymh	讖
dzrəp	dzryp	䯂
srəm	srym	槮森㺑蔘
srəp	sryp	澀歰
l̥rəm	lhrym	闖琛
r̥əm	rhym	綝郴
krəm	krym	禁襟衿唫{噤}
kʰrəp	khryp	泣湆㬤
grəmʔ	grymq	噤
grəp	gryp	及鷑
ŋrəm	ngrym	吟
ŋ̊rəp	nghryp	鈒
tˤəm	t'ym	酖妉湛{喜樂；沉湎}愖
tˤəmʔ	t'ymq	黕
tˤəp	t'yp	答荅{答}畣
tʰˤəmʔ	th'ymq	醓黮
tʰˤəp	th'yp	荅{相忘貌}
nˤəm	n'ym	南男楠柟{楠}枏
nˤəmʔ	n'ymq	腩湳
nˤəp	n'yp	納軜靹䪏
tsˤəm	ts'ym	鐕
tsˤəmʔ	ts'ymq	寁
tsˤəp	ts'yp	噆帀匝
tsʰˤəm	tsh'ym	慘
tsʰˤəmʔ	tsh'ymq	憯朁
dzˤəm	dz'ym	蠶
dzˤəp	dz'yp	雜襍
sˤəm	s'ym	蔘毿
sˤəmʔ	s'ymq	糝糂槮{捕魚具}
lˤəm	l'ym	覃蟫譚𧂇藫鐔{鐔成，縣}
lˤəmʔ	l'ymq	禫萏窞嘾
lˤəp	l'yp	沓遝誻讋{讋諄，中民亂}慴曡疊譶
l̥ˤəm	lh'ym	探
l̥ˤəmʔ	lh'ymq	嗿
l̥ˤəp	lh'yp	嚃濕{漯}漯
slˤəp	sl'yp	靸
rˤəm	r'ym	惏婪
rˤəp	r'yp	搚
kˤəm	k'ym	雂蜬
kˤəmʔ	k'ymq	感鱤贛{水名}㔶𧆐
kˤəmh	k'ymh	詌淦{水名}
kˤəp	k'yp	鴿蛤𧊧㪉韐閤鮯㠷匌㭘
kʰˤəm	kh'ym	龕
kʰˤəmʔ	kh'ymq	坎埳欿鍖顑錎{連環}
kʰˤəmh	kh'ymh	勘
kʰˤəp	kh'yp	溘厒
gˤəm	g'ym	函涵顄䶃
gˤəmʔ	g'ymq	竷菡頷撼蜭
gˤəmh	g'ymh	憾戇
gˤəp	g'yp	合郃
ŋˤəp	ng'yp	業{業業，危懼}
hˤəm	h'ym	欦
hˤəp	h'yp	欱
ʔˤəm	q'ym	韽鵪
ʔˤəp	q'yp	唈姶罨罯鞥搕
dzˤrəmʔ	dz'rymq	瀺
sˤrəm	s'rym	摻
kˤrəm	k'rym	瑊緘椷
kˤrəmʔ	k'rymq	減
kˤrəp	k'ryp	鞈𩊆袷{夾衣}
kʰˤrəp	kh'ryp	䁍
gˤrəm	g'rym	咸諴鹹醎
gˤrəmh	g'rymh	陷䱤錎{陷}
gˤrəp	g'ryp	洽祫
ŋˤrəm	ng'rym	羬麙碞
ʔˤrəp	q'ryp	凹䆟
po	po	跗柎𩿧
poʔ	poq	府俯俛{俯}腑柎{弓弝兩側貼附的骨片}拊
poh	poh	付軵
pʰo	pho	泭
pʰoʔ	phoq	弣䋨
pʰoh	phoh	赴仆訃
bo	bo	鳧符苻
boʔ	boq	附腐胕坿
boh	boh	鮒祔蚹駙附{親附}柎{木片}
moʔ	moq	侮
moh	moh	騖務霧婺𦎦
to	to	朱珠侏鴸硃
toʔ	toq	主枓麈斗{勺}
toh	toh	注紸殶澍㹥屬{成套的鎧甲}
stoh	stoh	戍
tʰo	tho	姝樞{門的轉軸；樞紐}
do	do	殳杸銖殊洙茱{茱萸}
doʔ	doq	樹{樹立，動詞}豎竪
doh	doh	樹{樹木；屏風，名詞}
no	no	濡儒襦鱬懦偄懧臑鑐{襦}蝡蠕
noʔ	noq	醹乳
noh	noh	孺擩{染}㨎乳{分娩、產子}
n̥o	nho	需繻緰嬬𪋯
tso	tso	諏娵
tsoh	tsoh	足{使滿足，增益；過分}
tsʰo	tsho	趨趣{趨}
tsʰoʔ	tshoq	取
tsʰoh	tshoh	趨{趣}娶
dzoʔ	dzoq	聚
dzoh	dzoh	聚{積蓄；謂眾；村落。名詞}
so	so	須鬚嬃𩓣
soʔ	soq	𦄼
lo	lo	俞愉逾瑜踰渝揄{揮動}榆羭蕍蝓窬{踰}覦牏
loʔ	loq	瘉愈
loh	loh	喻諭籲
l̥o	lho	輸鄃
l̥oh	lhoh	隃腧䩱輸{所輸}
sloh	sloh	續{系靷的環}
ro	ro	婁{邾婁}鷜漊摟{牽引，挾持}鏤{屬鏤，劍名}
roʔ	roq	僂縷𧃒簍婁{拴系}
roh	roh	屢
jo	jo	臾腴螸萸{茱萸}諛庾{薜庾，草名}
joʔ	joq	窳楰庾斔瘐斞裕貐
joh	joh	慾
ko	ko	拘駒跔捄{盛土於器}俱眗
koʔ	koq	枸椇痀
koh	koh	句{句子}泃邭
kʰo	kho	軀驅區敺
kʰoʔ	khoq	竘蝺曲{曲遇，地名}
kʰoh	khoh	驅{鞭馬前進}
go	go	絇劬翑鼩斪鴝朐葋
goh	goh	具
ŋo	ngo	禺愚隅嵎喁湡
ŋoʔ	ngoq	寓
ŋoh	ngoh	遇
hoʔ	hoq	煦䧁姁
hoh	hoh	酗呴昫休{燠休}
ʔo	qo	鰸
ʔoʔ	qoq	傴饇嫗{養育；和悅}
ʔoh	qoh	飫嫗{老年婦女}燠{燠休}
tro	tro	株誅跦邾鴸袾蛛鼄𧑤
troʔ	troq	拄柱{支撐；柱夫，草名}
troh	troh	駐誅{名詞}
tʰro	thro	貙
dro	dro	趎廚躕祩
droʔ	droq	柱砫
droh	droh	住{停留}
tsʰro	tshro	芻蒭犓㷅
dzro	dzro	雛鶵
sroʔ	sroq	數{計算、分辨；數說；數落；稱道}藪棷{藪}籔
sroh	sroh	數
kroh	kroh	屨
kʰro	khro	嶇
groʔ	groq	窶貗
pˤoʔ	p'oq	掊{擊}
pʰˤoʔ	ph'oq	剖棓
bˤo	b'o	抔掊{扒開、搜取}箁
bˤoʔ	b'oq	部蔀瓿培{培塿}
mˤo	m'o	鍪蝥𩭾𨡭
mˤoh	m'oh	愗{怐愗，愚昧}䓮瞀
tˤo	t'o	兜剅
tˤoʔ	t'oq	斗㪷
tˤoh	t'oh	鬬鬭闘鬥
tʰˤoʔ	th'oq	黈
tʰˤoh	th'oh	㰯
dˤo	d'o	投頭
dˤoʔ	d'oq	𨪐
dˤoh	d'oh	豆脰浢郖逗𩊪
nˤo	n'o	獳
nˤoh	n'oh	鎒
tsˤo	ts'o	掫
tsˤoʔ	ts'oq	走奏
tsʰˤoʔ	tsh'oq	趣{周代掌管王馬的官員}
tsʰˤoh	tsh'oh	輳腠湊蔟{太蔟，樂律名}
sˤoʔ	s'oq	嗾
sˤoh	s'oh	欶嗽
lˤo	l'o	歈䤅
lˤoh	l'oh	竇窬{竇}
l̥ˤo	lh'o	偷媮
rˤo	r'o	婁{婁宿；母豬；婁婁，空}蔞膢鞻髏䣚
rˤoʔ	r'oq	螻婁{部婁，小土山}䅹甊塿
rˤoh	r'oh	漏陋瘻鏤
C.rˤo	C.r'o	樓
kˤo	k'o	句{彎曲}勾鉤鈎枸{彎曲、盤錯}緱{緱氏，山名}
kˤoʔ	k'oq	苟笱耇耈狗垢
kˤoh	k'oh	彀雊姤㝅軥呴{野雞鳴叫}鴝{雉鳴}
kʰˤo	kh'o	彄摳
kʰˤoʔ	kh'oq	釦叩扣𨙫
kʰˤoh	kh'oh	寇鷇袧怐{怐愗，愚昧}溝{溝瞀，愚昧}
gˤo	g'o	侯鍭𦞈猴喉鄇瘊翭篌緱{刀劍柄}
gˤoʔ	g'oq	後后郈詬{謑詬，辱罵}
gˤoh	g'oh	候堠餱後{落於後，及物}
ŋˤo	ng'o	齵
ŋˤoʔ	ng'oq	偶耦藕腢
hˤoʔ	h'oq	蚼
hˤoh	h'oh	訽詬
ʔˤo	q'o	區{量器}歐甌嘔{嘔夷}謳鏂䳼熰樞{刺榆}櫙蓲鷗
ʔˤoʔ	q'oq	毆嘔{吐}
mˤro	m'ro	蟊
tˤroh	t'roh	晝咮{鳥喙；柳宿}噣{鳥喙；畢宿}
tsˤro	ts'ro	鄒騶𨃘棸陬緅郰鄹菆棷{木名}
tsˤroʔ	ts'roq	掫
tsˤroh	ts'roh	縐皺
tsʰˤro	tsh'ro	鯫
tsʰˤroʔ	tsh'roq	𩋄
dzˤroh	dz'roh	驟
sˤroʔ	s'roq	盨
sˤroh	s'roh	漱
kˤro	k'ro	溝篝韝
kˤroʔ	k'roq	茩
kˤroh	k'roh	冓媾覯遘搆構購
kʰˤroʔ	kh'roq	口
kʰˤroh	kh'roh	詬{喫詬，強壯}滱
gˤroʔ	g'roq	厚缿
gˤroh	g'roh	逅厚{厚度}
ʔˤro	q'ro	嘔{唲嘔}
ʔˤroh	q'roh	漚
poŋ	pong	封葑
pʰoŋ	phong	鋒烽蜂𧒒蠭峰峯夆
pʰoŋʔ	phongq	捧
pʰoŋh	phongh	丰{容貌豊潤}
boŋ	bong	逢縫{縫合}漨
boŋʔ	bongq	奉
boŋh	bongh	縫{隙}俸
m̥ok	mhok	勖勗
toŋ	tong	鍾鐘籦妐
toŋʔ	tongq	種腫踵
toŋh	tongh	種{種植}
tok	tok	屬燭灟馵
stoŋ	stong	舂摏
stok	stok	束
tʰoŋ	thong	衝憧罿𠟍
tʰok	thok	觸歜斶臅鸀{傳說怪鳥，見山海經}
doŋʔ	dongq	尰
dok	dok	屬{種類；附屬；親屬}蜀蠋襡{衣}
noŋ	nong	茸襛穠戎{蒙戎，蓬鬆；雜亂}
noŋʔ	nongq	冗宂
nok	nok	辱溽蓐鄏𪑾縟褥
tsoŋ	tsong	蹤從{直，從橫}縱{直，縱橫}
tsoŋh	tsongh	縱{放縱}
tsok	tsok	足哫
tsʰoŋ	tshong	從{從容}樅
tsʰoŋʔ	tshongq	衳
tsʰok	tshok	促趨{促}趣{促}數{稠密}
dzoŋ	dzong	從{隨從}
dzoŋh	dzongh	從{放從；從者}
soŋ	song	蜙
soŋʔ	songq	竦聳悚駷
sok	sok	涑
loŋ	long	用庸墉鏞傭{僱傭}滽鱅鄘䗤
loŋʔ	longq	甬勇踊踴蛹俑涌湧𧗴桶{量器，守六斗}
loŋh	longh	用{役使、施展；治理、管理}
l̥ok	lhok	粟
sloŋh	slongh	誦
slok	slok	續藚
mloŋ	mlong	鱅
mlok	mlok	贖
roŋ	rong	壟籠{籦籠}壠
roŋʔ	rongq	隴
rok	rok	錄綠菉騄
C.roŋ	C.rong	龍
joŋ	jong	容蓉溶{容貌；溶與；溶㵝}鎔
joŋʔ	jongq	搈
jok	jok	欲浴鵒鋊
sjoŋ	sjong	頌松訟鬆
sjok	sjok	俗
koŋʔ	kongq	拱鞏栱拲蛬
kok	kok	輂䡞挶梮
kʰoŋ	khong	銎
kʰoŋʔ	khongq	恐
goŋ	gong	邛卭輁蛩
goŋh	gongh	共{同}
gok	gok	局
ŋoŋ	ngong	顒鰅遇{曲遇，地名}
ŋok	ngok	玉
ŋ̊ok	nghok	頊
hoŋ	hong	凶𣧑訩匈洶汹哅胷胸
hoŋʔ	hongq	兇
ʔoŋ	qong	雍噰澭邕雝灉壅饔𢋊廱癰癕𧴗𢀄
ʔoŋʔ	qongq	擁臃
troŋʔ	trongq	冢塚
trok	trok	斸欘钃瘃孎
droŋ	drong	重{重疊}穜
droŋʔ	drongq	重{厚重}
droŋh	drongh	重{重量；加重；輜重；再}
drok	drok	躅䠱
nroŋ	nrong	醲
tsrok	tsrok	捉
tsʰroŋ	tshrong	窗鏦
dzrok	dzrok	浞
sroŋ	srong	雙
srok	srok	數{親密；屢次；數數，迫切}
lroŋʔ	lrongq	鮦
l̥roŋ	lhrong	傭{公平}
r̥oŋʔ	rhongq	寵
kroŋ	krong	共供恭龔
kʰrok	khrok	曲
grok	grok	跼
ŋrok	ngrok	獄
pˤoŋʔ	p'ongq	菶唪琫鞛䋽
pˤok	p'ok	樸{未加工的木材}濮卜鳪纀蹼轐
pʰˤok	ph'ok	撲扑
bˤoŋ	b'ong	逢{逢逢，鼓聲}蓬塳塜
bˤok	b'ok	僕鏷
mˤoŋ	m'ong	蒙矇幪濛冡髳{覭髳，草木叢生貌}饛𢄐
mˤoŋʔ	m'ongq	蠓
mˤoŋh	m'ongh	懞
mˤok	m'ok	木蚞霂沐鶩楘
tˤoŋ	t'ong	東凍涷蝀棟{木名}
tˤoŋʔ	t'ongq	蕫董
tˤoŋh	t'ongh	棟䍶湩
tʰˤoŋ	th'ong	畽
dˤoŋ	d'ong	童僮瞳潼
dˤoŋʔ	d'ongq	動
dˤoŋh	d'ongh	慟
dˤok	d'ok	獨𤠢罜鸀{山鳥}韣髑襡{收藏}
nˤoŋ	n'ong	膿濃噥
nˤok	n'ok	耨
tsˤoŋ	ts'ong	豵椶翪猣朡惾緵艐緫{絲八十根}鬷
tsˤoŋʔ	ts'ongq	總緫摠揔蓯𢊕縱{縱縱，急遽貌}稯
tsˤok	ts'ok	鏃
tsʰˤoŋ	tsh'ong	聰葱蔥怱𦇎鏓
tsʰˤoŋh	tsh'ongh	憁
tsʰˤok	tsh'ok	蔟{鳥巢}瘯
dzˤoŋ	dz'ong	叢䕺藂
dzˤok	dz'ok	族
sˤoŋh	s'ongh	送
sˤok	s'ok	速遫蹐趚樕餗蔌遬藗㯈觫
lˤoŋ	l'ong	同桐銅峒侗{共同；幼稚}秱筩筒犝
lˤoŋh	l'ongh	衕恫{憁恫}洞
lˤok	l'ok	瀆犢牘讀讟櫝覿䢱殰黷匵豄韇𦢌嬻
l̥ˤoŋ	lh'ong	通恫狪
l̥ˤoŋʔ	lh'ongq	侗{長大、通達無掛礙}
l̥ˤoŋh	lh'ongh	痛
l̥ˤok	lh'ok	禿
rˤoŋ	r'ong	礱蘢櫳嚨聾籠龐{龐龐，高而壯}
rˤoŋʔ	r'ongq	弄籠{盛土器}
rˤok	r'ok	鹿漉淥麓蔍螰摝祿禄琭睩盝轆逯廘
C.rˤoŋ	C.r'ong	蠪
kjoŋ	kjong	公
kjok	kjok	谷𤞞
kˤoŋ	k'ong	工功攻釭
kˤoŋh	k'ongh	貢贛{同“貢”，端木賜之字}䇨
kˤok	k'ok	穀榖轂
kʰˤoŋ	kh'ong	空悾崆𢃐
kʰˤoŋʔ	kh'ongq	孔
kʰˤoŋh	kh'ongh	控空{窮困；貧乏}
kʰˤok	kh'ok	哭䵈䍍𪍠
gˤoŋ	g'ong	訌紅虹𧈫洪洚鴻
gˤoŋh	g'ongh	鬨
gˤok	g'ok	斛縠觳{斛}螜
hˤoŋ	h'ong	烘
hˤok	h'ok	豰㺉
ʔˤoŋ	q'ong	翁
ʔˤoŋʔ	q'ongq	蓊
ʔˤoŋh	q'ongh	罋甕瓮
ʔˤok	q'ok	屋剭
pˤroŋ	p'rong	邦
pˤrok	p'rok	剝
pʰˤroŋ	ph'rong	肨
pʰˤrok	ph'rok	朴樸{棫樸；樸樕，小木}璞墣
bˤroŋ	b'rong	龐逢{姓}逄胮
bˤroŋʔ	b'rongq	玤𢈦蚌蜯{蚌}䰷
mˤroŋ	m'rong	尨厖庬哤蛖駹
tˤrok	t'rok	琢{雕刻；挑選}啄噣椓涿諑斀斲斵
tʰˤroŋ	th'rong	憃瞳{無知直視貌}
tʰˤrok	th'rok	擉
dˤroŋ	d'rong	橦幢撞
dˤrok	d'rok	濁鐲
dzˤrok	dz'rok	齺鷟
sˤrok	s'rok	漱{吮吸}
kˤroŋ	k'rong	江杠矼
kˤroŋʔ	k'rongq	講港
kˤrok	k'rok	角桷瑴珏斠
kʰˤroŋ	kh'rong	跫椌腔控{敲打}
kʰˤrok	kh'rok	愨慤觳殼
gˤroŋ	g'rong	瓨
gˤroŋʔ	g'rongq	項
gˤroŋh	g'rongh	衖闀巷
gˤrok	g'rok	确埆
ŋˤrok	ng'rok	鸑嶽岳
hˤroŋ	h'rong	舡
ʔˤrok	q'rok	渥喔握幄腛
pos	pos	祓{除}
pʰos	phos	肺杮
bos	bos	吠鼣
tojʔ	tojq	箠捶棰
tos	tos	贅
doj	doj	垂厜{厜㕒，山頂}倕陲
dojʔ	dojq	菙
dojh	dojh	睡
nojʔ	nojq	繠蘂蕊
nos	nos	蚋
n̥ojh	nhojh	挼
tsʰos	tshos	脃脆毳膬竁
lojʔ	lojq	䝐㨊
los	los	銳
l̥os	lhos	說{遊說；停止}帨稅涚裞祱挩{拭}䬽喙餯
l̥oj	lhoj	墮{毀壞；輸送}隋{祭}綏{祭}隳䜐
l̥ojh	lhojh	隋{殘剩的祭品}
slojʔ	slojq	髓瀡
sloj	sloj	隨
rojʔ	rojq	累{堆積、重疊}絫
rojh	rojh	累{連累；託付；勞累；憂患}
C.roj	C.roj	羸
j̊oj	jhoj	吹炊
j̊ojh	jhojh	吹{名詞，吹奏樂器；樂器}
kojʔ	kojq	蛫佹詭祪垝姽觤恑
gojʔ	gojq	跪䣀
ŋoj	ngoj	危峗洈㕒
ŋojʔ	ngojq	頠
ʔoj	qoj	倭
trojh	trojh	諈
tros	tros	綴{連綴；點綴}錣{鐵針}餟
droj	droj	錘膇
drojh	drojh	甀硾縋腄
nrojh	nrojh	諉
tsʰroj	tshroj	衰{動詞，差別、次第；衰減}
pˤos	p'os	芾{官服上的蔽膝}𨙶
pʰˤos	ph'os	沛{豐沛}
bˤos	b'os	拔{盡；茂盛}旆
tˤoj	t'oj	𨹄
tˤojʔ	t'ojq	埵𦀉
tˤos	t'os	祋
tʰˤojh	th'ojh	唾
n̥ˤojʔ	nh'ojq	妥
tsˤoj	ts'oj	挫侳
tsˤojh	ts'ojh	蓌
tsˤos	ts'os	最
tsʰˤoj	tsh'oj	剉
tsʰˤojʔ	tsh'ojq	脞
tsʰˤos	tsh'os	竄
dzˤoj	dz'oj	痤銼㛗
dzˤojʔ	dz'ojq	坐
dzˤojh	dz'ojh	座坐{犯罪；連坐；爭訟}
dzˤos	dz'os	蕞
sˤojʔ	s'ojq	鎖瑣璅{鎖}
lˤojʔ	l'ojq	惰墮{惰}墯嶞鬌嫷𨬍䲊
lˤos	l'os	兌奪{狹路}
l̥ˤojʔ	lh'ojq	橢㯐媠
l̥ˤos	lh'os	駾蛻稅{喪禮追服；改變}毤脫{舒適、舒緩}
rˤoj	r'oj	騾鸁
rˤojʔ	r'ojq	蓏㒩臝裸倮
rˤos	r'os	䮑
C.rˤoj	C.r'oj	蠃
kˤoj	k'oj	戈鍋𩰫祼
kˤojʔ	k'ojq	果菓裹蜾
kˤos	k'os	鄶澮
kʰˤoj	kh'oj	科
kʰˤojʔ	kh'ojq	顆
kʰˤojh	kh'ojh	課
gˤoj	g'oj	禾和龢盉𨨛
gˤojʔ	g'ojq	夥
gˤojh	g'ojh	和{應和，附和}
ŋˤojʔ	ng'ojq	㛂
ŋˤojh	ng'ojh	臥
ʔˤoj	q'oj	涹
ʔˤos	q'os	薈
pˤros	p'ros	拜
tsˤroj	ts'roj	髽
tsʰˤros	tsh'ros	嘬
kˤroj	k'roj	騧果{婐，侍女}媧
kˤrojʔ	k'rojq	剮
kʰˤros	kh'ros	噲
gˤrojʔ	g'rojq	踝髁輠
tor	tor	顓
torʔ	torq	𦓝
torh	torh	惴
dor	dor	遄
dorʔ	dorq	瑞𡭐
tˤor	t'or	端耑
tˤorʔ	t'orq	短揣朵{朵頤}踹
tʰˤor	th'or	貒湍
pot	pot	髮紱帗
bon	bon	煩笲
bonʔ	bonq	飯{進食}軬
bonh	bonh	飯{一頓飯}飰
mon	mon	樠
mot	mot	襪韤
ton	ton	專塼{磚}磚鄟{鄭國城門名}諯篿
tonʔ	tonq	剸剬
tot	tot	茁
tʰonʔ	thonq	喘
tʰot	thot	歠嚽
don	don	輲歂圌篅膞
donʔ	donq	鱄鄟{國名}腨
dot	dot	啜
non	non	瓀擩{祭}壖堧撋
nonʔ	nonq	耎輭軟礝氄㼱
not	not	焫爇
tson	tson	鐫
tsonʔ	tsonq	臇
tsot	tsot	蕝
tsʰon	tshon	銓荃痊駩悛
dzon	dzon	全牷
dzonʔ	dzonq	雋
dzot	dzot	絶絕
sonʔ	sonq	選䠣
sonh	sonh	選{選得的人才；整齊}
sot	sot	雪
lon	lon	蝝緣
lonh	lonh	緣{衣緣}掾
lot	lot	閱說{悅；敬重}悅
l̥ot	lhot	說
ron	ron	癵
ronʔ	ronq	臠
ronh	ronh	戀
rot	rot	埒蛶鋝脟
C.ron	C.ron	攣聯
C.ronʔ	C.ronq	孌
jon	jon	沿鉛鈆
jonʔ	jonq	兖兗萒沇
j̊on	jhon	穿
mjon	mjon	船
konʔ	konq	卷𧯦𨹵
konh	konh	韏
kot	kot	蕨𠎮獗瘚劂
kʰonʔ	khonq	裷綣拳{拳拳，緊握}卷{卷石}圈{圈豚，徐步趨行貌}
kʰonh	khonh	券絭
gonʔ	gonq	圈{獸圈}錈蔨
got	got	鷢𩪗
ŋon	ngon	元沅芫黿杬蚖螈原{本源；推究}源嫄騵獂
ŋonʔ	ngonq	阮盶邧
ŋonh	ngonh	願𩕾愿傆
ŋot	ngot	軏䡇
ʔon	qon	冤寃蒬宛{楚地}鴛怨{仇怨；責備；引致怨恨的對象}涴𩝸葾
ʔonʔ	qonq	菀婉宛𪂧綩
ʔonh	qonh	怨{悲傷；別離；違背}苑
ʔot	qot	黦𧯡
pronh	pronh	變
bronh	bronh	卞弁抃閞
tronʔ	tronq	轉
tronh	tronh	轉{裝衣甲的口袋}
trot	trot	掇{短}惙輟畷剟綴{停止；拘束}罬啜{泣}錣{計數的籌碼}
dron	dron	傳
dronʔ	dronq	縳
dronh	dronh	傳{書傳；驛}
tsron	tsron	跧
dzronʔ	dzronq	僎{撰}撰
dzronh	dzronh	饌籑譔輇
sron	sron	𨏉
srot	srot	刷
lron	lron	椽
lronʔ	lronq	瑑篆腞{瑑}
l̥ronh	lhronh	鶨
kronʔ	kronq	卷{卷耳}菤
kronh	kronh	眷睠𥆞{眷}飬帣桊
kʰron	khron	圈{飲酒器}棬卷{冠卷，帽緣；地名}䌯弮
gron	gron	拳惓卷{彎曲；柔弱}捲觠踡蜷犈
gronh	gronh	倦勌
pˤot	p'ot	跋{踩踏}
bˤot	b'ot	犮跋{草行}柭胈
mˤonʔ	m'onq	滿
tˤon	t'on	竱
tˤonʔ	t'onq	斷{使動，折斷；斷絕；斬殺；區分}
tˤonh	t'onh	段鍛碫{或訛作“碬”}煅腶斷{判斷；一定；斷斷，專一}
tˤot	t'ot	掇{拾取}
tʰˤon	th'on	䵎
dˤon	d'on	團慱漙摶鷒鷻敦{聚攏；圓形}塼{摶}
dˤonʔ	d'onq	斷{自動，片段之物}
dˤonh	d'onh	椴毈
nˤon	n'on	濡{灤河}
nˤonʔ	n'onq	煗渜餪
nˤonh	n'onh	稬糯
tsˤon	ts'on	鑽
tsˤonʔ	ts'onq	纂纘酇
tsˤonh	ts'onh	鑽{鑽孔工具}䂎
tsˤot	ts'ot	繓撮{會撮，頸椎；一說髮髻}
tsʰˤon	tsh'on	爨{燒火做飯}
tsʰˤonh	tsh'onh	爨{燒火做飯的人；灶；楚曆十一月}
tsʰˤot	tsh'ot	撮
dzˤon	dz'on	欑櫕巑
dzˤonh	dz'onh	攢
sˤon	s'on	酸痠狻
sˤonʔ	s'onq	算{計算；謀劃}篹匴
sˤonh	s'onh	算{數目；算疇}筭蒜巽
lˤot	l'ot	奪𡙸鮵挩{打}痥脫{逃走；脫落，自動}
l̥ˤonh	lh'onh	彖褖
l̥ˤot	lh'ot	脫{解脫，他動}侻梲莌
rˤon	r'on	羉巒灓鑾
rˤonh	r'onh	亂
rˤot	r'ot	捋
C.rˤon	C.r'on	欒孿鸞
C.rˤonʔ	C.r'onq	卵
kjon	kjon	貫{連、通}
kjonh	kjonh	貫毌實{見《易·象傳》}
kˤon	k'on	冠{帽子}莞棺
kˤonʔ	k'onq	盥筦管{管狀物；專管}琯脘
kˤonh	k'onh	館灌冠{戴冠；冠禮；居首位}棺{以棺殮屍}懽{懽懽，憂懼無處訴}涫
kˤot	k'ot	劊
kʰˤon	kh'on	窾
kʰˤonʔ	kh'onq	款梡
kʰˤot	kh'ot	闊{契闊，勤苦}
gˤon	g'on	完院丸{小球}芄紈雚雈萑{蘆類}
gˤonʔ	g'onq	浣澣鯇睆{渾圓}
ŋˤon	ng'on	刓园抏岏䬧
ŋˤonʔ	ng'onq	輐{輐斷，圓轉無棱角}魭{魭斷，圓轉無棱角}
ŋˤonh	ng'onh	翫玩忨
ʔˤon	q'on	婠
ʔˤonh	q'onh	惋
bˤrot	b'rot	拔
mˤron	m'ron	蠻𪈿
tˤrot	t'rot	鵽窡
tsʰˤronh	tsh'ronh	篡
kˤron	k'ron	關
kˤronh	k'ronh	倌丱卝
gˤron	g'ron	患䍺懽{患}
gˤronʔ	g'ronq	睆{光滑、明亮}皖莞{微笑}
gˤronh	g'ronh	豢
ŋˤron	ng'ron	頑
ŋˤronh	ng'ronh	薍
ŋˤrot	ng'rot	刖
puʔ	puq	缶缹
puh	puh	鍑
pʰu	phu	孚莩郛俘稃垺𰕊{安撫}
pʰuh	phuh	覆{蓋、遍及}罦
bu	bu	浮蜉烰琈桴枹{鼓槌；术}
buʔ	buq	阜蛗𩢿
buh	buh	復{反復；回復}覆{埋伏}椱
mu	mu	矛牟侔鴾眸蛑麰雺恈
muʔ	muq	牡戊茂
muh	muh	楙懋袤
tu	tu	舟州洲
tuʔ	tuq	帚箒鯞
tuh	tuh	祝{祝禱；詛咒，動詞}
stu	stu	收{車後橫木}
stuʔ	stuq	守狩獸
stuh	stuh	守{戍守，及物；職守}
tʰu	thu	犨犫臭{氣味}
tʰuʔ	thuq	糗魗醜{類；眾；相同}
tʰuh	thuh	臭{香味；臭味}
du	du	雔讎{仇敵，仇恨；用}讐醻{勸酒，敬酒}
duʔ	duq	壽受綬讎{對方，對手；應驗}𨞪
duh	duh	授售讎{報答，回應}酬{酬謝}
nu	nu	柔蹂蝚騥鶔㹛擾{安撫；馴養}鞣
nuʔ	nuq	輮楺沑耰櫌
nuh	nuh	揉肉{豐滿；玉器的邊}
n̥u	nhu	羞
tsu	tsu	遒
tsuʔ	tsuq	酒
tsuh	tsuh	僦
tsʰu	tshu	蟗𪓰
dzu	dzu	酋遒鰌蝤{蝤蠐}慒𧤕
dzuʔ	dzuq	就{成功，完成；終}
dzuh	dzuh	就
suʔ	suq	糔
suh	suh	宿{拖延、停留；夜間守衛；星}
lu	lu	由{動植物名；由由，愉悅}悠{憂思貌；遼闊無際}油{盛興；自然；油油，和悅恭謹}舀抭揄{抌}抌
luʔ	luq	牖誘莠秀{開花，抽穗，結實}羑褎琇
luh	luh	秀{特異，優秀}
l̥uʔ	lhuq	首手
l̥uh	lhuh	首{朝著}繡{錦繡}
l̥u	lhu	羞{進獻；珍饈}
slu	slu	囚鮂苬
sluʔ	sluq	袖
sluh	sluh	牰岫
ru	ru	留鶹劉飂流旒裗瘤霤騮駵摎{尋求；擇取}榴瀏𤠑𦃓
ruʔ	ruq	柳罶懰䶉㧕
ruh	ruh	窌塯溜廇餾留{等待；謂搗土修築}
ju	ju	斿遊游蝣猷猶莤蕕卣輶楢庮槱眈{虎視眈眈}冘揂
juʔ	juq	酉猷{道，法則；謀略，計劃}猶{欺詐，責怪；謀略，計劃}
j̊uʔ	jhuq	醜
hjuʔ	hjuq	朽㱙
hjuh	hjuh	畜{家畜}
ku	ku	鳩救{阻止；援救}
kuʔ	kuq	九韭究{窮盡；周遍}
kuh	kuh	救{醫治；安慰、寬解；補救}廄廐究{研究、謀劃；究究，相互憎惡貌}𠣿
gu	gu	求蛷梂逑絿球銶賕捄{長而曲}脙仇朹犰䊵艽鼽厹䣇
guʔ	guq	舅咎麔𤷑
guh	guh	鯦
hu	hu	休烋鵂髤髹庥貅咻
huh	huh	嗅
ʔu	qu	憂優懮瀀鄾嚘麀纋
ʔuh	quh	憂{憂患、禍患，名詞}
mruh	mruh	貿鄮
tru	tru	譸籌輈侜
truʔ	truq	肘疛
dru	dru	𠷎躊疇裯幬儔
druʔ	druq	紂
druh	druh	酎
nruʔ	nruq	紐鈕杻狃禸𠘯莥𨙺
nruh	nruh	糅
n̥ruʔ	nhruq	丑
tsʰruh	tshruh	簉憱
sru	sru	搜溲{排洩大小便}蒐鄋獀䤹
sruʔ	sruq	叟瞍傁廋廀醙溲{浸泡}
sruh	sruh	瘦
lru	lru	紬{粗綢}
lruh	lruh	宙伷
l̥ru	lhru	抽妯{悲慟}怞紬
l̥ruh	lhruh	抽{拔}
kruʔ	kruq	氿軌軓匭簋厬宄孂
kʰruʔ	khruq	頯{高亢顯露}
gru	gru	逵馗頄
pˤu	p'u	褒襃裒捊𨚔
pˤuʔ	p'uq	寶保葆堡褓䳈鴇駂
pˤuh	p'uh	報
bˤu	b'u	袍
bˤuʔ	b'uq	抱
bˤuh	b'uh	抱{人體胸腹間的部位；懷抱}袍{衣服前襟}
mˤu	m'u	髦{頭髮下垂至眉的一種髮式；西南少數民族名}髳{西南少數民族名}
mˤuh	m'uh	冒帽𪃑
tˤu	t'u	裯{袛裯}
tˤuʔ	t'uq	禂擣搗島禱
tʰˤuʔ	th'uq	討
dˤu	d'u	濤燾檮翢
dˤuʔ	d'uq	翿{舞具，形似雉扇}
dˤuh	d'uh	纛幬{覆蓋}
nˤu	n'u	猱夒獿獶峱媷
nˤuʔ	n'uq	擾腦匘惱
n̥ˤu	nh'u	薅
n̥ˤuʔ	nh'uq	好
n̥ˤuh	nh'uh	好{喜好，名詞；孔}
tsˤu	ts'u	遭糟傮㷮
tsˤuʔ	ts'uq	早棗蚤
tsˤuh	ts'uh	竈灶
tsʰˤuʔ	tsh'uq	草艸慅
tsʰˤuh	tsh'uh	造慥鼜{擊鼓巡夜戒守}糙
dzˤu	dz'u	曹𣍘漕螬
dzˤuʔ	dz'uq	造{製造}皁皂
sˤu	s'u	搔騷鰠溞艘
sˤuʔ	s'uq	埽掃嫂𦺋
sˤuh	s'uh	瘙
lˤu	l'u	綯陶{陶器；和樂；鬱陶；皐陶}蜪騊䛬淘
lˤuʔ	l'uq	道稻蹈
lˤuh	l'uh	導道{導；諂媚}陶{陶陶，驅馳貌}蹈{行走，高蹈}
l̥ˤu	lh'u	滔{水瀰漫}慆搯謟韜弢槄絛縚
rˤu	r'u	牢
rˤuh	r'uh	嫪
C.rˤu	C.r'u	醪
C.rˤuʔ	C.r'uq	老
kʰjuʔ	khjuq	考攷栲
kˤu	k'u	羔皋臯皐槔櫜{收藏弓矢、盔甲的袋子}䓘鼛韟䔌睾
kˤuʔ	k'uq	桕
kˤuh	k'uh	告{上告、祭告}誥郜{國名}禚櫜{收藏}皋{緩慢而拖長的呼喚聲}
kʰˤu	kh'u	𦙷尻
kʰˤuʔ	kh'uq	考{完成；建築物落成}
gˤu	g'u	嗥獋
gˤuʔ	g'uq	浩晧皓昊惢𠕫皞顥
gˤuh	g'uh	𧬁
ŋˤu	ng'u	翱
hˤuʔ	h'uq	旭
ʔˤu	q'u	鏖䥝
ʔˤuʔ	q'uq	媼襖
ʔˤuh	q'uh	奧懊隩
pˤru	p'ru	包枹苞{草木根}
pˤruʔ	p'ruq	飽苞{茂密}
pʰˤru	ph'ru	脬胞{胎衣}
pʰˤruh	ph'ruh	胞{皰}
bˤru	b'ru	庖烰{庖}泡炮炰狍匏㯡
bˤruʔ	b'ruq	鮑
bˤruh	b'ruh	皰
mˤru	m'ru	茅葇{茅}罞昴
mˤruʔ	m'ruq	卯茆
tˤru	t'ru	鵃
tsˤru	ts'ru	抓
tsˤruʔ	ts'ruq	爪
kˤruʔ	k'ruq	攪
kˤruh	k'ruh	窖窌窯覺{睡醒}
kʰˤruʔ	kh'ruq	巧
gˤruh	g'ruh	斅
hˤru	h'ru	虓烋
hˤruh	h'ruh	孝
puk	puk	腹複
pʰuŋ	phung	豐酆灃麷
pʰuŋh	phungh	賵
pʰuk	phuk	覆蝮
buk	buk	蕧輹復{恢復；招魂}
muk	muk	目
tuŋ	tung	眾衆終螽蔠鼨潨潀
tuk	tuk	祝{祭祀時司禮儀的人}𥙐鑄
stuk	stuk	菽叔{拾起}
tʰuŋ	thung	充珫
tʰuk	thuk	俶{作，始；厚}柷琡
duk	duk	孰熟塾
nuŋ	nung	戎駥
nuk	nuk	肉
n̥uŋ	nhung	娀
tsuk	tsuk	蹙䠞顣踧{踧踖，恭敬而不安}蹴戚{戚速}
tsʰuk	tshuk	鼂晁
suŋ	sung	嵩崧
suk	suk	宿夙
luŋ	lung	融肜
luk	luk	儥鬻{儥}
ruŋ	rung	隆
ruk	ruk	穋鵱稑鯥𩣱鼁
C.ruŋ	C.rung	癃
C.ruk	C.ruk	六陸
juk	juk	毓育淯粥{半流質食物}
hjuk	hjuk	畜{養育}慉蓄{收藏，名詞}
kuŋ	kung	宮宫躳躬
kuk	kuk	𦥑匊菊掬鞠踘椈鞫蘜𥷚鵴
kʰuŋ	kung	芎
kʰuk	khuk	麴
guŋ	gung	窮藭
ʔuk	quk	薁蒮燠隩{燠}澳奧{暖；澳}
bruk	bruk	愎
mruk	mruk	睦
truŋ	trung	中忠衷
truŋh	trungh	中{射中；值得；傷害}衷{恰當；中斷}
truk	truk	竹筑築
tʰruŋ	thrung	忡
tʰruk	thruk	蓄{積}滀畜{容納；制止}鄐稸
druŋ	drung	沖盅衶
druŋh	drungh	仲
nruk	nruk	衄忸
dzruŋ	dzrung	崇
sruk	sruk	縮謖蹜
lruŋ	lrung	蟲
lruk	lruk	軸
l̥ruk	lhruk	蓫
mˤuk	m'uk	瑁媢
tˤuŋ	t'ung	冬
tˤuk	t'uk	篤竺督裻錖
tʰˤuŋh	th'ungh	統
dˤuk	d'uk	毒𦺇瑇
nˤuŋ	n'ung	農
tsˤuŋ	ts'ung	宗
tsˤuŋh	ts'ungh	綜宗{作宗主}
tsʰˤuk	tsh'uk	戚{斧；憂愁；親密}鏚慼傶鼜{巡夜戒守所擊之鼓}
dzˤuŋ	dz'ung	琮賨
sˤuŋh	s'ungh	宋
lˤuŋ	l'ung	彤𢥞爞䳋赨
kˤuk	k'uk	告{告訴}梏牿䅵鵠{箭靶}郜{春秋晉邑}
kʰˤuk	kh'uk	酷俈嚳
gˤuk	g'uk	鵠{天鵝，鴻鵠；雕刻象牙}
hˤuk	h'uk	澩
pʰˤruk	ph'ruk	鞄
bˤruk	b'ruk	雹䮀跑{踩踏}
kˤruŋh	k'rungh	降絳袶
kˤruk	k'ruk	覺
kʰˤruk	kh'ruk	礐
gˤruŋ	g'rung	降
gˤruk	g'ruk	學觷
ʔˤruk	q'ruk	鷽
pus	pus	沸{沸騰}芾{小；蔽芾，小而茂密}
pʰus	phus	費
tuj	tuj	隹鵻騅錐萑{茺蔚，益母草}
tujʔ	tujq	準{平；準繩；測量；鼻子}
stujʔ	stujq	水
tʰus	thus	出{使出}
duj	duj	誰脽
nuj	nuj	蕤綏{旗}緌桵俀
n̥uj	nhuj	綏䅗夊
tsus	tsus	醉檇
tsʰus	tshus	翠
dzus	dzus	萃瘁悴顇
sus	sus	粹誶賥睟祟
luj	luj	遺壝𧔥
lujʔ	lujq	遺{遺遺，隨行}唯{唯唯，隨行}
l̥us	lhus	邃
slus	slus	遂檖穟隧燧鐩禭襚璲繸旞
ruj	ruj	纍虆蔂畾儽傫藟縲鸓㶟嫘樏欙㹎
rujʔ	rujq	壘櫐耒誄
C.rus	C.rus	類禷
kujʔ	kujq	鬼
kujh	kujh	餽{祭鬼}
kus	kus	瞶貴
gus	gus	蕢{赤莧}
ŋuj	nguj	巍犩
ŋujh	ngujh	魏
ʔuj	quj	威蝛畏隈萎痿葳
ʔujʔ	qujq	磈
ʔus	qus	慰蔚犚熨螱褽罻
truj	truj	追
trus	trus	轛
druj	druj	椎顀
sruj	sruj	衰{形容詞，衰微，衰老，衰弱}榱涒
lrus	lrus	墜
srus	srus	率{率領；表率；勸誡；一般}帥
krujh	krujh	愧媿騩
kʰruj	khruj	蘬
gruj	gruj	夔𧢦犪
grujh	grujh	饋{贈送}餽{贈送；祭祀}
grus	grus	饋{進食；飲食；祭祀}餽{進食；飲食}櫃樻匱簣鞼蕢{草織的盛器}
bˤus	b'us	孛悖𢨋旆{旆旆，茂盛}㫲
mˤus	m'us	昧
tˤuj	t'uj	堆敦{治理；雕刻；投擲；敦彼}追{冠名；雕刻}
tʰˤuj	th'uj	推蓷啍{啍啍，車行聲}
dˤuj	d'uj	魋㢑
dˤujh	d'ujh	憝譈
nˤujʔ	n'ujq	餧餒
tsˤus	ts'us	晬
tsʰˤuj	tsh'uj	崔縗
tsʰˤujʔ	tsh'ujq	漼
tsʰˤus	tsh'us	倅淬啐焠
dzˤuj	dz'uj	摧
dzˤujʔ	dz'ujq	罪辠
sˤuj	s'uj	蓑
sˤus	s'us	碎
lˤuj	l'uj	穨頹頽蘈㿗㿉僓隤
lˤus	l'us	隊
l̥ˤuj	lh'uj	藬
rˤuj	r'uj	雷靁罍儡{喪敗}𤴇𡔁
rˤujʔ	r'ujq	磊礨磥灅頛𨹫𨻌
rˤujh	r'ujh	䣂櫑{𥣬}𥣬
rˤus	r'us	蘱纇
kˤuj	k'uj	櫰傀
kˤus	k'us	憒
kʰˤuj	kh'uj	魁顝
kʰˤujʔ	kh'ujq	魁{魁壘}
kʰˤujh	kh'ujh	塊
gˤujʔ	g'ujq	廆瘣藱
gˤujh	g'ujh	螝{蛹}
gˤus	g'us	繢闠䜋嬇
ŋˤuj	ng'uj	嵬敱鮠
ŋˤujʔ	ng'ujq	隗
ʔˤuj	q'uj	煨偎椳㙗
ʔˤujʔ	q'ujq	猥{總括；積聚}
kˤruj	k'ruj	壞{毀他}
kʰˤrus	kh'rus	蒯𦳋𨛖蕢{蕪穢；土}
gˤruj	g'ruj	槐懷瀤褢壞{自毀}
gˤrujh	g'rujh	蘾
ŋˤrus	ng'rus	聵
ʔˤruj	q'ruj	崴
pun	pun	饙餴
punh	punh	糞拚
put	put	弗黻韍巿紼綍沸{觱沸，泉水湧出貌}𧙻
pʰun	phun	紛{盛多；雜亂；繽紛}
pʰut	phut	拂茀祓{擦洗使清潔}
bun	bun	賁墳隫濆焚蚡轒鳻蕡汾𥦋棼
but	but	岪佛{大}
mun	mun	聞
munʔ	munq	抆
munh	munh	問聞{使聞；名聲}
mut	mut	物勿
tun	tun	肫{肫肫，誠懇}諄淳{澆灌}
tunʔ	tunq	準{符合，齊等；標準；獄官}綧純{鑲邊}淳{準}
tunh	tunh	訰
tut	tut	拙䪼
stunʔ	stunq	賰
stunh	stunh	鬊
tʰun	thun	春萅
tʰunʔ	thunq	蠢惷舛
tʰut	thut	出
dun	dun	純屯{全部}肫鶉醇淳錞{錞于}漘膞{股骨}
nun	nun	犉
nunh	nunh	閏潤
tsun	tsun	遵僎鷷
tsunh	tsunh	畯俊儁焌駿餕晙𤮪
tsʰun	tshun	壿逡竣
dzut	dzut	崒
sunʔ	sunq	簨
sunh	sunh	浚峻晙陖鵔
lunʔ	lunq	允狁馻鈗
l̥unh	lhunh	舜
slun	slun	循
slut	slut	訹
mlunʔ	mlunq	盾楯{盾}揗吮
mlut	mlut	术{秫}術述秫鉥沭
run	run	侖倫淪崙鯩棆菕{棆}惀綸
rut	rut	律率{法令；佩巾；句首助詞}繂𦆽膟
C.run	C.run	輪
j̊un	jhun	川
mjunh	mjunh	順
sjun	sjun	紃巡馴
hjunh	hjunh	訓
kun	kun	君皸
kunh	kunh	攟攗
kut	kut	屈{地名}鶌{鶌鳩，即鶻嘲}
kʰut	khut	屈詘𧌑䓛鶌{鶌鶋}
gun	gun	帬裙羣群𤸷
gunh	gunh	郡
gut	gut	倔屈{短；竭盡}詘{聲音戛然而止}掘
ŋunʔ	ngunq	齫
ʔun	qun	藴{包藏，包含}
ʔunʔ	qunq	藴{積聚，蓄藏}蕰
ʔunh	qunh	愠慍醞
ʔut	qut	鬱𩏴尉
prut	prut	筆
brut	brut	弼
mrun	mrun	岷㞶崏緡緍捪㨉抿㡪
mrunʔ	mrunq	𨌲
trun	trun	窀屯{困頓；吝惜；滿；厚；卦}
trut	trut	絀窋
tʰrun	thrun	椿杶櫄
tʰrunʔ	thrunq	蜳
tʰrut	thrut	黜茁欪
srut	srut	蟀率{順著；自、從}
lrun	lrun	㡒
lrut	lrut	术{草名}𦬸
l̥run	lhrun	鶞輴䡅楯{輴}
l̥rut	lhrut	怵怴䟣
krun	krun	麇麕𢋵
kʰrun	khrun	囷蜠
kʰrunʔ	khrunq	麇{捆綁}
grunʔ	grunq	莙菌窘箘蜠𡹤
ʔrun	qrun	頵
pˤun	p'un	奔犇
pˤunʔ	p'unq	本
pˤunh	p'unh	奔{直趨}
bˤunh	b'unh	坌{紛繁；覆蓋}
bˤut	b'ut	誖
mˤun	m'un	璊捫虋𧄸䫒汶{汶汶，玷辱}
mˤunʔ	m'unq	懣
mˤunh	m'unh	悶
mˤut	m'ut	沒歾歿𤤄
m̥ˤun	mh'un	婚昏昬𩌲惽涽惛殙
m̥ˤut	mh'ut	惚{恍惚}昒
tˤun	t'un	敦錞{鐏}惇埻{埻端，國名}
tˤunh	t'unh	頓敦{豎立；食器；困敦}
tˤut	t'ut	咄
tʰˤun	th'un	啍{啍啍，重遲貌，猶慢吞吞}暾焞{明亮；焞焞，車行聲}𪏆䵍
dˤun	d'un	屯{聚積；戍守；土丘}純{纏束，包裹；布帛一段}沌{沌沌，無知；圓轉貌}韕芚忳鈍軘庉{火熾盛貌}邨{地名}橔燉
dˤunʔ	d'unq	庉沌{渾沌}
dˤunh	d'unh	鐓
nˤunh	n'unh	臑{肉醬}
nˤut	n'ut	訥吶
tsˤun	ts'un	尊樽朘
tsˤunʔ	ts'unq	撙繜噂僔
tsˤunh	ts'unh	捘
tsˤut	ts'ut	卒
tsʰˤunʔ	tsh'unq	忖刌
tsʰˤunh	tsh'unh	寸
tsʰˤut	tsh'ut	猝
dzˤun	dz'un	蹲踆
dzˤunʔ	dz'unq	鱒
dzˤunh	dz'unh	鐏
dzˤut	dz'ut	捽
sˤun	s'un	孫蓀飧飱蕵
sˤunh	s'unh	遜
sˤut	s'ut	窣
lˤun	l'un	豚遯遁㹠{豚}
lˤunʔ	l'unq	盾{趙盾，人名}
lˤut	l'ut	腯突葖鼵鶟
l̥ˤut	lh'ut	葖
rˤun	r'un	論掄崘
rˤunh	r'unh	論{言論，名詞}
kjunʔ	kjunq	袞衮蔉
kˤun	k'un	昆崑崐䖵晜鯤鵾琨騉菎混{混夷}
kˤunʔ	k'unq	緄繉䃂鯀鮌輥
kˤunh	k'unh	睔
kˤut	k'ut	淈
kʰˤun	kh'un	髠髡坤巛
kʰˤunʔ	kh'unq	壼捆稛閫梱綑齫悃
kʰˤunh	kh'unh	困
kʰˤut	kh'ut	堀窟𩑔
gˤun	g'un	渾
gˤunʔ	g'unq	混䧰
gˤunh	g'unh	圂溷慁焜
gˤut	g'ut	抇{掘}搰{掘}
ŋˤun	ng'un	梱{木名}
ŋˤut	ng'ut	兀扤卼{臲卼，動搖不安}杌{杌隉，動搖不安}阢
ʔˤun	q'un	溫縕緼轀豱韞
ʔˤunh	q'unh	揾
nˤrut	n'rut	貀
kˤrun	k'run	綸{海草，即昆布}
stumʔ	stumq	沈{諸侯}邥審
dum	dum	諶忱葚
num	num	荏{大豆}
nəps	nyps	芮汭枘
l̥um	lhum	深冞䍘
l̥umh	lhumh	深{深度}
ləps	lyps	肄{習}
sləps	slyps	肆
rəps	ryps	涖莅蒞
C.rum	C.rum	臨
C.rumh	C.rumh	臨{哭吊死者}
kum	kum	今
kʰum	khum	欽
gum	gum	禽擒肣{占卜時甲上向內斂收的裂紋}捦黔
ʔum	qum	陰霠蔭{樹蔭，影}窨堷瘖
ʔumʔ	qumq	飲
ʔumh	qumh	陰{遮蓋；隱蔽；埋藏}蔭{遮蓋；隱蔽}廕{遮蔽；庇護}飲{使飲；宴請；滿足}
drum	drum	沈沖{幼}
drumh	drumh	沈{使沈；祭川澤，向水中投祭品}
drəps	dryps	懟
tsrum	tsrum	簪
tsʰrum	tshrum	參{參差}
srumh	srumh	滲
krəps	kryps	洎{添水於鍋中；湯汁}
grəps	gryps	洎{浸潤；到}
wrəps	wryps	位
tˤum	t'um	耽
tˤəps	t'yps	對荅{對}
dˤumʔ	d'umq	髧
dˤəps	d'yps	薱㬣{茂盛}
nˤəps	n'yps	内內
n̥ˤəps	nh'yps	退
tsˤumʔ	ts'umq	簪{快}
tsʰˤum	tsh'um	參驂
tsʰˤumʔ	tsh'umq	憯{快}
sˤum	s'um	三犙
lˤum	l'um	潭
lˤəps	l'yps	逮棣
kˤumh	k'umh	紺
kʰˤum	kh'um	堪
kʰˤumʔ	kh'umq	貪
gˤum	g'um	含
gˤumh	g'umh	唅含{以珠、玉、貝、米之類納於死者口中}
ʔˤumʔ	q'umq	黭黯黬晻隌
ʔˤumh	q'umh	闇暗
dˤrum	d'rum	湛{（水）深、積水；河名}
kˤrum	k'rum	𪒹
