tsɿ⁵²	之知栀蜘兹咨姿资滋芝枝支肢
tsɿ²²	值职植殖置汁织执糍隻质
tsɿ⁴⁴	子姊脂止指旨址趾梓紫滓只
tsɿ³⁵	至致炙智渍制製
tsɿ³¹	字自寺帜治痔痣志誌
tsʰɿ⁵²	雌痴
tsʰɿ²²	池驰迟持祠词慈辞磁瓷嗤
tsʰɿ⁴⁴	耻此
tsʰɿ³⁵	翅鹚次刺赐侍斥
sɿ⁵²	思尸师诗施狮丝司私斯撕饲嗣
sɿ²²	识食鲥蛳失十蚀室适鸶
sɿ⁴⁴	死史始驶使
sɿ³⁵	四士事世试寺侍氏仕市示式势视试饰恃柿誓巳似祀矣肆嗜
pi⁵²	 蓖陛
pi²²	必碧璧皮疲琵脾匹僻鼻
pi⁴⁴	比彼鄙被□{掰}
pi³⁵	闭臂滗箅蔽被
pi³¹	备币鐾毙敝弊避篦辟弼
pi⁵	逼笔毕
pʰi⁵²	批披枇秕
pʰi⁴⁴	痞
pʰi³⁵	庇界痹屁闢
mi⁵²	眯
mi²²	眉楣弥糜迷嵋
mi⁴⁴	米密蜜
mi³⁵	泌
mi³¹	秘谜
ti⁵²	低的
ti²²	敌堤滴狄涤荻笛嫡啼提题蹄嘀
ti⁴⁴	底抵
ti³⁵	弟帝蒂隶涕惕嚏迪
ti³¹	地递第屉
tʰi⁵²	梯
tʰi⁴⁴	体
tʰi³⁵	剃替
li²²	厘梨狸犁璃黎篱立栗笠粒尼倪逆呢离历泥
li⁴⁴	礼你李理鲤里裹
li³⁵	丽莉雳
li³¹	吏利励例荔厉疬痢腻
tɕi⁵²	鸡机肌基稽讥箕饥饑
tɕi²²	吸击迹积绩激及级即极辑籍脊鲫脐骑棋旗蛰侄秩祈齐崎集藉
tɕi⁴⁴	已挤纪杞纸圾几
tɕi³⁵	计祭记妓缉忌技际剂季既继寂寄髻麒契济泣冀嫉暨繫□{乳房}
tɕi⁵	吉急疾戟
tɕʰi⁵²	妻欺凄
tɕʰi²²	其祁期戚奇
tɕʰi⁴⁴	启起岂齿乞
tɕʰi³⁵	气祁鳍汽砌器氣企
tɕʰi⁵	七漆柒
ɕi⁵²	西希牺犀栖奚稀溪熙
ɕi²²	什拾夕昔析息悉惜熄习袭媳嬉时实蟋匙席
ɕi⁴⁴	矢屎洗喜玺是
ɕi³⁵	弃戏细系係
ɕi³¹	释逝豉
ɕi⁵	湿
i⁵²	衣医依咿
i²²	宜姨液腋揖夷移遗疑译仪谊咦
i⁴⁴	已以倚椅
i³⁵	蚁义亿忆艺议异意肄翼邑毅易{容~}
i³¹	二贰矣
i⁵	又日一乙亦益逸缢沂壹易{交~}
pu²²	不葡菩僕
pu⁴⁴	补朴甫蒲浦谱捕扑脯
pu³⁵	辅普佈舖
pu³¹	怖部埠簿步布
pʰu⁵²	铺
pʰu³⁵	瀑
pʰu³¹	讣赴扑卜仆
mu²²	目模
mu⁴⁴	母拇
mu³⁵	幕
mu³¹	睦
mu⁵	木牧穆
fu⁵²	麸夫肤呼
fu²²	忽佛孵敷伏扶芙服俘栿浮符福辐蝠缚腹覆乎狐壶湖葫糊蝴抚瑚弧複复胡鬍瓠
fu⁴⁴	府斧俯腑虎浒
fu³⁵	父付妇负幅釜腐附驸副傅富赋互护戽咐户瓠
fu³¹	復
tu⁵²	督都
tu²²	独牍犊屠
tu⁴⁴	堵赌拄肚
tu³¹	杜渡镀妒度踱
tu⁵	凸
tʰu²²	突图徒涂途
tʰu⁴⁴	土
tʰu³⁵	兔吐
tʰu⁵	秃
lu²²	奴卢芦炉鸬录庐
lu⁴⁴	卤鲁橹努
lu³⁵	禄
lu³¹	怒赂路鹭虏露
tsu⁵²	珠租株珠诛蛛
tsu²²	浊足锄触蜀轴烛逐瞩祝筑
tsu⁴⁴	主阻组祖诅
tsu³⁵	著蛀铸注
tsu³¹	助驻註
tsʰu⁵²	初粗
tsʰu²²	橱蓄族促畜
tsʰu⁴⁴	础楚曙薯
tsʰu³⁵	醋触处
su⁵²	蔬梳疏舒苏酥
su²²	叔殊淑熟术述俗肃速粟缩续赎属
su⁴⁴	数
su³⁵	塾束漱诉素塑戍溯数宿
ku⁵²	姑孤辜箍鸪
ku⁴⁴	古估股鼓牯
ku³⁵	固故顾雇锢
ku⁵	骨呱
kʰu⁵²	枯
kʰu²²	苦
kʰu⁴⁴	酷
kʰu³⁵	库裤
kʰu⁵	窟
u⁵²	乌污握巫诬呜
u²²	无吴梧蜈物勿
u⁴⁴	侮舞喔
u³⁵	吾务戊误悟雾恶{厌~}
u⁵	屋
ly²²	驴律率{效~}
ly⁴⁴	吕旅女缕履褛
ly³¹	虑滤
ly⁵	绿{~林好汉}
tɕy⁵²	猪朱居拘驹诸硃褚车{~马炮}
tɕy²²	除厨储瞿渠徐掬蛐蜍
tɕy⁴⁴	煮柱举矩俱
tɕy³⁵	句巨拒具剧惧据距锯聚踞炬
tɕy³¹	住
tɕy⁵	局菊鞠橘□{填塞}
tɕʰy⁵²	区驱蛆趋
tɕʰy²²	屈曲粬
tɕʰy⁴⁴	鼠黢暑署取娶
tɕʰy³⁵	趣
tɕʰy⁵	出
ɕy⁵²	书虚嘘需输须墟鬚
ɕy²²	 □{屈；勾}
ɕy⁴⁴	许戌恤鼠{又}
ɕy³⁵	恕序叙嗉绪婿絮薯
ɕy³¹	竖树
ɕy⁵	膝嘘
y⁵²	 淤吁
y²²	迁愚盂娱愉逾榆虞域狱于余馀
y⁴⁴	语雨耳乳与宇羽禹
y³⁵	愈
y³¹	玉遇芋浴预欲喻寓裕愈誉豫郁御禦鬱
pa⁵²	巴芭疤笆爸
pa²²	拔杷爬琶趴扒筢耙粑
pa⁴⁴	靶把
pa³⁵	霸坝壩欛
pa³¹	罢
pa⁵	八
pʰa³⁵	怕
pʰa³¹	叭
pʰa⁵	啪
ma⁵¹	蟆孖{揹}
ma²²	麻痲
ma⁴⁴	妈马码
ma³¹	骂
ma⁵	袜抹
fa⁵²	花
fa²²	伐罚筏滑猾哗划
fa³¹	化话画劃
fa⁵	 乏法发华
ta⁴⁴	打
ta³⁵	达
ta⁵	 搭沓答
tʰa⁵²	他它
tʰa²²	塌遏
tʰa³¹	獭
tʰa⁵	塔踏蹋
la⁵²	拉垃
la²²	纳邋捺啦
la⁴⁴	哪
la³⁵	那娜
la³¹	钠
la⁵	腊蜡
tsa⁵²	遮咱渣楂
tsa²²	擦茶搽察杂札查
tsa⁴⁴	者
tsa³⁵	诈榨汊蔗鹧拃炸□{擤}
tsa³¹	蚱蜇
tsa⁵	眨乍闸铡摘窄紥咂宅择扎轧煠昨
tsʰa⁵²	叉杈衩差{~别}车{马~}
tsʰa⁴⁴	扯
tsʰa³⁵	岔
tsʰa⁵	插拆拆撤
sa⁵²	沙纱奢赊佘鲨煞杉
sa²²	蛇畲设
sa⁴⁴	洒捨
sa³¹	萨社赦麝舍射
sa⁵	杀撒
ka⁵²	加家痂颊袈
ka²²	裌
ka⁴⁴	贾假
ka³⁵	价驾架嫁
ka⁵	甲胛夹挟
kʰa²²	卡掐
kʰa³⁵	□{打~~：穿开档裤}
kʰa⁵	客{~气}
ŋa⁵²	丫鸦雅呀
ŋa²²	桠研牙芽蚜
ŋa⁴⁴	 哑
ŋa³⁵	垭也
ŋa³¹	 □{犟嘴}
ŋa⁵	押鸭压
xa⁵²	蛤虾瘕{嘶哑}
xa²²	蝦
xa⁴⁴	 哈{傻}
xa³¹	辖下夏厦
xa⁵	瞎嚇
a⁵²	阿
a²²	啊
pia²²	白
pia⁵	百柏蔔
pʰia⁵	帕拍
mia⁵	麦脉
tia⁴⁴	 □{~鱼：捕鱼}
tia⁵	德得□{给}
lia⁴⁴	惹
lia³⁵	苶{疲劳}
lia⁵	额轭阨{山脊险路}
tɕia⁵²	佳傢嘉
tɕia²²	茄杰
tɕia⁴⁴	姐
tɕia³⁵	借笡{斜}
tɕia³¹	稼谢
tɕʰia³⁵	恰洽趄{错开；让开}
tɕʰia⁵	客{~人}
ɕia²²	霞侠峡狭遐暇
ɕia⁴⁴	写
ɕia³⁵	泻
ɕia³¹	辖
ia²²	衙爷伢
ia⁴⁴	野
ia³⁵	亚
ia³¹	夜
tsua⁵²	抓
tsua⁵	錣{啄}
sua⁴⁴	耍
sua⁵	刷
kua⁵²	瓜
kua²²	剐寡
kua³⁵	卦挂
kua⁵	括刮
kʰua⁵²	夸
kʰua⁴⁴	垮
kʰua³⁵	跨跨
ua⁵²	洼蛙
ua²²	娃娲哇
ua⁴⁴	瓦
ua⁵	挖
po⁵²	波玻菠跛颇
po²²	博婆泊薄
po⁴⁴	 拔播
po³⁵	伯脖魄簸
po⁵	拨剥钵驳博{又}
pʰo⁵²	坡
pʰo³⁵	破剖迫
pʰo⁵	勃泼
mo⁵²	摸魔摩
mo²²	末沫馍漠没模
mo³¹	膜寞磨
mo⁵	莫陌
to⁵²	多
to²²	夺
to⁴⁴	朵躲惰垛
to³⁵	剁砣
to³¹	舵堕
tʰo⁵²	拖
tʰo²²	驼驮
tʰo⁴⁴	妥椭
tʰo⁵	脱託拓托
lo²²	酪啰罗脶锣箩骡螺洛络骆挪萝乐{快~}
lo⁴⁴	裸
lo³⁵	辣诺
lo³¹	糯懦
lo⁵	落烙捋
tso²²	镯酌凿着作
tso⁴⁴	左座坐
tso³⁵	啄佐
tso⁵	桌卓琢捉
tsʰo⁵²	搓
tsʰo²²	矬
tsʰo³⁵	措锉挫错
tsʰo⁵	戳
so⁵²	梭蓑唆
so²²	学朔芍说索
so⁴⁴	所琐锁
so³¹	削
so⁵	硕
ko⁵²	哥歌锅戈
ko⁴⁴	裹果
ko³⁵	个过
ko⁵	鸽割搁阁各郭国角廓蝈葛
kʰo⁵²	科窠
kʰo²²	颗蝌确
kʰo⁴⁴	可
kʰo³⁵	课棵
kʰo⁵	渴扩壳磕阔
xo²²	河禾盒鹤活或惑何合获和{~气}荷{~花}
xo⁴⁴	火伙夥
xo³⁵	穫和{连词}荷{薄~}
xo³¹	贺祸藿货霍
xo⁵	喝
o⁵²	窝涡莴
o²²	鹅蛾俄娥峨
o⁴⁴	我
o³¹	饿卧
o⁵	 恶{善~}
lio²²	掠
tɕio⁵²	 □{打}
tɕʰio³⁵	雀鹊却
io²²	虐若弱略约岳嶽乐{音~}
tə²²	□{抛；掷}
tʰə²²	特
tsə²²	泽
tsə³⁵	这
tsə⁵	哲浙责摺
tsʰə²²	测
tsʰə³⁵	彻厕
tsʰə⁵	册策栅
sə²²	涉
sə³⁵	摄
sə⁵	瑟色
kə⁵	胳革格隔疙
kʰə²²	瞌
kʰə⁴⁴	坷
kʰə³⁵	去
kʰə⁵	克苛咳刻
ŋə⁴⁴	饵
ŋə³⁵	鄂
ŋə³¹	颚
xə²²	哈
xə³⁵	壑
xə³¹	赫嚇
xə⁵	呵
ə³⁵	额
pie⁵²	鞭边蝙编
pie²²	别便{~宜}
pie⁴⁴	扁匾瘪贬
pie³⁵	变辨辩辫
pie³¹	遍便{方~}
pie⁵	憋鳖
pʰie⁵²	篇偏
pʰie³⁵	骗片
pʰie⁵	撇
mie²²	绵棉眠
mie⁴⁴	免勉娩缅
mie³¹	面麺
mie⁵	灭篾
tie⁵²	颠癫爹
tie²²	田甜填蝶叠碟谍跌
tie⁴⁴	典点碘
tie³⁵	甸
tie³¹	殿掂电佃店垫淀奠靛簟
tʰie⁵²	天添
tʰie⁴⁴	舔
tʰie⁵	贴铁帖
lie⁵²	研
lie²²	列劣烈年业连帘怜莲廉鲢镰猎裂聂阎镊蹑黏热联蔫
lie⁴⁴	脸燃撵捻敛碾
lie³¹	念练砚楝孽验恋捏炼鍊
lie⁵	捡
tɕie⁵²	艰尖坚煎肩搛犍楔监兼歼奸间{中~}
tɕie²²	疖捷前钱钳桔
tɕie⁴⁴	剪检简拣践俭柬笕碱茧趼
tɕie³⁵	建剑荐健渐腱箭暂键见给{供~}
tɕie³¹	件饯贱涧溅锏谏间{~断}
tɕie⁵	接揭节洁截褶结折
tɕʰie⁵²	千迁牵铅掀笺谦签
tɕʰie²²	虔乾潜妾
tɕʰie⁴⁴	浅遭且谴
tɕʰie³⁵	欠怯窃芡歉
tɕʰie⁵	切
ɕie⁵²	先仙些
ɕie²²	舌闲贤舷衔嵌嫌协邪穴折
ɕie⁴⁴	显险
ɕie³⁵	线羡宪献泄懈
ɕie³¹	县现胁谢
ɕie⁵	虱歇蝎
ie⁵²	烟胭淹阉掩椰腌
ie²²	然燃焉延严言炎盐筵檐谚颜
ie⁴⁴	辇染演冶
ie³⁵	厌宴艳堰咽燕嚥
ie³¹	焰
ie⁵	噎页叶
lye⁵	月
tɕye⁵²	捐鹃娟绢
tɕye²²	劫决诀绝瘸全权泉拳颧觉{~悟}
tɕye⁴⁴	眷卷捲圈
tɕye³⁵	绢倔
tɕye³¹	倦券
tɕʰye⁵²	圈
tɕʰye⁴⁴	犬
tɕʰye³⁵	劝
tɕʰye⁵	缺厥
ɕye⁵²	靴宣喧玄悬鲜
ɕye⁴⁴	选癣
ɕye³¹	眩弦旋
ɕye⁵	薛雪血
ye⁵²	鸳渊曰冤
ye²²	园援辕悦阅粤越袁阮丸元员原圆袁缘源猿沿
ye⁴⁴	远
ye³⁵	媛
ye³¹	皖怨院愿
pai⁵²	掰□{女阴}
pai²²	排牌
pai⁴⁴	摆
pai³⁵	拜簰
pai³¹	败稗
pʰai³⁵	派
mai²²	埋
mai⁴⁴	买
mai³¹	迈卖
fai²²	怀淮槐踝
fai³¹	坏
tai⁵²	呆
tai²²	头抬苔臺
tai⁴⁴	歹斗
tai³⁵	带待怠殆贷袋代戴黛
tai³¹	豆逗痘大
tʰai⁵²	胎偷
tʰai³⁵	太态泰透汰
lai⁵²	搂{掏}
lai²²	来楼
lai⁴⁴	奶篓搂{抱}
lai³¹	赖癞陋漏奈耐
tsai⁵²	灾栽斋瞻
tsai²²	才材财裁柴豺哉
tsai⁴⁴	在宰走崽
tsai³⁵	再债载
tsai³¹	寨
tsʰai⁵²	猜钗差{当~}
tsʰai⁴⁴	采彩睬採
tsʰai³⁵	菜蔡
sai⁵²	腮鳃筛
sai³⁵	赛晒瘦嗽
kai⁵²	该沟钩阶皆秸街谐勾{~结}
kai⁴⁴	狗苟改解{~开}
kai³⁵	界构丐盖购够介戒芥届疥械
kai³¹	 勾{姓}
kʰai⁵²	楷开
kʰai⁴⁴	凯楷口
kʰai³⁵	溉概慨
ŋai⁵²	哀喉欧{姓}
ŋai²²	埃捱
ŋai⁴⁴	矮葛藕偶
ŋai³⁵	爱艾隘呕碍
xai⁵²	□{佝}
xai²²	孩喉猴瘊鞋侯行
xai³⁵	海蟹骇
xai³¹	亥害厚候后後解{姓}
ai³⁵	隘
tsuai⁵²	□{稻穗}
tsuai³⁵	□{栗凿}
tsʰuai⁵²	搋{搓揉}
suai⁵²	衰
suai²²	摔
suai³⁵	帅蟀率{~领}
kuai⁵²	乖
kuai⁴⁴	拐
kuai³⁵	怪
kʰuai⁴⁴	 □{拔；扯}
kʰuai³⁵	刽桧快筷块会{~计}
uai⁵²	歪
uai⁴⁴	崴{~脚}
uai³¹	外
pəi⁵²	兵杯悲碑婢范卑
pəi²²	贫陪培赔频平评坪苹屏瓶萍凭
pəi⁴⁴	丙秉饼柄禀
pəi³⁵	倍焙辈贝背并
pəi³¹	病
pəi⁵	北壁
pʰəi⁵²	胚坯□{箅子}
pʰəi²²	裴霹劈
pʰəi³⁵	佩配
məi²²	名铭某枚莓梅媒煤霉
məi⁴⁴	每美
məi³⁵	玫妹昧
məi³¹	命媚
məi⁵	墨默
fəi⁵²	飞妃非灰恢挥辉麾徽晖
fəi²²	肥回茴
fəi⁴⁴	匪毁悔榧翡彙
fəi³⁵	讳吠废肺费痱绘彗惠慧诲晦卉会{开~}
fəi³¹	贿穗汇
təi⁵²	丁疗叮堆灯钉
təi²²	停亭
təi⁴⁴	等戥顶鼎
təi³⁵	队对
təi³¹	定锭订澄钉
tʰəi⁴⁴	腿
tʰəi³⁵	听
tʰəi⁵	剔踢
ləi²²	雷
ləi⁴⁴	垒冷岭领屡磊
ləi³¹	内类令泪累擂曆
ləi⁵	力儡肋勒
tsəi⁵²	蒸贞侦罾甑正{~月}
tsəi²²	贼直睛蓆
tsəi⁴⁴	井诊疹拯整
tsəi³⁵	最
tsəi³¹	净
tsəi⁵	则侧
tsʰəi⁵²	青清蜻称撑
tsʰəi⁴⁴	请
tsʰəi⁵	吃赤尺
səi⁵²	声虽
səi²²	石谁
səi⁴⁴	髓醒擤
səi⁵	锡塞
kəi²²	□{拿}
kəi⁴⁴	颈
kʰəi⁵²	轻
ŋəi²²	赢
xəi⁵²	兄
xəi⁵	黑核
əi²²	儿而
əi⁴⁴	尔
tuəi⁵²	堆
tuəi³⁵	兑碓
tʰuəi⁵²	推
tʰuəi³⁵	退褪
luəi³⁵	蕊
luəi³¹	锐
tsuəi⁵²	追锥摧
tsuəi²²	槌锤垂捶
tsuəi⁴⁴	嘴
tsuəi³⁵	醉赘
tsuəi³¹	罪坠
tsʰuəi⁵²	吹炊崔催
tsʰuəi³⁵	脆翠
suəi²²	谁随
suəi⁴⁴	水
suəi³⁵	岁碎粹瑞税遂隧隋
suəi³¹	睡
kuəi⁵²	归闺圭龟规
kuəi²²	睽
kuəi⁴⁴	轨诡鬼
kuəi³⁵	癸贵桂鳜
kuəi³¹	柜跪
kʰuəi⁵²	亏盔窥奎
kʰuəi²²	葵魁逵
kʰuəi⁴⁴	傀
kʰuəi³⁵	溃
kʰuəi³¹	愧
uəi⁵²	威煨萎
uəi²²	危微围违桅唯惟维为
uəi⁴⁴	尾委
uəi³⁵	为
uəi³¹	伪卫未位味畏谓胃猬慰魏纬伟苇尉韦餵
pau⁵²	苞包
pau²²	袍
pau⁴⁴	胞宝饱保堡抱菢褒
pau³⁵	雹报豹暴爆匏{大脖子病叫~颈}
pau³¹	鲍铇
pʰau⁵²	抛泡
pʰau³⁵	炮疱泡{浸}
mau⁵²	冒帽貌
mau²²	毛矛茅猫
mau⁴⁴	卯牡
tau⁵²	刀叨
tau²²	逃掏陶淘萄桃
tau⁴⁴	导岛捣祷倒
tau³⁵	到悼盗道倒
tau³¹	稻
tʰau⁵²	涛滔
tʰau⁴⁴	讨
tʰau³⁵	套
lau²²	捞劳牢唠痨
lau⁴⁴	老恼脑瑙
lau³⁵	涝
lau³¹	闹
tsau⁵²	遭糟招昭沼诏召朝{今~}
tsau²²	潮巢嘲朝{~代}
tsau⁴⁴	找早枣蚤澡爪藻
tsau³⁵	兆糙窖灶皂躁照罩燥
tsau³¹	造赵
tsʰau⁵²	超操抄钞
tsʰau²²	曹槽
tsʰau⁴⁴	草吵炒
sau⁵²	烧搔骚臊筲
sau²²	韶
sau⁴⁴	嫂扫{打~}少{不多}
sau³⁵	邵绍潲扫{~把}少{~年}
kau⁵²	羔高篙糕膏
kau⁴⁴	搞稿
kau³⁵	告犒
kʰau⁵²	敲
kʰau⁴⁴	考烤
kʰau³⁵	拷靠
ŋau²²	嗷熬
ŋau⁴⁴	袄咬
ŋau³⁵	奥懊傲鏊噢岰坳
ŋau⁵	噩鳄
xau⁵²	蒿薅
xau²²	豪壕毫嚎蚝濠
xau⁴⁴	好{不坏}
xau³⁵	好{喜爱}
xau³¹	号浩耗
piau⁵²	彪标膘镖猋{疾奔}熛{火星飞迸}瀌{水飞溅}
piau²²	瓢嫖
piau⁴⁴	婊表錶
pʰiau⁵²	飘漂{~流}
pʰiau⁴⁴	瞟
pʰiau³⁵	票漂{~亮}
miau²²	苗描
miau⁴⁴	秒渺
miau³¹	庙妙
tiau⁵²	刁貂雕
tiau²²	条迢调{~和}跳{小孩乱动}
tiau⁴⁴	鸟
tiau³⁵	掉吊钓调{~动}
tʰiau⁵²	挑
tʰiau³⁵	跳
liau²²	辽聊撩燎瞭僚嘹镣疗缭
liau⁴⁴	了
liau³¹	廖料尿
liau⁵	疟
tɕiau⁵²	交郊娇浇骄胶椒焦蕉噍乔侨荞桥樵教{~书}
tɕiau²²	爵嚼蛟
tɕiau⁴⁴	狡绞饺铰搅剿缴荞
tɕiau³⁵	矫叫较教{~师}觉{睡~}
tɕiau³¹	轿噍{反~：反刍}
tɕiau⁵	脚
tɕʰiau⁵²	悄锹缲
tɕʰiau²²	瞧
tɕʰiau⁴⁴	巧
tɕʰiau³⁵	蹻窍俏撬翘
ɕiau⁵²	捎宵消逍萧硝销箫霄嚣淆肖稍鞘梢削
ɕiau⁴⁴	小晓
ɕiau³⁵	笑酵孝效校
iau⁵²	妖腰邀幺要{~求}
iau²²	饶桡尧姚窑谣摇遥挠
iau⁴⁴	扰舀
iau³⁵	耀跃绕要{重~}
iau³¹	鹞
iau⁵	药
məu²²	谋
məu⁴⁴	亩
məu³¹	暮茂贸募墓慕
fəu⁴⁴	否
təu⁵²	兜
təu²²	读毒投
təu⁴⁴	抖陡
təu³⁵	窦鬥
tsəu⁵²	州舟周洲邹
tsəu²²	愁酬仇
tsəu⁴⁴	肘
tsəu³⁵	纣绉昼皱奏揍凑做
tsəu⁵	帚
səu⁵²	搜馊飓艘
kəu⁵²	抠
kəu⁵	谷穀
kʰəu³⁵	叩扣寇
kʰəu⁵	哭
ŋəu⁵²	鸥
ŋəu⁴⁴	呕殴
xəu⁴⁴	吼
tiəu⁵²	丢
liəu²²	牛刘流留琉硫榴瘤
liəu⁴⁴	柳扭纽
liəu³¹	谬馏溜
liəu⁵	鹿六陆陸绿{~色}
tɕiəu⁵²	鸠阉州纠
tɕiəu²²	绸稠筹囚求泅球仇{姓}
tɕiəu⁴⁴	九久灸韭酒
tɕiəu³⁵	究救骤咒
tɕiəu³¹	旧柩就舅
tɕiəu⁵	撮竹粥揪卒
tɕʰiəu⁵²	抽丘秋蚯鳅鞦邱
tɕʰiəu²²	瞅
tɕʰiəu⁴⁴	丑醜
tɕʰiəu³⁵	臭
ɕiəu⁵²	收休修羞
ɕiəu²²	缩
ɕiəu⁴⁴	手守首黍朽
ɕiəu³⁵	携秀绣锈诱嗅
ɕiəu³¹	寿受兽售授袖
iəu⁵²	优忧幽悠犹
iəu²²	揉柔由邮油游尤
iəu⁴⁴	友有酉
iəu³¹	柚又右幼祐鼬釉
iəu⁵	肉
yu²²	如入育褥役疫儒辱
yu⁴⁴	汝
pã⁵²	班般颁斑搬
pã²²	盘扮扳
pã⁴⁴	板版
pã³⁵	半伴绊拌
pã³¹	办瓣
pʰã⁵²	藩潘攀
pʰã³⁵	襟判叛盼
mã²²	蛮馒瞒屘
mã⁴⁴	满
mã³¹	慢漫曼慢蔓
fã⁵²	番翻欢
fã²²	帆凡矾烦繁环桓还
fã⁴⁴	反返缓
fã³¹	饭贩幻宦换患焕犯泛唤范範
tã⁵²	丹耽单担{~任}
tã²²	掸谈痰谭潭檀坛罎弹{~簧}
tã⁴⁴	胆疽淡
tã³⁵	担{~子}
tã³¹	旦但蛋诞弹{子~}
tʰã⁵²	贪摊滩瘫
tʰã⁴⁴	坦毯
tʰã³⁵	炭探叹
lã²²	兰拦栏蓝篮男南难{~易}
lã⁴⁴	览揽缆榄懒
lã³⁵	难{灾~}
lã³¹	烂滥
tsã⁵²	簪毡粘
tsã²²	残蚕惭馋谗
tsã⁴⁴	攒斩展盏崭
tsã³⁵	颤赞沾佔战蘸栈站
tsã³¹	錾
tsʰã⁵²	餐掺参
tsʰã⁴⁴	惨产铲穇
tsʰã³⁵	灿
sã⁵²	衫三山珊叁
sã²²	蝉禅
sã⁴⁴	伞闪陕
sã³⁵	羶膳赡煽散扇
sã³¹	卅善鳝
kã⁵²	甘泔柑
kã²²	竿
kã⁴⁴	碱赶敢感橄减秆桿
kã³⁵	舰鉴幹
kʰã⁵⁴	刊堪
kʰã⁴²	坎砍
kʰã³¹	勘
ŋã⁵²	安庵鹤鞍
ŋã²²	癌崖涯岩
ŋã⁴⁴	眼
ŋã³⁵	岸按案暗雁晏
xã⁵²	憨酣
xã²²	含函寒韩邯咸鹹
xã⁴⁴	罕喊
xã³¹	苋汉汗焊憾翰限陷馅旱
tuã⁵²	端
tuã²²	团
tuã⁴⁴	短断
tuã³¹	段缎锻
luã²²	鸾
luã⁴⁴	卵暖软
luã³¹	乱
tsuã⁵²	专砖纂钻
tsuã²²	传{~送}
tsuã⁴⁴	转{~变}
tsuã³⁵	钻
tsuã³¹	撰篆赚转{~动}传{~记}
tsʰuã⁵²	川穿
tsʰuã⁴⁴	喘
tsʰuã³⁵	串窜篡
suã⁵²	删闩酸拴栓
suã²²	船椽蟾
suã³⁵	疝蒜算涮
kuã⁵²	肝关官棺干观
kuã⁴⁴	馆管
kuã³⁵	贯惯灌罐幹冠
kʰuã⁵²	宽
kʰuã²²	槛
kʰuã⁴⁴	款
kʰuã³⁵	看
uã⁵²	弯劑湾豌
uã⁴⁴	宛挽晚婉碗腕
uã³⁵	完顽玩
uã³¹	万
pin⁵²	宾槟冰彬
pin³¹	殡鬓
pʰin⁴⁴	品
pʰin³⁵	拼聘
min²²	民抿闽鸣明冥螟
min⁴⁴	悯敏
tʰin⁵²	厅汀廷庭蜓
tʰin⁴⁴	挺艇
lin²²	人鳞邻林临淋燐拎伶灵凌铃陵翎菱龄吟磷零拧宁
lin³⁵	绫硬另凝韧
tɕin⁵²	针巾今斤金津筋京茎荆惊晶鲸擎精
tɕin²²	秦擒襟
tɕin⁴⁴	仅紧谨锦近景警枕
tɕin³⁵	镜尽进晋儘竞敬靖境静沁竟缙劲禁
tɕin³¹	经径
tɕʰin⁵²	钦卿皴亲
tɕʰin²²	岑晴芹琴禽勤情寻
tɕʰin³⁵	浸侵庆
ɕin⁵²	心辛欣新薪星猩腥深馨芯兴{兴~}
ɕin²²	刑形型行{~为}
ɕin³⁵	信焮杏姓幸性讯迅兴{高~}
in⁵²	姻因阴音英莺婴缨樱鹦鹰蝇嘤
in²²	仁扔仍寅银迎盈营
in⁴⁴	忍殷引蚓隐颖影映饮
in³⁵	壬刃认韧印纫任应
in³¹	荫
tɕyn⁵²	军君均钧
tɕyn²²	琼裙群
tɕyn⁴⁴	准
tɕyn³⁵	俊峻骏
tɕyn³¹	醇菌郡
tɕʰyn⁵²	春椿鹑
tɕʰyn⁴⁴	蠢顷倾
ɕyn⁵²	勋熏薰醺
ɕyn²²	巡询循
ɕyn²²	纯
ɕyn³¹	顺舜训殉瞬驯
yn²²	云匀
yn⁴⁴	耘允
yn³¹	闰润孕运酝韵
yn³¹	熨
yn⁵	尹
paŋ⁵²	邦帮
paŋ²²	蚌滂庞旁螃膀
paŋ⁴⁴	绑榜
paŋ³⁵	棒谤傍
pʰaŋ³⁵	胮胖
maŋ²²	忙盲茫氓虻芒
maŋ⁴⁴	莽蟒
maŋ³¹	妄忘望
faŋ⁵²	方芳荒慌
faŋ²²	坊防妨房肪凰蟥访惶
faŋ⁴⁴	纺恍谎幌仿倣晃
faŋ³⁵	放
taŋ⁵²	 当{~然}
taŋ²²	裆唐堂棠塘糖螳膛
taŋ⁴⁴	挡党
taŋ³⁵	荡档铛当{上~}
tʰaŋ⁵²	汤
tʰaŋ⁴⁴	躺
tʰaŋ³⁵	烫趟
laŋ²²	榔郎狼廊螂囊
laŋ⁴⁴	朗
laŋ³¹	浪
tsaŋ⁵²	赃张章樟彰脏
tsaŋ²²	肠常场偿藏{收~}
tsaŋ⁴⁴	掌涨长{生~}
tsaŋ³⁵	葬胀障瘴涨帐账藏{西~}
tsaŋ³¹	丈脏仗杖
tsʰaŋ⁵²	仓苍舱昌菖疮沧
tsʰaŋ²²	 长{~短}
tsʰaŋ⁴⁴	厂敞
tsʰaŋ³⁵	畅倡唱
saŋ⁵²	桑伤商丧
saŋ²²	裳尝
saŋ⁴⁴	嗓搡磉赏
saŋ³⁵	上
saŋ³¹	尚
kaŋ⁵²	刚纲肛缸冈岗钢
kaŋ²²	扛
kaŋ⁴⁴	港讲
kaŋ³⁵	杠虹
kʰaŋ⁵²	康糠
kʰaŋ⁴⁴	慷
kʰaŋ³⁵	抗炕
ŋaŋ⁵²	肮
ŋaŋ³⁵	昂
xaŋ⁵²	夯
xaŋ²²	航杭行{银~}
xaŋ³¹	巷项
liaŋ²²	良凉梁粮粱娘量{测~}
liaŋ⁴⁴	俩辆两
liaŋ³⁵	晾
liaŋ³¹	亮谅量{数~}
tɕiaŋ⁵²	江礓姜浆薑将{~来}
tɕiaŋ²²	墙详祥翔强
tɕiaŋ⁴⁴	奖桨蒋
tɕiaŋ³⁵	酱将{大~}
tɕiaŋ³¹	匠犟象降{~落}
tɕʰiaŋ⁵²	僵缰疆枪腔羌
tɕʰiaŋ⁴⁴	抢炝勥
tɕʰiaŋ³⁵	牚戗呛
ɕiaŋ⁵²	箱乡香厢湘镶相{~互}
ɕiaŋ²²	降{投~}
ɕiaŋ⁴⁴	响享响饷想
ɕiaŋ³⁵	向
ɕiaŋ³¹	橡像相{~貌}
iaŋ⁵²	央殃秧鸯
iaŋ²²	瓤穰扬羊阳杨疡洋烊
iaŋ⁴⁴	 养痒
iaŋ³⁵	仰
iaŋ³¹	嚷壤攘让样酿
tsuaŋ⁵²	妆庄桩装
tsuaŋ³⁵	壮状
tsʰuaŋ⁵²	窗
tsʰuaŋ⁴⁴	闯
tsʰuaŋ³⁵	撞创
suaŋ⁵²	霜孀双
suaŋ²²	床
suaŋ⁴⁴	爽
kuaŋ⁵²	光胱
kuaŋ⁴⁴	广
kuaŋ³⁵	逛
kʰuaŋ⁵²	匡筐眶框
kʰuaŋ²²	狂
kʰuaŋ³⁵	况旷矿
uaŋ⁵²	汪
uaŋ²²	皇黄蝗簧亡王隍
uaŋ⁴⁴	网往枉
uaŋ³¹	旺望
pəŋ⁵²	奔锛崩绷
pəŋ²²	盆朋彭棚膨蓬篷鹏
pəŋ⁴⁴	本
pəŋ³⁵	迸
pəŋ³¹	笨
pʰəŋ⁵²	喷塳{尘土飞扬}
pʰəŋ⁴⁴	捧
pʰəŋ³⁵	碰
məŋ²²	门萌盟蒙朦濛
məŋ⁴⁴	猛懵蠓
məŋ³⁵	扪
məŋ³¹	闷孟梦问
fəŋ⁵²	荤婚晕吩纷芬丰风枫封疯峰锋蜂分昏
fəŋ²²	坟焚豶冯逢馄魂缝{~补}横浑
fəŋ⁴⁴	粉讽奉
fəŋ³⁵	奋愤粪凤俸混
fəŋ³¹	 份忿缝{一条~}
təŋ⁵²	灯登东冬敦墩礅蹲
təŋ²²	同桐铜童瞳茼筒
təŋ⁴⁴	董懂动盹
təŋ³⁵	疼栋邓凳冻钝顿遁吨囤盾
təŋ³¹	瞪洞垌炖
tʰəŋ⁵²	通吞
tʰəŋ²²	腾眷藤屯饨豚筒
tʰəŋ⁴⁴	统捅桶
tʰəŋ³⁵	痛
ləŋ²²	伦聋轮崙能拢笼论{~语}
ləŋ⁴⁴	拢
ləŋ³⁵	窿齈棱楞论{议~}
ləŋ³¹	嫩弄
tsəŋ⁵²	增憎珍真斟臻争睁筝尊遵赠甄征徵曾{姓}
tsəŋ²²	橙
tsəŋ⁴⁴	挣
tsəŋ³⁵	阵振镇震证郑政症粽圳正{~当}
tsʰəŋ⁵²	村
tsʰəŋ²²	呈层尘臣沉陈丞成承诚城惩程逞存乘曾{~经}
tsʰəŋ³⁵	衬趁秤寸
səŋ⁵²	牲甥森申伸身升笙耸孙僧呻参生鬆
səŋ²²	辰晨唇娠神绳旬
səŋ⁴⁴	沈审婶损笋榫荀省
səŋ³⁵	肾甚慎圣剩宋渗胜盛
kəŋ⁵²	根跟庚耕羹更{五~}
kəŋ⁴⁴	粳哽耿梗汞肯
kəŋ³⁵	更{~加}
kʰəŋ⁵²	坑空{~虚}
kʰəŋ⁴⁴	埂垦恳啃
kʰəŋ³⁵	控空{~地}
ŋəŋ⁵²	恩
xəŋ⁵²	亨哼烘
xəŋ²²	恒痕衡弘红宏洪鸿
xəŋ⁴⁴	很哄
xəŋ³⁵	桁
xəŋ³¹	恨狠
kuəŋ⁴⁴	滚
kuəŋ³⁵	棍
kʰuəŋ⁵²	坤昆崑
kʰuəŋ⁴⁴	捆
kʰuəŋ³⁵	困睏
uəŋ⁵²	温瘟翁瓮嗡煴
uəŋ²²	文闻蚊纹
uəŋ⁴⁴	吻稳璺
luŋ²²	龙隆农侬浓脓
luŋ⁴⁴	垄胧陇拢
tsuŋ⁵²	崇忠终盅钟衷锺宗综棕踪鬃鐘中{当~}
tsuŋ²²	虫
tsuŋ⁴⁴	肿总种{谷~}
tsuŋ³⁵	众纵中{~奖}种{~地}重{轻~}
tsʰuŋ⁵²	充舂囱匆葱聪摏冲衝
tsʰuŋ²²	丛从重{~复}
tsʰuŋ⁴⁴	宠
tsʰuŋ³⁵	铳
suŋ⁵²	松
suŋ³⁵	讼诵送颂
kuŋ⁵²	工弓公功攻宫恭蚣躬龚
kuŋ⁴⁴	巩拱
kuŋ³⁵	贡供
kuŋ³¹	共
kʰuŋ²²	孔恐
xuŋ⁵²	轰
xuŋ³¹	讧
tɕyŋ²²	穷
ɕyŋ⁵²	匈胸汹凶兇
ɕyŋ²²	雄熊
yŋ⁵²	痈壅
yŋ²²	茸荣容蓉榕融萤庸戎绒溶熔镕
yŋ⁴⁴	勇涌恿踊永咏泳氄拥
y³¹	用
ŋ̍²²	渔鱼
ŋ̍⁴⁴	午五伍鹉武
ŋ̍³⁵	蕹