#拼音	漢字
zz1	之兹卮吱呲咨嗞姕姿孖孜孳巵恣搘嵫支枝梔椔榰氏汥淄滋甾漬玆兹眥眦知祗禔粢緇缁肢胔胾脂芝茲菑蜘觜訾諮咨貲資趑趦輜錙鎡髭鯔鼒齍齜㞢㠿㲍㿳䝷䟗𠀢𡙛𢙊𤂇𤰭𥝮𦙆𧹛𪑿𪗋
zz2	吱{～咕～咕}
zz3	仔只咫址坁姊子徵峙帋恉指旨枳栺梓榟止沚洔滓漬畤疻砥祇秄祉秭笫籽紙紫耔芓芷茈訾趾軹酯阯黹㣥㫑㫖㲛㴯䅩𠂔𡱔𣥉𣲵𣸆
zz5	剚字=寺幟寘彘徝志忮恣懥懫摯智治洷淛滯牸狾疐痔=痣知稚稺置翅-自至緻致製制觶誌識質{人～}贄躓輊這鋕雉鷙㚄㡶㨖㴛䇽䓌䘭𠊷𡜍𢂴𢙺𢷟𣄮𣉻𤾞𧩴
cz1	嗤媸字-{硬幣有字的一面}差泚玼疵痴癡眵竾笞筂篪絺蚩彲螭跐*雌魑鴟黐㛓𠈴𡥎𣘜𣣷𤶢𥉍𧠎
cz2	値匙坻墀徥慈持柌池治{～魚}濨瓷磁礠祠稺竾箈箎箷篪糍茈茌茨詞豉趍踟踶辞辤辭遅遲餈粢{餈}馳弛鶿鹚㓾䜴𢔊𣸗𣹡
cz3	佌侈峙庀恥耻此泚茝豸跐歯齒䊼𡗼𢓗𣦗
cz5	偫佽刺廁厠喫{字彙音}庛啻懘朿栨次洩滍滯璏痓稺穉翅莿褫賜雉㰷䆈痔-疵
sz1	絲事-偲俬司嘶尸屍市-師厮廝思撕斯施是-楒泀湤溮燍獅禗禠私箷篩絲緦罳蓍蕬螄詩邿釃鍶颸鰤鳲鷥飼+侈+㴲㺇㺨𠷇𢠹𤜳𥯨𧜂
sz2	塒時榯漦蒔鰣𨸝弛-{下陷：地基不牢，房子往下～}
sz3	使史始屎死矢駛𣦸𣦹𣧇𥏳𦳊
sz5	世事=亖仕伺似佴侈+侍俟兕勢卋哆嗜嗣噬四士姒寺屎峙巳市=鈰弒弛怬恀恃是=柿氏汜泗泤洍涘澨牭眂眎矢示祀禩竢笥笶筮耜肆舐舓蒔視試誓諟諡謚豉豕貰逝食飤飼+駟㒾㭒㹝䜴𠀍𠁱𠦜𡱢𢃰𢻃𣻞𤜣𥘰𥫴𦧇𦧧𩢲
bi1	屄𣬼𡚦
bi3	佊啚匕妣彼比沘鄙毗㠲𠀤𠴿𡚧
bi5	匕媲鄙嬖庇柲毖毙泌狴畀祕秘笓篦蓖+芘詖費髲䀣䇫𢅩𢌿𣴪𤹦
pi1	仳坏坯娝怶批披抷砒磇笓紕翍邳鈹錍㓟𠜱𠞇𡲮𢱧𢾱𦊁𧪫
pi2	啤丕埤枇枈毗毘琵疲皮粃羆脾蚍裨貔鈚𢓖𣓋𤧰
pi3	伾俾痹否噽嚭圮狴痞丕邳妣+胚脾裨駓䠋䯗𡉏𢔌𢛞𢻹
pi5	屁譬辟𠱢𥥓𥧔
mi1	昧-眯-瞇咪謎-渳-
mi3	米+
di1	仾低奃磾𠽰𩑾
di3	底弤抵柢氐牴砥觝詆邸㡳㭽䩚𢇝
di5	地=坔娣帝弟=悌慸棣楴泜渧滓睇禘第締苐蒂蔕螮蠆諦跇踅㦅䠠𦯔𦷾𧍝
ti1	梯地-弟-
ti2	啼嗁埞堤姼惿提稊綈緹蹄隄題鯷騠鵜鶗𣹲𧙣𩤢
ti3	涕躰軆醍体{體}體𡥩
ti5	剃嚏屉屜弟悌揥替楴洟涕薙褅逓遞鬀㔸䶑𡲕𧝆𧝐
ni2	倪呢坭埿堄妮婗尼屔怩柅泥淣猊鈮輗郳霓鯢麑㞾䘽𡌰𢛜𨋗
ni3	伱伲你旎濔禰祢䦵𨳴
ni5	殢眤膩㦐䛏𢄽
li1	利-痢-厲-
li2	剓剺劙厘喱嫠廲梨棃樆氂牦漓漦犁犂狸璃瓈筣篱籬罹蔾藜蘺貍醨釐離离驪鱺鬁鸝麗黎黧㒿㦒㴝䉫𡟋𢛮𢟢𤛿𥝫𥟦𥠖𥲪𩼽𬃗
li3	俚哩娌悝李浬欚澧理礼禮蠡裏裡逦邐醴里鋰鯉鱧
li5	例俐儷利勵厲吏唳巁捩攦曞栛棙沴沵涖濿痢=癘礪荔+莅莉蒞蜊詈隸隶麗㡂𠠫𢤆𨽾
ji1	丌乩几{～乎}刏嗘嘰基奇{～數}姬尗幾机機犄玑璣畸畿磯禨稽笄筓箕羁羇羈肌薺{～菜}萁覊譏賫躋錤鐖隮雞鞿飢饑饥鷄齎齏齑檵𪲛杞*㚻䇫𠚽𡋵𢁂𥡞𥭱𧅱
ji3	几己幾擠机穖紀{～律}虮蟣麂㚡㲹𢓄𥭱
ji5	伎偈冀嚌垍塈妓季寄既忌忮悸惎愒憇技摡旡旣既曁泲洎漈濟劑畁痵眥眦祭穄穊穧継縊紀{年～}繫系繼罽芰薊蘻覬計記際霽驥髻鰶鱖-罽{～花魚}鯚{～花魚}㗫㡭㲅㳵䀈𡜱𢌿𢗏𧚈𩼄
qi1	倛僛妻悽敧朞期栖棲欺淒凄萋蹊𠁭𣍠
qi2	俟其圻埼奇岐崎徛忯愭鰭懠旂旗棊棋檱歧淇濝猉玂琦琪畦璂畿疧碁碕示祁祇祈祺竒粸綦耆脐臍芪薺荠蕲蘄蜞蠐錡頎颀騎骑騏麒齊齐㫅𠁭𢁒𥇚𧯯
qi3	企啓啟岂圯屺杞棨玘盀綺芑豈起砌*鮆𠭎𤣱
qi5	企噐器嚌契弃愾憇憩暣棄气氣汽炁矵砌鱭𡬨𣓇𧱲
xi1	俙僖兮唏嘶嘻娭嬉屖希徆恓憘撕晞暿曦栖桸樨欷汦浠烯熈熙熹爔犀犧牺睎硒禧稀粞羲莃西覀豨郗醯㚀㺣㾷㿽𣢑𦻎
xi2	傒奚嵇徯携攜溪磎谿鸂㜎㩦𡗞𢹂𣒎
xi3	史喜壐嬉屣徙枲洒洗熹狶璽玺禧葸蓰蟢{～～蛛（蜘蛛）}蹝𢇌𪖥
xi5	嚊壻屭憙戏戲盻禊系細细係系繫餼饩㑶㐹㡜𣳦
i1	伊依勩{磨損}吚咿擬欹毉洢漪猗祎禕瑿衣醫医矣+㙠㛄𠁼𠂣
i2	仪儀匜咦夷姨宐宜峓崕嵇嶷彜彝忔怡恞懿扅栘椸沂洟溰珆疑痍眙移箷胰螘蟻訑詒诒誼谊貽贻跠迤迻遗遺酏頤颐飴饴饐*眙㝖䄬𠅌𠗺𡗝𢂒𢓡𣅿𣻗𦚟𧧼
i3	以倚儗已扆掎攺旖椅矣舣艤笖苡苢顗㕥㠯𢙇
i5	乂义亄刈劓医噫呓埶幆悘亿億忆+意憶+撎擬拟易曀曳+槸殪毅泄異异瘞瞖竩義羿翳肄蓺薏藝艺裔詣議议跇蚁蟻饐㛳㡼㱲㵝䆿𢖫𢘽𢳊𣿉𥧵𧙟
bv1	姑晡逋餔𡜵*{姑母}
bv3	哺圃圑捕补補䝵
bv5	佈哺埠+布怖抪步=歨篰簿部餔㳍㻉𡇊𤵗
pv1	呼誧步-潽孵-{～小雞}鋪餔𫗦𢽊
pv2	匍莆菩葡蒱蒲酺
pv3	普暜氆浦溥甫-潽脯譜谱輔-{～導}鐠镨酺
pv5	舖鋪{牀～}埠+㵗
fv1	伕夫敷枹泭稃肤糐膚肤衭麩麸麬𤿲㠸䊿
fv2	俘哹垺妋姇孚孵=巫扶旉无枹桴榑殕浮涪玞琈符膚肤芙芣苻蚨蜉誣诬撫-{～養}郛鈇鳧凫𢞦𣶀𣿆𥄑𦰮𦷰𦽏
fv3	俌俛俯圑府弣撫抚{巡～}拊捬斧暊柎滏甫盙簠脯腐腑輔辅釜黼䄮𣩇
fv5	仅仆付傅副咐坿婦妇媍富父祔胕袝訃讣負賦负赋賻赴敷+阜埠+附駙驸鮒㤔𢂆𢠲𧵐𮘟
dv1	嘟都{首～}闍阇
dv3	堵暏杜睹肚{鱼～}覩賭赌𡍨
dv5	喥妒妬度{温～}斁杜渡秅秺肚蠹鍍镀𣳥
tv1	肚-{桌～、～裏}
tv2	图圖塗屠峹廜徒梌涂瘏稌荼途酴㻌䅷𨢬
tv3	吐土釷
tv5	兎兔吐堍菟唾*
lv1	路-露-
lv2	偄儒卢嚅蠕垆嚧壚如嵐懦挐攎栌櫨洳泸濡瀘炉爐獹瓐盧筎籚纑罏胪臑臚舻艫芦茹薷蘆袽襦轤醹鑪顱颅鱸鴽黸鸕鸬孺𡄲𢖵
lv3	乳嚕噜塷女擄掳虜虏擩擼撸櫓橹汝滷瀂澛磠蕊蕋魯鲁鹵卤剆+㳶𡜃𢟧𢲸𪉖𪉣
lv5	孺挐潞璐簬茹袽賂赂路輅辂露鷺鹭
zv1	侏徂朱株櫫橥洙潴瀦猪珠硃租茱蛛誅诛諸诸豬邾銖铢㦵𢔪𣦁𤝹𧳯
zv3	丶主俎宔左拄殂渚煮砫祖組组阻㵭𠂇𠰍𤆯𥘭𥘲
zv5	佇住助宁柱泞注澍炷祚竚筯箸紵纻翥胙苧苎著蛀註詛貯贮跓鑄铸阼駐驻㧣㹥䝬做坐+𢁼𣋐𥩣
cv1	坐-住-箸-初怚粗芻刍觕閦麁麄麤𢀯𣦂𤙟𥼡
cv2	儲储幮廚徂搊櫉橱滁篨耡蒭蜍蹰躇鉏鋤锄除雏雛㕑厨𢊍
cv3	处憷措暑杵杼楚楮潻濋礎础處处褚黍鼠䑕䖏𣗂𥞆
cv5	厝措處处醋錯错
sv1	囌姝書梳樗樞枢檽櫯殊殳洙瑹甦疎疏秼穌紓纾抒絑舒芟薷蘇苏踈輸酥㢝㧧樹-𡚾𣓜𣩷𤼀
sv3	数數
sv5	傃嗉塐塑墅尌庶庻恕愫愬戍数數曙榡樹=树=泝溯漱澍濖竪素署薯蔬訴诉豎遡㨞㴑𠊪𠐊𣗳𣶮𥪛𥪡𥵟
gv1	呱姑孤柧沽咕泒笟箍箛苽菇菰觚辜鴣㼋䉉𠽿𡘎𢡇𢪿𦍬
gv2	鼓?{鼓起}
gv3	估古牯皷盬瞽罟羖股薣蠱蛊詁诂賈贾鼓𠑹𤅱𦊙𦍩𧵎
gv5	僱雇固堌故痼錮锢頋顧顾
kv1	刳枯郀骷
kv2	鼓?{鼓起}喖?{似哭未哭貌}
kv3	楛苦
kv5	庫库絝绔袴褲裤
hv1	乎呼嘑幠恗歑泘滹箶㦆烀烰*
hv2	壺壶弧楜湖煳狐猢瑚瓠胡葫和{～牌}蝴衚餬糊鬍鶘㗅䉿𠁕𣬣𥁖𩰯𪍒𪏹𪐉
hv3	岵戶汻滸浒火+琥箎萀虎唬䗂𣶉戽*{～水}胡{二～子}
hv5	互帍怙戶户戽扈滬沪摢槴沍瓠祜簄護护䉟𣶉𬇛
v1	嗚呜塢坞嵨弙杇歍汙汚污洿烏乌鄔隖𡜵*𠞆𣽏𦶀
v2	亡吳吴吾唔梧毋浯潕𣲘無无珸璑祦禑胡蕪芜蜈鋘齬龉㹳㻍𠥢𡙻𢓲
v3	五仵伍侮儛午塢娬嫵妩嵨幠廡忤憮旿武捂溩潕珷甒碔舞隖鵡鹉㵲戊𢇜𢎁𢜮𣺀
v5	俉務务噁埡堊塢坞奦寤悞悟惡恶戊敄晤窹誤误隖霧雾騖骛鶩鹜㜈㡔㦍𢄓𢤓𣊃𥦸𥧝𥧸
ny3	女
ny5	㵖
ly2	廬庐蔞蒌閭闾馿驢驴魚{木～}𡳬𢣻
ly3	侶侣呂吕履旅祣穭穞窶縷缕膂褸褛鋁铝㛎𢔃𢙲
ly5	屡屢慮虑濾滤鋁铝鑪𡀿
jy1	伹俱咀娵居拘据椐沮涺狙琚疽眗睢砠苣苴菹蛆裾趄車駒驹鶋齟㡹䏣䝻𡨢𥇛𧐅𩒐
jy3	佢屨擧举柜椇楀窶筥舉莒踽㪯𠔖𡲰𥱿
jy5	倨具句埧埾姖巨怇惧愳懅懼拒據昛洰澽炬矩秬聚苣詎距踞遽鉅钜鋸锯阻颶駏䀠䇫𥃲𥬙
qy1	佉區区嶇岖抾敺祛蛆袪覻觑趨趋軀躯驅驱
qy2	俆劬徐懅渠璩瞿籧蕖蘧衢鴝䞤𣸔𤥾𧾱
qy3	取娶
qy5	厺去覷覻觑趣袪
xy1	偦吁喣噓嘘墟壖姁帤憈旰旴歔浽湏湑煦盱糈綏绥胥荽{芫～}虗虛虚蝑袽諝谞需須须鬚䇓䇕𥪃𥪙𥪥𥬔𥳗
xy3	栩煦珝許许詡諝谞醑㥠
xy5	偦叙壻婿嶼屿序彗敘叙汿沀漵燧穗穟篲絮緖绪襚遂鐆鐩隧㐨㘧㵰酗緒绪𢢝𢣿𣁏
y1	歟淤璵紆與芋迂{～腐}醧飫餘饇遇=𡌧𩜏
y2	予于伃余圩妤娛娱媮寙嵎庾愉愚扵揄於旟杅歈渝湡漁渔澞狳瑜璵畬瘀盂禺窬竽腢腴臾萸虞覦諛踰輿舆轝逾俞榆邘隅雩餘髃魚鱼㥚㥥㳛迂{～回}𢹏𣿡𤀯𥁄𩦢
y3	与予{给～}偊傴伛圄圉宇敔瑀瘉禹窳羽與語语雨齬龉㙑𢌱𤆛
y5	俁喩嫗妪寓庽御忬悆愈玉=禦禺舁芋籲吁予与宇蕷裕諭喻譽誉豫遇=逾預预飫馭𠕦𡒊𡪾𣁎𣕃
bae1	爸*{～～：父亲}伯*{～～：父亲}
bae3	捭擺摆襬𤁣
bae5	憊惫懘扒拜敗败湃+稗𩋂嫑*
pae1	呸
pae2	俳徘排棑椑牌琲箄篺㧳㻗𥱼
pae3	矲?{踩}
pae5	泒派湃+稗粺𠂢
mae1	賣-䁲
mae2	埋霾㦟䨪𢠼
mae3	嘪買买
mae5	佅賣=卖=邁迈䜕𧱘
dae1	呆懛獃䐩𤶗𪒴
dae3	歹𣦶逮
dae5	代大岱帒帶带待怠=戴殆玳瑇袋=襶貸贷迨逮黛𠷂𢂸𢄔𥩳
tae1	孡胎苔邰駘骀袋-怠-汏{漂洗}
tae2	儓台嬯抬擡旲檯炱臺薹𡎲
tae3	奤{大～～}紿㘆
tae5	冭大太忕態态汰泰溙㥭𡇷
nae1	摨熋腉螚䍲䯮
nae3	乃奶妳嬭迺𠄕𡇲
nae5	佴奈柰渿耐褦鼐㖠㮈㴎𣉘𥉃
lae1	癩-賴-
lae2	來来徠徕淶涞萊莱逨郲騋麳䅘
lae3	唻*咧*懶攋兩两㚓𨦂
lae5	勑瀨濑癩=癞=睞睐籟籁賚赉賴=赖=
zae1	亝哉斋栽渽災灾烖菑葘齋㪰𡿧𢋿𤆋𥯒
zae3	宰崽者赭載载仔𣪮𤌊
zae5	債债儎再在=寨載汏*{清洗}𣿐𥩴𥰾
cae1	在-差猜釵=𢀠𢀩
cae2	儕侪喍才材柴犲祡纔裁豺財财𥈐𧴶
cae3	倸埰寀彩抂採睬綵跐跴躧踩采㥒䣋䜺𣠁
cae5	菜蔡躧
sae1	愢揌篩筛腮顋鰓鳃㩄
sae3	𢄌
sae5	僿塞晒曬洒簺賽赛㬠𣻑
gae1	佳侅垓姟皆-荄街-該该賅赅陔㚊㨟稭秸槩*
gae3	忋改解-
gae5	丐扢摡槩槪概檞溉界盖葢蓋薤㧉疥-戒-钙鈣
kae1	嘅奒愾忾慨揩開𢔡开
kae2	欬{～气}
kae3	凱凯塏愷慨揩暟楷欬鍇锴鎧
kae5	勓愷{斜倚}愒{拖延}慨𡢖甲{指～}
hae1	咳㨙㨟害-械?{𦌒～：渔具}
hae2	偕咍孩慀諧鞋鞵頦骸䀭还還
hae3	海澥獬蟹蠏醢駭𣖻𣴴𥁐𥂹𧴛𨡬
hae5	亥儗噧害=懈擬解邂駭骇㞒𠿇𡂖𡃤𢞐𤵽
ae1	哀埃挨敱竢艾
ae2	厓唉啀嘊埃娾岩崖嵒巖挨捱欸涯睚碞騃呆{～板}獃
ae3	也濭矮藹蔼靄霭餲
ae5	呃哎噯嗳愛爱曖暧璦瑷皧瞹硋碍礙艾隘㝵𡺬𢙴𢛄𨵏
jiae1	偕喈堦湝痎皆街=階阶𣅜
jiae3	解=
jiae5	丯介价妎尬屆届恝悈戒=械溉玠琾界疥=芥解誡诫魀魪㑘㠹㳦㾬𠌰𡗟𡯓𢌵𤘦𤸋𦬉𫒞
xiae2	偕孩諧谐鞋鞵骸
xiae5	懈解
zuae2	跩转{傲慢}
zuae3	拽𢶀𰀀{扁擔～子}橛{扁擔～子}
zuae5	拽𢶀
cuae1	扠搋猜揣膗+啐
cuae3	揣
cuae5	嘬囆膪蠆膗+
suae1	夂榱縗衰摔䙑𤸬𧽠
suae3	璀𰔜甩摵*
suae5	帥帅淬焠𣰚
guae1	乖㨟*{碰}𠂯𧱾
guae3	夬拐柺㗗𣐷𦫳
guae5	壞夬怪恠襘𡌪𣲾
kuae1	㔞㧟擓
kuae3	擓㧟蒯
kuae5	儈劊刽會会噲块塊墤快檜澮獪璯禬筷膾駃㘨䈛𠜐𢼾𫂜
huae1	壞-
huae2	徊懷怀槐櫰淮瀤𤜄踝
huae3	㠢𡾝𡾨甩*
huae5	壞=坏=𢸬𣩹𧱳
uae1	歪
uae2	蛙-{～子：青蛙}
uae3	箉𢱉𨂿崴
uae5	外孬𠨃
lui5	汭芮銳锐瑞+泪+
zui1	嗺睢觜追錐锥騅骓𡙭𣖱椎
zui3	嘴㭰𠿘𥼂𭉨𭪿
zui5	墜坠惴憝懟最檇硾縋罪膇蕞贅赘辠醉隊䃍𡈚𨰩缀綴
cui1	催吹崔慛炊鏙𠷕𢕘摧
cui2	垂{縣志音}捶搥摧棰椎槌沝湷箠錘锤鎚隨-瘸=
cui3	倅崒悴漼琗瘁萃㯜䤵𣿒𣿓
cui5	倅啐悴橇毳淬濢璀睟粹翠脃脆脺萃邃㯔
sui1	夂娞尿+浽滖濉綏绥荽蕤衰雖虽靴=㳮𣻨
sui2	垂瀡誰谁辠隋隨髓㵦䭉
sui3	水綏绥𣸕
sui5	啐埣帨晬桵歲岁涗澻濊瑞-粹-璲睟睡碎祟稅税穗穟繀誶遂㱑㴚㽷𡻕𢅕𢇤𢇥𥝩𥠂
gui1	僞圭歸归珪硅瑰皈規规邽鄬閨闺龜龟䂓𣦨𨾚
gui3	佹姽宄恑晷癸祪簋詭诡軌轨鬼𣷾𤘧
gui5	劊刽撅桂檜櫃=柜=瑰貴贵劌刿跪=鱖𢈌𤡱
kui1	盔窺窥虧亏跪-櫃-柜-闚䯓
kui2	傀奎恢悝楏櫆烣犪睽葵逵馗騤魁䕫𠃳𢜽
kui3	傀揆跬䞨
kui5	匱愧憒愦櫃簣蕢虧{字彙音}亏{字彙音}餽饋馈潰溃㙺
hui1	幃幑徽恢拻揮挥撝暉晖楎洃灰煇翬翚虫虺豗輝辉隳麾㺔䖶𣸀𤟤𦭹盔{～堆甲：地名}會-
hui2	囘回徊恛檓洄痐茴迴𮞉
hui3	悔毀毁燬瘣芔𢙽
hui5	卉喙嚖寭恚惠慧憓晦會会檜桧櫘殨泋湏潰{字彙音}溃{字彙音}澮浍燘璯瘣穢秽篲繪绘膾脍芔蕙虫誨诲諱讳譓賄贿靧㜇㥣㬩䜋𠽡𣨶𣴵彙匯
ui1	倭偎唩喂威微=椳楲渨溾煨痿詴逶隈㙎𩗯萎{困倦}
ui2	危唯喡囗圍围壝峗嵬巍帷幃微-惟桅湋溦潿濰潍為爲为犩維维薇褘違违闈隗韋㣲㵟𨤒𮧮偉+伟+
ui3	亹偉伟偽僞伪委娓寪尾愇暐椲洧浘煒猥痿葦苇蔿薳諉韙韪㧪㬙䪘𣨙𥯤萎{枯～}
ui5	位偽僞伪叞叡味喂喟猬尉慰未渭畏磑穢緯纬罻胃菋蔚衛衞卫謂谓餧魏㥜㦣𢟬𣩪𦝩
ba1	妑巴扒爬疤笆芭葩豝鈀钯㿬爸吧
ba3	叭把粑㞎{～～：大便，儿语}㸭𢃳𥝧
ba5	垻壩坝弝杷罷罢耙覇霸靶䃻𢺞𣠽把{刀～}𥝧𩨜
ba	吧
pa1	耙趴𤆵{～蹄}
pa2	妑帕扒{～手}杷爬琶筢鈀𤧲
pa3	𥩙
pa5	帊帕怕派𢗌
ma1	媽妈駡-
ma2	痲蔴蟆蟇麻嘛
ma3	榪瑪玛碼码螞蚂馬马
ma5	傌嗎{～啡；俗骂字}吗{～啡；俗骂字}榪溤禡駡=䧞𢉿
ma	嗎吗嘛
da3	打
da5	大汏
da	咑
ta1	他她牠它
na2	拏拿挐𢮝
na3	那哪=𠈊
na5	那𢇵𢬻
la1	垃拉啦
la3	喇哪-{～块、～个}
la5	拉
za1	偧咱喳奓摣揸拃挓柤查楂槎樝渣皻蹅㗬㦋䵙遮
za3	吒蔗鮓砟𤯋𩻢
za5	咋乍夎怍昨柘柞榨溠灹炸砟笮蓌蔗蜡詐诈酢醡鷓䄍䋾䗪𣘻𣹧
ca1	乂叉嗏喳*差扠杈槎瘥艾車-{踏～：脚踏的水车}釵-𢩩
ca2	刹搽查茶㢉茬𡨀
ca3	𠻦𡗸𡛥
ca5	仛吒咤奓奼姹岔杈汊衩詫䟕𨀠
sa1	桬殺沙洒痧砂紗纱裟髿賒-鯋鯊鲨㠺㲚㸺䤬𡋷𣲓𣴷
sa2	蛇-佘-啥
sa3	傻儍洒灑𣳳𣶓
sa5	舍-厦=嗄𠚺𢇗
ga1	傢加-家-咖{～喱}
ga3	嘎尕
ga5	嫁-{寡妇再嫁}架-駕-尬嫁{寡妇再～}界{搭～}
ka1	抲{～脖子}揩{～油}咖{～啡}
ka2	咔{行动吃力}揢*{抢占}
ka3	卡
ka5	𧆠揢{握持}
ha1	下-{～雨、～劲}哈𨉣鰕
ha2	瘕*{鲁莽}
a1	丫-椏-砑
a2	伢芽-兒+而+牙-閕
a3	啞-爾+耳+餌+迩+
a5	二{縣志音}貳+挜垭*{～田}
a	啊
dia1	爹
dia2	嗲
dia3	嗲
nia3	𰍧*𰍨*
jia1	伽佳傢加=嘉家=枷珈痂笳耞葭袈豭跏迦䈔
jia3	假{真～；暑～}嘏姐-椵賈贾假?{～腰}假?{～巴眼}
jia5	價嫁=借-幏斝架榢稼駕驾𢜿𤙑
qia1	㢒㰤{小睡}笡{相～}
qia2	斜-瘸笳茄邪-
qia3	欹㿲
qia5	㿲
xia1	虾蝦鰕𨉣
xia2	瑕瘕蝦遐霞㰺𢝅
xia3	下厦哈夏閕閜㗿些-写-寫-
xia5	下寫{笔不～}写{笔不～}厦{～门、大～}夏暇疜睱罅諕{嚇}泻-瀉-卸-
ia1	丫呀夜-孲曰椏桠爹爺爷琊耶邪鴉鸦㝞㭨椰𠜲𥮳丫=𬼸
ia2	枒涯漄牙=笌芽=衙𤘅
ia3	啞=哑=瘂痖雅野-
ia5	亜亞亚埡垭婭娅庌掗砑迓訝讶䃁䛩𢛟
zua1	抓
zua3	爪
sua1	靴+
sua3	耍
sua5	刷{～净}䵘{～汤}𬓸{～汤}
gua1	瓜㧓
gua3	冎剮剐叧寡{拉～：闲谈}𠆣
gua5	卦挂掛褂詿𦊱𧬮
kua1	咵夸姱誇垮+
kua2	爬㓤?划*
kua3	侉胯{骻}骻垮
kua5	胯跨銙㡁挎𢓢
hua1	花芲華华鏵化{叫～子、興～}𢪎
hua2	划嘩哗找樺桦華华譁驊骅㕦㦊㭉
hua5	化杹畫{名词}畵華华話𤱪
ua1	剜哇唲娃媧搲洼溛漥窊窪蛙=騧㧓𡗷
ua2	娃
ua3	咓掗搲瓦𣁳{舀取}
ua5	瓦{～匠、～工、～刀}凹坳窊㘭𠹁𡗷𨥯洼
feu1	不吥芣
feu2	否坏抔殕缶裒𡜊罘
feu3	否痞缶𦈢
deu1	兜兠氀篼㨮𠱑𰚦
deu3	呌抖斗蚪鈄阧陡㪷𣁬
deu5	痘竇窦荳讀豆=逗酘鬦鬪鬭斗䇺𤀨𤅋𤞟𥥷𩰚
teu1	偷荳豆-
teu2	亠投頭頭𣪌骰
teu5	透
leu1	漏-瘘-
leu2	僂偻嘍喽娄搂{～取}婁廔慺揉柔楼樓漊熡縷羺螻蹂鏤髏㡞㺏䫫𡞔𧷡
leu3	嘍喽塿摟搂㧕{搅:～豆子}沑煣甊簍篓縷蔞蒌㝅𡗆𡭾𢔟𣫌
leu5	漏=獳瘺瘻耨肉=輮陋褥+𢉀𣤋𭼴
zeu1	侜周州徟掫洀洲淍緅舟譸賙週鄒邹鄹陬騶鯫鲰
zeu2	㥮㤘{脾气犟}扭?{物体没放平}
zeu3	帚箒肘菷走𢫧扭{双手拧}
zeu5	咒奏宙怞晝昼皺皱籀籒紂縐胄驟骤㵵𡘶𢃸𢓟𣻱𧛸
ceu1	惆抽搊煪瘳篘㮲
ceu2	儔俦圳幬帱惆愁懤㤽燽犨疇畴稠籌筹紬綢绸裯讎仇讐躊酧酬醻雔㘜㵞䊭䌧䲖𡕪𢛇𢤉𢥰𨞪𩯦絒?{清洗抹布}
ceu3	丑侴醜瞅𠹐
ceu5	凑揍湊簉腠臭蔟輳䔏𣽵
seu1	嗖廀廋搜摗收涑溲滫獀艘蒐醙鎪颼餿馊受-𠈅𢯱𣸈𤟫𨡻𩜯
seu3	傁叜叟嗾守手搜漱狩瞍藪首䈹𠻛𠻣𥈟
seu5	受=售嗖嗽壽夀寿授摗擻涑漱獸兽瘦瘶簉綬膄㖟䛵𠱔𤘀𤢚𤸂𤸃𥯴
geu1	勾句泃溝沟笱篝褠鈎鉤钩㡚㤎購+购+
geu3	枸狗耈苟㺃
geu5	个=個=冓坸垢夠够姤媾彀搆构構箇=購购覯詬豞逅遘雊㝤㨌㳶𣪬𤠼𥉇
keu1	彄摳抠瞘眍芤䁱𥱸
keu3	口𠮚
keu5	叩宼寇怐扣蔻𢽉𣻎𣿟𥲃𦸅
heu1	齁厚-後-
heu2	侯喉猴瘊睺□{～觉}矦篌鍭餱㺅䞀𠊱𣔹𣣠
heu3	佝吼吽犼𤘽
heu5	候厚后垕堠後=洉郈鱟㰯𠷋𨒥䞀□{朝前～}
eu1	剾塸慪摳敺歐欧毆殴漚熰甌瓯瞘蓲藲謳鷗鸥𣪅
eu2	牛-
eu3	偶嘔呕歐欧耦藕𣢨
eu5	漚沤𣽕怄
mieu2	繆缪
mieu3	繆缪
mieu5	謬谬
dieu1	丟丢
nieu1	妞
nieu2	汼牛=繆缪㖻䒜
nieu3	忸恧扭杻紐纽莥鈕钮
nieu5	忸衄謬谬䘐拗
lieu1	𤆀𧽖溜熘
lieu2	刘劉旒榴橊流瀏浏琉瑬留畱瘤硫磂遛鎏鎦镏鏐騮骝㻲𠗽𢞓𣹭𣹳𤥗𥆦
lieu3	柳桺橮綹绺𣒘
lieu5	塯溜磂窌遛㙀鎦镏餾馏𢕍𦉉
jieu1	啾□{～嘴}揪揫摎柩柾樛湫糾纠赳轇鬏鬮鳩鸠㸨䰗阄𩭓
jieu3	丩久乆九灸玖糾纠赳酒韭韮𡚮𨠊
jieu5	咎就廏廐慦救槱疚究臼=舅舊-旧-㾭{～筋：抽筋}𣪋𣸄𥦄𥦡
qieu1	丘丠坵媝楸湫犰秋秌臼-{碓～}舊=旧=蚯蝵邱鞦鰌鰍鳅鶖㚱㳋𤇫
qieu2	仇俅囚捄梂殏毬求汓泅浗渞湭球璆虬虯裘訄賕逑酋銶鼽㐜㛏㞗䤛𠗈𡲚𢛃𣭳𣰐𥭑𧺤𪖒
qieu3	倃搝□{瞎～}𢛃𩝠
qieu5	𪖛
xieu1	休修咻庥羞脩貅饈㳜𡯐
xieu2	嗅□{吸}
xieu3	朽滫㱙
xieu5	嗅宿岫溴琇秀糗綉绣繡臭莠袖銹锈鏥鷲齅
ieu1	優优呦嚘幽怮悠憂懮忧攸櫌泑滺瀀耰麀㴗黝+又-右-佑-釉-𠮫𢖒𢚐𢝊𣲏𩘈
ieu2	偤冘卣尢尤斿柚楢油浟游湭牞猶犹猷由疣繇肬蕕蚰蝣蝤訧輶遊郵邮釉㽕𣏞𧌕𨜚
ieu3	丣友庮有湵羑莠酉㕛𥝘
ieu5	佑=侑又=右=囿姷宥幼柚牖祐褎誘诱黝+釉=鼬䀁𡈹𥤃
bo1	包笣胞褒鮑鲍襃𠣒
bo3	褒+保凸堡堢宝寶怉葆褓飽饱鴇鸨褒=𠈃
bo5	報报怉懪抱=暴曝瀑爆菢=刨=豹趵鉋鮑鲍㬥㲒𣋏𣕅𣭀
po1	刨-抱-菢-拋抛泡爮胞脬𣶐
po2	匏咆庖炮苞袍刨跑-𡯚
po3	孢跑=
po5	奅炮疱庖皰砲泡麭㘐𣕅𣶐𪏶
mo1	帽-冒-毛?{上～：发霉}
mo2	旄毛渵犛芼茅茒蝥酕錨锚貓猫髦𤚐
mo3	卯昴㧇
mo5	冃冐冒=媢帽=毷瑁眊耄萺貌㒵㡌㴘𢝌𣔺𣭢𣴟𥈆𨩩
do1	刀忉釖魛鱽叨
do3	倒壔島嶋岛捯擣捣禂禱祷道㠀捣搗㨶悼+𥛇
do5	倒到噵導导幬悼燾盜盗稻=衜蹈道䆃毻
to1	叨夲幍慆搯{拳击}洮滔稻-絛縚縧韜韬饀饕
to2	匋咷啕掏桃檮洮淘濤涛綯萄迯逃醄陶鼗𢔇𣴧
to3	討讨
to5	套𡘷
no1	孬
no2	峱怓撓挠橈桡猱硇鐃铙饒饶㺜𢜸𢪼𢫤𣲿
no3	惱恼瑙腦脑𢙉𣭺𣭽𤤼𧩣
no5	橈桡淖獟瑙鬧闹𠅈𠆴
lo1	撈{～一把}繞-
lo2	澇僗勞哰嘮唠嬈撈-{打～}浶牢窂蕘醪饒饶𠈭𤎤
lo3	恅擾扰潦繞老佬遶𡂕
lo5	僗嫪憦澇癆繞=绕=耮
zo1	佋傮召妱招昭沼{～氣}朝糟詔蹧遭醩釗繰缲㯥𣩒
zo3	找抓早皂-枣棗沼澡爪璪藻蚤𣅼𧎮
zo5	兆召唣垗懆掉旐曌棹櫂氉灶炤照狣皁皂瞾竈笊箌罩肇肈莜蓧詔趙赵躁造+㡽䈃䈇𥵢𫁘
co1	剿叉怊懆譟{大聲叫喊}抄摷操漅耖超鈔䜈𠰉𠻥𨮽訬*
co2	嘈嘲巢曹朝槽漕潮窼螬鏪𡮦𣍘𣶃𥕢𩞄
co3	吵愺懆炒煼眧艸草謅騲㥮钞+㷅𠹊
co5	仯慥漕糙覞觘造鈔+㿷𢲵𤰬
so1	慅捎搔杪梢溞燒烧稍筲繅臊艄蕱騷骚髾㥰䈰䘯𨃣{踢脚}𠋺𢔳𤠘𥵦𦿃𨈘
so2	佋晁玿紹绍韶鼂㲈
so3	埽嫂少掃扫㛮𢾐
so5	劭卲哨噪少燥瘙紹譟趮邵苕龆*{頭～子：第一個孩子}鐰䏴𢜶𢤁𣕇
go1	橰櫜皋睾篙糕羔膏教-{～你}茭-臯餻高鼛䓘𠆪𥮑交{遍}
go3	夰攪搅杲槁皜稁稾稿縞缟㚖搞
go5	吿告窖誥诰郜膏{～油}覚觉酵𡜲叫-{～化子}交{量词}斠{調試}
ko1	尻敲-
ko3	嚛拷攷洘烤熇祰考薧𣧏𣩅
ko5	搞犒靠銬铐
ho1	蒿薅𢫩
ho2	噑嚎壕毫濠號号豪㩝𠰘
ho3	好恏悎昊昦晧暭滈皓皞皡鎬镐𡘏
ho5	好浩淏澔灝灏秏耗號顥㙱㚪㬶𤅡𤝐
o1	爊鏖噢
o2	侕兒厫唲嗷婗廒摮敖滶熬獒璈翺而輀遨驁鰲鷔𣘢𦪈𨅚𩪋
o3	咬嚙媼尒尓懊洱爾珥耳袄襖輀邇鉺餌駬齩㛅
o5	二{字彙音}佴傲凹墺奡奥奧弍慠扷抝坳拗澳擙柪樲澳狕穾衈袎詏貳鏊隩㒃㥿䫨𢳆𣵽𥃺𥑑𩑍
bio1	彪杓標标滮瀌猋膲鑣飆飙飇驃骠麃䁃䁭𢖐
bio3	婊表裱錶
bio5	瞟鰾鳔膘{肉～}嫑
pio1	僄幖彯漂縹缥颩飄飘𣻔
pio2	嫖瓢㯱朴
pio3	摽殍瞟縹缥莩蔈䙳𠬪𣨈
pio5	俵勡彯票㬓漂𣊠𤾛
mio1	廟-庙-
mio2	描猫緢苗貓瞄
mio3	淼渺眇秒緲缈藐邈𦳥
mio5	妙庙=廟=玅繆缪
dio1	凋刁叼刟奝彫琱貂雕鵰㓮㨄䫸𠚥𠛪𤙴𦨣{海～子：航海的大船}𧜣
dio3	屌
dio5	伄吊弔窵訋調调掉釣钓銚铫𢎣
tio1	庣挑旫祧𠛪調-调-{～頭}條条{一～鱼}
tio2	佻岧条條笤苕藋蜩調调迢髫鰷齠斢{调换}
tio3	眺祧窕誂䠷挑
tio5	彌掉眺糶蓧覜跳頫粜
nio1	尿-溺-
nio3	嫋繆裊袅鳥鸟𠄏𠌵
nio5	嬲?{挣扎}尿=𡲘
lio1	膋撂
lio2	佬僚嘹嫽寥寮屪尿+廖撩繚缭敹暸橑漻燎竂簝聊膋遼辽療疗鐐镽髎鷯㞠㵳
lio3	了尞憭漻燎瞭繚缭蓼䄦裊袅𤁸𨣀
lio5	尥撩料爒獠療{字彙音}膋𥛰𦌒
jio1	交僥侥僬咬噍姣嬌娇跤憍梟椒澆浇焦燋膠胶膲茭=礁蕉蛟蟂教{～书}郊驕骄鮫鷦㚣䩌𣻏𤀴𤊙𤓪𤓬
jio3	儌剿劋勦徼恔憿捁撟攪搅暞狡皎皛皦矯矫絞绞繳缴餃饺僥侥㽱䥞𠞰𤶀
jio5	叫呌嘂噭嶠挍教{～育}枛校潐爝窌覺觉趡較轎轿教醮釂鉸𠘣𢥚𥦿
qio1	墝墽幧繰缲撬敲=橇磽硗趫蹺跷{～腿}蹻鍫鍬锹鞽㚠㡑
qio2	僑侨喬乔憔樵橋桥瞧翹翘{变形}荍蕎譙谯㝯䀉𦒏
qio3	巧悄愀𢒾𨲭
qio5	俏哨峭帩悄愀翹翘撽竅窍撬+誚诮陗䆻𠿕𢶡𥤾𥦂
xio1	哮嘐囂嚣宵枵{薄}梟櫹歊消瀟潇硝磽硗箾簫箫綃绡翛蕭萧逍銷销霄魈鮹鴞鸮㺧𢸳𣱩𤄙𤣠𧳍
xio2	崤殽洨淆爻猇笅肴誵肴郩餚㤊𢛘𤞚
xio3	小曉晓筱篠𥭪
xio5	傚効咲哮嘯啸孝庨恔效斆校涍笑肖鞘酵=魈𣹝
io1	仸吆喓喲哟夭鷂鹞+妖幺枖祅窔腰要邀䄏䙅𢆽𣧕
io2	垚堯尧姚嶢峣嶤鷂鹞徭愮搖摇暚榣洮猺珧瑤瑶窑窯窰謡谣遙遥颻飖㨱𢭌𢳘
io3	偠杳殀眑穾窅窈窔舀㫐㴭䆞𡛙
io5	曜燿耀躍+跃+要鷂鹞㿢䌁𢆷𢲷𧇠𪖘
baen1	扳掰{扳}攽斑斒朌班螌頒颁般=癍𤤻
baen3	板版坂阪舨鈑钣
baen5	扮瓣辦办=辧𢴬
paen1	攀眅办-{忙不～}𠆪
paen2	湴爿踫𨂝{～河}
paen5	盻盼絆{～个跟頭}䙪
maen1	䟂慢-
maen2	蛮蠻䅼
maen3	矕
maen5	僈慢=漫縵缦蔓謾谩熳㵘䟂𢢔
faen1	帆+藩+幡憣拚旛番眅翻颿飯-𤄜𤄫
faen2	凡墦帆矾樊煩烦燔璠礬笲繁膰舤舧蕃藩蘩𥢌𩗋
faen3	仮反坂岅畈返阪𢓉
faen5	乏奿婏梵氾汎泛滼瀪犯笵範范販贩飯=饭=帆+㤆㽹𠆩𧶶
daen1	丹儋勯匰单單擔担殫殚癉瘅眈砃坍{新～：地名}簞箪簟耼耽襌鄲㴷𠕑𣅟𥣲
daen3	亶刐担撣掸胆{膽}膽䃫
daen5	但僤呾妲弹彈憚憻担旦淡=潬疸石笪蛋誕诞鴠㡺氮𠻪𢅒𢎚𢎫𢎬𪉧
taen1	坍攤摊欿灘滩癱瘫痑{疲惫}蛋-淡-貪贪㵅𤁤
taen2	倓坛壇壜昙曇彈弹惔檀潭澹痰繵罎覃談谈譚谭鐔镡䉡𡐧𤮦𤺺𥰨
taen3	倓啖啗坦埮忐憳毯璮禫窞菼萏袒醓髧㫜㲜毯䏙𧝓
taen5	僋嘆叹坍{墙～下来了}碳探撢歎湠炭𢾡𨂞
naen2	侽南喃娚枏楠湳男蝻難难𠲸
naen3	戁揇罱赧
naen5	攤摊難难𢺋
laen1	纜-缆-爛-臘+{～月}
laen2	儖婪嵐岚幱惏攔拦斕谰欄栏瀾澜籃篮籣藍蓝蘭兰襤褴襴闌阑𡮻𣋣
laen3	嬾懶懒攬揽爁覧覽览㰖榄𢞥𤑸
laen5	懢漤濫滥爛烂=纜蘫䑌𣩼𣽦𧸦
zaen1	孱嶃嶄+摲簪鐕㔆𠟆𡭞𥕌𦢤劖{～肉：肉圆}
zaen3	儧喒拶斬斩琖盞盏醆䟎嶄崭
zaen5	偡囋嶘暫暂棧栈湛濺灒𪷽㳨瓚禶站綻绽蘸譖讚賺贊赞跕鄼鏨錾饡𱄊𣳤𥩠
caen1	參参叅攙搀掺惨+飡餐驂䱗𠣄𠫵𡮿𥴷𩼇
caen2	儳慙慚惭戔欃殘残毚蚕蠶讒谗鑱饞馋㥇㨻㱚孱潺𢦸𣧻
caen3	丳剗剷慘惨谄+旵滻產产穇䅟羼鏟铲驏黲㦃㦧䊲𨪑
caen5	懴忏摻攕灿澯燦璨粲㛑㬱䜟𢖱𢺟𣻬
saen1	三删卅叁参姍山彡摻杉澘珊穇芟衫舢跚𢇢𣬛𣲀𥤇𦳫
saen3	傘伞摲散汕糝繖饊馓㨻㪔𠍘𢄻
saen5	俕散柵潵疝訕讪汕釤㣌𠚹
gaen1	乾亁干忓攼柑泔犴玕甘疳肝豻頇㤌尷尴監-监-間-𤮺𤯌
gaen3	感擀敢杆桿橄澉𦪧{走～：船舷}灨盰稈秆竿簳赶趕揀-𣔼𦼮𦾮
gaen5	幹斡{幹}旰榦干{幹}汵淦濣紺詌贑贛赣間-𢁗
kaen1	刊堪鉛铅鵮龛勘看嵌𢦟𢽣
kaen3	侃凵勘坎=埳塹欵款砍窞㙳㦿嵌槛𠈉𣽌
kaen5	勘嵌槏看瞰矙闞㟛㪠𡰶𥉏
haen1	憨粯𬖑莧苋-蚶酣鼾汗-餡-陷-限-{不～定}𣵷
haen2	函凾含=咁唅啣圅寒=梒浛涵菡邗邯醎銜-韓韩鹹咸㖤晗闲𠀟𡋶𣐺𣹢𣽬𧑚
haen3	喊憾撼暵琀罕頷𡒓
haen5	悍捍撼旱桿汗=浛涆淊漢汉瀚焊熯粯翰莧=苋=餡=㢨罕
aen1	侒偣安=氨庵淹荌菴諳谙鞍鵪鹌雁-岸-{南洋～}
aen2	顏颜岩𩪋
aen3	俺揞眼罨隌銨铵
aen5	偐妟姲岸=按晏{晚}晻暗=曣案桉洝犴腤豻雁=鴈鷃黯㬫
jiaen1	奸姦姧尶監=艱艰蕳間间=𥌈
jiaen3	揀=柬椷減减碱簡简緘缄鐧锏䶢𥻇
jiaen5	檻澗涧監监瞷艦舰諫谏鍳鉴鑑鑒間=
qiaen1	刊慳
qiaen5	掔瞰矙闞
xiaen2	函凾咸嫺嫻娴崡緘缄閑閒闲鷼銜降-𢔈
xiaen3	僩豏
xiaen5	俠惂限=陷=餡=馅=㡾𣐻𨵬
zuaen1	潹潺跧{弯腰}
zuaen3	僝喒{早晚的合音}
zuaen5	僎撰譔𬤥賺赚饌馔𢰅
cuaen1	賺-
cuaen5	創+创+㦼𢺟{插}
suaen1	珊栅姗删拴栓跧閂闩疝𢩠𣟴赸{赶}
suaen3	摲
suaen5	汕涮狦疝訕
guaen1	菅関關关鰥纶𡮟𢇇
guaen5	丱卝慣惯摜掼擐𣩔
kuaen1	掼-{摔、耽誤}
kuaen2	圜奻寰環环鐶蜷-{弯腿、蜷缩}𡑡𤨔
huaen1	懁{～𢜶：快}𦌦
huaen2	擐澴還还鬟𢕼
huaen5	宦幻患豢𠄔𣥌
uaen1	弯彎湾潫灣萬-㘤𡇿
uaen2	頑顽𤸷
uaen3	娩挽晚綰绾輓
uaen5	獌萬=蔓薍贎𦱏
bu1	嶓波玻菠裒褒襃𣴫般
bu3	播簸{顛～}跛
bu5	簸{～箕}
pu1	坡陂𤀪
pu2	婆媻皤
pu3	剖鄱叵笸尀岥頗颇𣲳
pu5	破
mu1	磨-礳
mu2	侔堥墲恈摩摹擵模橅氁洠牟獏饃馍眸矛磨藦蘑蛑蝥蟊謀谋謨謩鍪髍魔麰䃺𢂳𢃱𢘓𥍤
mu3	丘{孔子名，本音秋}姆姥娒拇某母牡畝亩畮麽么𡭚𢟨𤘥𤚴𤵝𧰷𧿹
mu5	募墓愗慔慕懋暮楙磨=茂袤貿贸㮘𧴵𧵍
fu3	否+
du1	多𡖇𡖈
du3	嚲亸垜垛朶朵跥{字彙音}躱躲軃㛆㛊𣏻𦕰𩬻
du5	刴剁垛垜跥跺墮堕惰柁柂炧舵𭩥𮃄
tu1	拕拖
tu2	佗它沱沲狏砣紽詑跎迤酡鉇鉈铊陀馱驮駝驼鮀𬶍鴕鸵鼍鼉㾃𣵺𣵻𤝛𤵚𥓿𥹈𨈷𰶿
tu3	堶妥扡挼撱橢椭㨊䅜𣷿
tu5	唾蜕{～皮}
nu1	稬穤𤲬
nu2	伮儺哪奴娜孥帑挪砮笯那駑𥑌
nu3	努娜弩樐櫓橹艣艪
nu5	怒愞懦稬穤糯
lu1	摞-螺-覶覼
lu2	儸㑩囉啰𣎆驘擩攞欏氌籮箩罹羅罗腡脶{手指纹}蘿萝螺蠃邏逻鑼锣騾骡𡏱𥡜
lu3	倮剆{切}擄攞㦬瘰蓏虜{字彙音}虏{字彙音}裸𠿛𪌳
lu5	砢䌱摞=𨇽
zu1	矬𩛠銼
zu3	左𠂇𠡃𡯛
zu5	做+坐=佐夎座袏𠱯
cu1	坐-剉夎嵯嵳搓瑳矬磋艖莝蹉鹺
cu5	銼錯+错+䟶𢚂剉挫
su1	唆嗦{啰～}娑桫梭傞簑莎莏蓑趖㛖㛗䓾𥆝𥇇𥭟
su3	嗩惢所瑣琐璅鎖锁鎻鏁𠝿𥔭
su5	𪍌
gu1	哥堝戈歌渦{水名}涡{水名}渮滒濄過过{超～}鍋锅㽿𩰭
gu3	倮惈果淉猓粿綶菓蜾裹錁餜䴹𥁁𥰮
gu5	个-{～子}個-箇過过
ku1	堁柯棵犐珂科稞窠笴苛蝌軻顆颗
ku3	可坷岢舸蓏?裸?㪼㰁?㾧𣸌
ku5	課课錁騍
hu1	呵炣訶诃㗾𬉸
hu2	和何啝姀惒柇河澕盉禾苛荷㘞回{下～、～頭}𤖱𠰓𥞄
hu3	火伙夥㚌𡖿
hu5	抲楇禍祸荷貨货賀贺㘞𢬲𢼽𣨱𧴦姡
u1	餓-饿-倭唩妿婀屙涹渦涡蝸蜗疴痾窩窝萵阿㚳䆧䋪𡑟𡱻𣚝
u2	俄哦囮娥峨莪蛾訛讹誐譌鵝鵞鹅𧚄
u3	妸婐我=䂺
u5	卧臥餓=饿=涴
bun1	搬般-䈲
bun5	伴半姅怑秚絆㪵
pun1	潘磻拌{～命}𢬵
pun2	媻捊搬搫柈槃瀊盘瘢盤磐蟠鞶𠽲𡂑𤠍𨃞
pun3	坢𡗹
pun5	冸判叛沜泮溿牉畔㚘頖
mun1	漫-
mun2	墁慲曼槾瞞瞒縵謾蹣鏝顢饅馒鰻𡑦𧜞
mun3	滿满蟎螨
mun5	幔漫=澫澷蔓𣸞
dun1	剬端篅鍴𥬫𧤗
dun3	剸椯短踹㙐𢭃𥠄
dun5	断=斷椴段煅碫籪簖緞缎鍛锻㫁
tun1	湍貒断-
tun2	團团坛-慱揣摶湍漙煓猯䊜𩜵
tun3	疃瘓髧
tun5	彖楕湪褖
nun2	南-𡖝
nun3	暖煖渜稬餪㬉𣆝𤏙
lun1	乱-
lun2	圝堧婪嵐巒峦惏撋攣挛欒栾葻鑾銮鸞鸾㞩㡩㨎𢺈
lun3	卵愞軟輭软阮檽㮕𢘎𥦝䞂𧸀
lun5	乱=亂𡄹𣨀
zun1	專专甎磚砖耑鑚鑽钻顓颛膞䏝{鸡～}
zun3	囀昝纂纘轉转鐏鑚
zun5	傳传堟揝撍瑑篆鑽钻转
cun1	巛川汌穿遄釧钏䆤汆
cun2	傳传掾攅椽篅舡舩船䒃蚕-{～豆}𦩍
cun3	僢喘穇舛黲㱛䅟-𥬫
cun5	串攛汌爨竄窜篡纂釧钏㸑𢸥
sun1	酸狻痠
sun3	𩆑
sun5	筭算祘蒜䐶𥫫𮅕
gun1	倌冠官棺觀观𢃙𥍕
gun3	感-赶-斡筦管脘舘輨錧館馆䘾𥭨𦜐𬋩
gun5	丱毌泴淉灌瓘盥祼罐觀观貫贯鏆鑵鸛
kun1	寬宽看-
kun3	欵坎-{河浜～子}冚𠖫款-歀𣤂𣽟
kun5	看-
hun1	懽歡欢犿獾讙貛驩汗-蚶换-𡚊
hun2	韓-韩含-寒-
hun3	憾-𤀣
hun5	喚唤喛奐奂愌𢚾換换=浣渙涣漶煥焕瑍㪱痪𧶲
un1	剜岸-安-帵弇眢豌
un2	丸凡{同丸}垣完桓瓛紈纨芄萑豲𡘍𥥣
un3	埦婉宛捥桉椀涴琬盌碗㼝䝹皖腕惋畹豌+
un5	妧忨惋浣澣濣玩睆睕緩缓翫腕莞㣪䯛暗-𣴼{同浣}
jiun1	姾娟悁捐涓獧睊蠲鐫镌鵑鹃
jiun3	呟卷啳捲錈锩𢍏𩜇
jiun5	倦劵+卷埢帣慻棬淃狷獧眷絹绢綣绻毽-圈=蕈菌㢧𠉮𢛗𣙢𥆞𨤓𨤖
qiun1	圈{圆～、猪～}棬𡈕
qiun2	全姾帣弮恮惓拳栓權权泉湶牷痊筌詮跧踡顴鬈㒰㩲𠤹𢂘𣹻𤷄
qiun3	汱犬畎𤰝
qiun5	券勸劝𢍕𣒀
xiun1	亘仚吅咺喧塤壎嬛宣愃愋掀揎昍晅暄烜瑄秈籼萱萲藼蘐諠諼讙軒轩轘駽㩊
xiun2	埍懸悬旋泫漩炫玄璇璿眩翾衒鉉铉弦㳬𢕼𢳄𤜼𤣥
xiun3	僎渲癬癣選选𤂿
xiun5	券旋楥楦眩絢绚鉉铉鏇镟颴㧦𢳄𦌔
iun1	寃冤惌淵渊渁灁鳶鸢鴛鸳㠾㶜𣴸𣴺𣾜𤀵
iun2	亰元刓原員员园園圓圆圜媛嫄援杬榞榬櫞湲源爰猨猿獂瑗緣縁缘芫袁轅辕騵鶢黿㥳㹉𡊮
iun3	遠远
iun5	夗妴怨愿掾瑗苑衏院願愿𢖭𥧛𨙨𭜨
bii1	卑埤庳悲杯桮盃碑箄蓽裨陂蓖+{～麻}背𢃍𤰞𥓓
bii3	匕+比-
bii5	俾倍偝偹備僃备奰婢帔幣币弊悖敝棓焙狽狈獙痺糒背臂蔽薜被褙貝贝貱贔軰輩辈避閉闭陛髲㡀毙+𠍯𡚁𢖬𣖾𤰈𦮷𦯞
pii2	培掊裴賠赔陪㟝𡌮
pii3	俖琲
pii5	佩偝呸姵嶏斾旆柭沛派淠濞珮譬轡辔邶配㤄𢁖𨚍
mii1	咪+渳+
mii2	侎咩咪哶堳塺媒嵋弥弭彌弥枚梅幭楣楳渳湄湈煤玫珻痗眉睂禖糜縻蘪迷郿酶醚醾醿鋂莓霉靡麛黴㙁䕷謎谜𢘺𢞞𣒫𣨴𤦀𩔢𪃏
mii3	乜凂哶敉每洣浼镁渼眯禰米+美羙䖹𡴕𣫭
mii5	妹媚寐昧沬瑁痗眛袂謎谜魅䀛
fii1	啡妃扉渄緋绯蜚霏非菲靟飛飞騑
fii2	淝痱肥腓𤷂𩇯
fii3	匪吠奜悱斐棐榧篚翡菲誹诽㥱𫅪
fii5	剕吠廢废杮疿痱癈肺芾費费䉬䕠𣏕𣙿𥝈𥳊
dii1	爹=垖堆壝嵟㢈䏨𠂤𡸠𡺾𣳨𥑵
dii3	謉𠡒㨃
dii5	兌兑对對憝憞懟怼涗濧碓譈隊队駾㬣𡭊
tii1	推
tii2	穨隤頺頽颓㿉魋弚
tii3	腿
tii5	毻蛻蜕退褪=
nii3	妳伱你儞餒馁
nii5	內内汭芮
lii1	擂{～～：赶牛号子}泪+
lii2	壘{字彙音}垒{字彙音}擂礧羸藟雷累{～赘}㵢𦢏
lii3	壘垒儡蕾惹=磊理耒洡㵽𡚗𢜪𠰒
lii5	偌唳泪+淚睙累縲纍類㴃𤁾𣈪瑞
zii1	㸙𠌮
cii1	硨砗蛼車车
cii3	扯撦哆
sii1	賒赊奢𧴳
sii2	佘蛇
sii3	捨舍
sii5	厙厍舍射社赦麝𢼜
jii1	嗟罝㚗
jii3	姉姐怚
jii5	借=
xii1	些𡭟𡭥
xii2	邪=
xii3	且冩寫=些
xii5	卸=瀉=榭謝谢㓔㴬㵼
ii2	爺爷
ii3	也=椰=冶墅野=鎁埜
ii5	亱夜=㖡
bin1	囨楄猵稨籩笾編编緶萹蝙边邊鞭鯾鯿鳊
bin3	匾惼扁揙稨窆藊褊貶贬𢴂𥤓𧴷
bin5	便卞=弁徧忭昪汳汴窆變変变辨辮辯遍鶣㳎㵷𣸇𤀫𤀲𥍚
pin1	偏卞-犏箄篇編编翩蹁㾫
pin2	便諞賆輧駢骈骿𠷊
pin5	弁徧片遍{～地}騙骗㓲㴜
min1	麪麫麵面-
min2	宀愐棉眠綿绵緜𡒳𡯫𣏜
min3	免冕勉娩愐沔湎澠眄緬缅㝃㡈䤄𨡞𬗟𭰫
min5	偭面靣麪麫麵面=㴐𥸴𬹃
din1	傎巔巅掂敁滇癲癫磓顚颠𠑘
din3	典捵碘点蒧點店+𠔓
din5	奠=佃坫埝墊壂店惦踮殿沾淀澱玷甸砧簟趝鈿電电靛㼭𣪍𤘠
tin1	天奠-沗添祆靝𣸸
tin2	塡填屇嵮恬搷沺沾滇甛甜田畋盷磌窴菾䧃𢇶𥪧
tin3	咶忝悿晪殄沴淟腆舔覥餂㤁㥏𥪌𧨩
tin5	掭栝舚㐁㮇𠀬𣒂𣓱𦧖𦧻
nin1	拈艌
nin2	姩年鮎鲇粘黏𥝝怜+
nin3	埝撚涊淰碾捻跈輦辇攆撵輾辗齞𡰫𢲳𤁥𨋚
nin5	唸念錜
lin1	楝-鏈-
lin2	嗹奩奁帘廉憐怜溓漣涟濂濓然燃璉琏稴簾籨縺聯联臁蓮莲薕連连鐮镰鰱鲢㦁㾾𢅖𢇣𢊴𤡮
lin3	冄冉姌染臉脸苒髯㚧㚩𥬕
lin5	孌彙恋戀戾斂敛楝歛殮殓澰瀲煉炼練练萰鍊㱨𧍴鏈=链=
zin1	占{～卜}幨惉旃旜栴毡氈氊沾添痁瞻粘襜詹譫輾邅霑饘驙鱣鸇㙴㫋㮵𡖞𡝫𣒰𣭣
zin3	展搌{～布}蕆蹍輾辗颭㞡
zin5	佔占{～领}戰战顫颤
cin2	儃嬋婵廛澶瀍禪禅纏纒缠蟬蝉蟾躔㙻
cin3	奲諂谄𢁧
cin5	幝纏缠{～麪}闡阐䦲䵖
sin1	膻扇煽單-
sin3	善晱睒閃闪陝陕㨛㴸
sin5	傓善單单扇擅禪禅笘苫鱔鳝蟮膳繕缮贍赡䄠𥰢
jin1	兼堅坚尖幵戔戋搛{～菜}湔瀸煎牋箋笺籛縑缣肩蒹
jin3	偂儉俭剪囝戩戬揃撿捡梘檢检筧笕繭茧翦謇趼蹇鬋㨵𢆞𢦞𣦃𣳲
jin5	件健僭劍剑唶建晛楗毽=洊湕漸渐濺溅牮箭聻荐薦見见譖谮賤贱踐践鍵键韉餞㝺㣤𣿕𥑼𥤆𭸠
qin1	仟僉千圱圲奷愆扦搴攐汘汧牽牵簽签笺+籤褰謙谦迁遷阡韆纎{縣志音：～維}殲{縣志音}騫骞㔐䇂件-𢕆𢫀𢳍𢴡𣢬
qin2	乹乾仱前媊扲拑揵撏挦{～毛}湔潛潜濳箝蚙誗鉗钳錢钱黔䖍虔𢁮𣦃𣦖𥮠𧨾
qin3	忏淺浅繾缱譴谴遣㹂𡒌𣻝𪘦
qin5	俔倩刋塹慊棈槧欠歉箐篟縴{拉～}芡茜㐸
xin1	仙仚僊先奾妗孅掀=摻暹杴殲{字彙音}祆秈纎纖羶薟襳蹮躚軒轩鮮鲜鱻𧞬
xin2	嫌弦舷慊絃臤賢贤贒𢎙𢎺𢛆𥲋
xin3	尟尠岘嶮憲宪毨洗獫猃玁禒筅箲臔蜆蚬跣銑閃險险顯显鮮鲜㦓䘆𢞩𩔰
xin5	晛献獻現现瓛綫線线縣縣羡羨霰峴岘腺
in1	咽嫣淹烟焉煙燕胭腌臙荌菴菸蔫鄢醃閹阉鞍鵪𡙷𤊗𧹢𧹬𩸆
in2	嚴严儼俨埏壛姸妍嵒嵓巖延揅檐沿涎炎癌硏研碞筵簷蜒言閻阎閆闫鹽盐㳄㳭㵪䇾𣳧𣵿𣹺𥂁
in3	偃儼兗剡厴厣唵埯堰夵奄广弇愝懕扊掩揜晻棪椻渰渷演琰硽罨衍躽闇靨㭺䅖䤷𡘹𣄑𥀬𥈔𥍻𥜒𥣘𥤴𧽉
in5	厭厌唁喭嚥咽壓宴彥彦掾暗灔焰焱燄燕爓硯砚艶艳覘諺谚讌讞豔醼騐驗验魘黶䞁堰埝𣄑𤝴𧰚𨡎𪈏𪑈
ban1	垹帮幇幫搒梆浜邦㙃㨍
ban3	㮄榜綁绑膀
ban5	傍塝棒棓磅{～秤}稖謗谤鎊镑㭋𣘙
pan1	乓肨{縣志音：浮}
pan2	傍塝徬旁滂胮膀{～胱}磅{～薄}螃逄龐庞彷㥬㫄𢄎𢔚𣶢
pan3	覫髈䠙耪
pan5	胖䐟
man2	尨庬忙恾汒浝牻盲盳硭笀芒茫蝱邙鋩㟐䅒氓𡜋𥆙𥝕𦬆𩭒
man3	漭莽莾蟒蠎䁳𣾘
man5	𥭚
fan1	匚坊方枋汸淓牥祊芳雱㤃
fan2	埅妨房防魴鲂肪
fan3	仿倣彷放眆紡纺舫訪访髣㕫
fan5	放
dan1	儅噹檔澢璫當当簹襠裆鐺铛𡭠
dan3	党攩檔挡黨𫽮
dan5	儅圵宕愓擋璗當当档盪碭砀凼簜蕩荡𢠽𢡂𣿘
tan1	湯汤盪荡-鏜鼞搪{挡}𢴳
tan2	傏唐堂塘搪摚棠溏漟糖膛螗螳赯餳餹㭻𠹔𧱵
tan3	倘偒傥儻帑淌盪躺耥钂
tan5	燙烫趟
nan1	齉-囔囊{皮肤松弛}
nan2	囊
nan3	囔攮{～风船：帆船}
nan5	齉
lan1	儴攘瀼禳㫰-{晾}浪-让-𣰶
lan2	崀廊桹榔欴浪狼琅瑯鎯𨱍瓤硠稂穰莨蓈蘘螂躴郎閬㝗㟍㢃㱢㾿䆡䯖𦵧
lan3	嚷壤朗爙㫰{同朗}𣊧𧚅
lan5	埌浪=讓让閬㫰=𣻡
zan1	墇嫜張张彰慞樟漳獐璋章蟑臧賍贓赃髒脏麞㮜𢕔𪅂
zan3	仉掌涱漲涨長长鞝𠫝
zan5	丈仗塟帳帐扙杖漲涨瘴脹胀臟脏葬藏賬账障髒㙣𮍄
can1	倀伥倉仓倡傖伧唱娼愴昌淐滄沧猖琩瑲玱舱菖蒼苍螥閶阊鶬䗉尚{和～}𢃑𦞛
can2	償偿嘗尝嚐場塲场嫦常徜甞腸肠藏長长鱨㙊㵴㶓𠹉
can3	僘唱廠厂摤敞昶氅场{～子}
can5	倡唱悵怅摤{～痒}暢畅淌鬯𥇔
san1	傷伤商墒桑殤殇滳漡裳觴觞謪䘮丧上-𤳈𤹟
san3	上嗓扄搡磉褬賞赏顙晌𣞙
san5	上=喪丧尚慯緔绱
gan1	剛刚堈堽岡冈崗岗扛杠江-疘矼綱纲缸罡肛豇釭鋼钢㟵㼚𠵹𤦇𤭛𤭺𥃽𥬮
gan3	港𠅣{挤}𣽣𣿑
gan5	扛掆㧏摃扛槓杠焵钢{～刀}虹-𡎴𢭎𥒳
kan1	嵻康漮穅糠躿㝩㱂䆲项+{颈～}𡻚
kan2	夯
kan3	忼慷
kan5	亢伉匟囥抗炕犺砊𥒳
han1	項项-夯巷-𤼍
han2	吭杭航行绗絎桁貥頏䋁䘕𬠽
han3	夯㰠
han5	妔巷=笐行衖項项㟟𥮕
an1	骯肮䱀𩹡怏{～脑子：皱眉頭}
an2	昂
an3	咉醠炴{～烟：冒烟}
an5	枊盎𠹃𣉗𧪪
nian1	娘孃{～～：姨母}
nian2	娘孃釀凉+
nian3	仰-
nian5	曩釀
lian1	亮-踉𪳄{～子：水桶}
lian2	俍凉惊梁樑涼稂粮粱糧綡良量䣼𡮎𣌣𥞹𩗬
lian3	両两倆兩輛魎𣓈
lian5	亮=倞哴喨悢晾諒踉量𠅙𪳄
jian1	僵壃姜將橿殭江=漿畕畺疅疆礓繮缰薑韁䗵𠘌𥬮
jian3	奬槳獎耩蔣講膙{老～}
jian5	佭匞匠=夅將洚絳醬降犟强糨𢘸𤝷
qian1	匠-傹嗆埪戕戧戗{～枕}斨椌槍熗𪉨{～虾}瑲羌羗羫腔謒跫蹌鎗鏘䬕像-𡉉𢦤𩩝
qian2	勥墻嬙庠廧強强彊檣洋牆痒祥羊翔薔詳襁㩖𢉈
qian3	勥墏强搶摤磢襁鏹
qian5	傸嗴弜弶{～港}戧摪謒謽蹡䉃鏹𢪇
xian1	勷廂厢湘缃瓖相箱襄鄕鄉鑲镶香驤骧麘䅨𤉪𤷼
xian2	降
xian3	享亯响嚮恦想慯晑曏響項餉饗飨鮝𥖡
xian5	像=向晌曏相象橡𢄵
ian1	佒央姎殃泱秧鞅鴦㹧樣-𤢐
ian2	佯崵徉揚昜暘楊氜洋煬痒瘍眻禓羊陽颺𢒑
ian3	仰=痒勨懩攁瀁癢痒養氧
ian5	怏恙樣=漾盎羕㨾㺊煬{火旺}𢓋𢟣𢵇
zuan1	妝庄樁淙粧莊桩裝㽵𣻛𪁈𪄻
zuan3	奘
zuan5	壯戇撞=淙漴狀僮幢䚒𣴣
cuan1	摐牕瘡窗窻撞-𡆪
cuan2	噇{～飯}幢床牀䭚𩃕
cuan3	闖
cuan5	剏創戧㦼䚎
suan1	双孀欆艭雙霜驦䨇𩀝
suan2	漺+
suan3	塽慡漺爽
guan1	光炛灮炚咣垙姯桄洸珖胱觥𤗶
guan3	廣广
guan5	光{～臉、～胡子}榥櫎矌誑{字彙音}逛㤮𤗶𨤡
kuan1	劻匡框洭眶筐誆䯑𨴑
kuan2	抂狂桄{～線}誑㾠𢙌𣴥
kuan3	怳𢓯
kuan5	况壙懬懭曠框礦纊貺鑛矿犷𣋷𦚞
huan1	巟慌肓荒鎤㠵㡆㤺𣺬𥞙𥠸𩥒
huan2	凰喤墴媓徨惶湟潢煌璜皇磺篁簧艎蝗蟥遑鍠隍鰉鷬黃㞷㾮𤛥𪏙
huan3	兤恍愰滉幌謊
huan5	幌晃晄榥熀𣄐𣄙
uan1	尩尪尫望-汪㴏忘-𥆚𪶁
uan2	亡忘-杗王
uan3	往徃惘枉棢瀇網罔誷輞魍㳹㴏𣇭𣶂𣶈
uan5	妄旺望=泳㴏忘=𥩿𧧄
ben1	奔捹泍浜渀犇畚賁錛㙃𣳰𥝯𧾜𩣺
ben3	夲本泍畚笨㤓
ben5	逩奔笨𢜘
pen1	匉噴{～沙子：毛雨子}歕笨-{～子}𠽾
pen2	歕浜湓瓫盆㖹㙃
pen3	体呠
pen5	昢笨馞噴{～香}
men1	懣悶
men2	捫璊門們盟+明-{～个}𤅣𨳇
men3	暪
men5	悶燜懣璺𣚪
fen1	份分吩妢帉昐棼氛汾紛芬雰𡵳𢁥𣬩𣱦𩝀
fen2	坟墳幩弅焚蕡蚠
fen3	粉㥹
fen5	份僨分奞奮忿憤濆瀵糞𡊄𡏰
den1	噸吨墩惇敦橔橙涒燈犜蹲=登竳豋蹬𥂦𧯭
den3	吨坉戥盹等躉
den5	噸囤墱扽揗暾楯櫈凳沌涒潡燉盾瞪蹬遁遯鄧鈍=鐙隥頓㡒䙞𠎻𢬼𢯭𩍐
ten1	吞暾熥㧷钝-𤶕𧰥
ten2	屯滕漛藤疼窀籐臀臋芚謄誊豚飩騰魨㡒㹠䠮𣹸𤹤𤻴𧑞𧱔
ten3	伅庉氽黗㖔𪑒
ten5	褪{脫}吞?{～子：嗓子}遁遯
nen1	嫩-
nen2	能㴰
nen3	冷
nen5	媆嫩=𤯦
len1	楞-{粗野}扔日+{～裏：白天}闰-䵑認-
len2	人仁仍任侖倫儿圇壬崙忈掄棆棱楞{～嚴咒}淪獰{字彙音}礽稜綸芢輪䄧䭢𤯔𤷔
len3	冷屻忍棯牣稐稔腍荏衽飪㠴㣼紉{縣志音}纫{縣志音}刃𢆉𪍴
len5	仞任倰刃妊姙恁惀潤牣訒認=論賃-踜閏靭韌飪㱥䇮楞=愣
zen1	争偵嗔噌增媜層帪延征徵怔憎揁斟椹楨榛橧正溱烝爭猙珍珎瑊瑱甄眞真睜睁瞋矰砧禎箏筝箴繒缯罾臻葴蒸蓁貞贞針针鉦鍖鍼䋫診+诊+贈+赠+曾鎮+镇+{压}症𠄙𠏄𢓞𣁱𥪘𩗲
zen3	姫怎拯整朕枕氶畛疹稹紾聄袗診诊軫缜鬒𢒀𣦔𤵜𤵲𤺋
zen5	侲僜塦娠振掙枕政正甑症證証证諍诤賑赈贈赠鄭郑圳鎭鎮镇陣=阵=震𣃻𩏠
cen1	偁偵崢憆挰掁撑檉浾盯瞠瞪稱穪称蟶蛏阵-赬𣛟㵾凈𥊰𥊲𥊼𨅝
cen2	丞乗乘呈坅城塵宬宸岑嶒忱愖懲成承晨曟曾桭橙橬沈沉洆涔澂澄瀓珵瘎眹程臣裎誠诚諶谌辰娠郕陳陈㞥䅾䆣䇸层𠅟𡒲𡔚𢌼𢗑𨻰
cen3	徎浧祳脤蜃逞騁鴆磣{飯菜裏夾雜泥沙}𡈼
cen5	剩疢秤稱称趁趂蹭牚
sen1	伸僧升参參叅呻声妽娠斘昇曑森槮殅泩深滲渗牲狌珄珅生甥申笙篸紳绅聲声身陞㐼㮱㽒𠫵𡰬
sen2	溗澠神繩蹲-䋲绳
sen3	哂嬸婶審审杏沈渻省眚矧磣諗𥄾
sen5	勝墭愼慎抻晟椹渗滲甚瘆盛聖腎肾葚䜟蜃
gen1	埂庚更根畊秔稉粳羹耕賡赓跟鶊齦㪅今-𣏄𣥦
gen3	哽埂挭{推}梗耿莄鲠𠷊𢙾𢞚𣆳
gen5	亘更珢艮
ken1	劥坑妔硜鏗阬吭顉{低頭}
ken3	墾懇肯豤齦{啃}啃㸧𢡆
ken5	掯硍{垢}
hen1	亨哼𣨉
hen2	姮恆恒拫桁洐珩痕莖衡𢖍𢘆𦚣
hen3	很狠
hen5	啈恨荇行䯒𢙃𢚉
en1	恩嗯硬-
en2	橫
en3	㹙
en5	硬=
bien1	仌份兵冫冰嬪彬斌枌梹殯氷汃濵繽牝玢臏豩豳賓賔邠髕㯽瀕傧𡣕𢒹𢣐𣩵𦆯𨮘
bien3	丙帡帲怲抦昞炳禀秉稟邴餅𬼌
bien5	並併倂儐寎并幷摒擯柄棅病竝䈂殡鬢𠀤𢉟𢷤𩬆𩯔𭀀
pien1	乒倂姘抨拚拼涄淜𦀔𩰝
pien2	伻偋凭凴坪屛平憑枰泙洴淜獱瓶甁萍蘋苹評貧頻顰㰋䈂䍈𠙥𡛞𣳷
pien3	品牝聘+
pien5	娉聘噴{～香}
mien1	命-謎{猜～～}
mien2	名岷忞明暝朙民洺玟珉瑉盟-眀緡銘鳴㨉䁕𣇱𥌏
mien3	僶冥刡吻愍慜憫抿敏旻旼暝榠泯湣溟潣澠猽畝皿瞑脗茗蓂螟酩閔閩黽黾䟨𠋶𣙣𧱴
mien5	命=
dien1	丁仃叮奵玎矴酊釘靪㣔䟓盯𥸧{粘}
dien3	朾濎頂鼎𣇓𥅀𥇴𪔂
dien5	定忊矴碇訂錠𥆑𥇓
tien1	厛听桯汀聽听鞓㕔䯕𦗟
tien2	亭停娗婷庭廷渟莛蜓霆
tien3	挺梃涏珽頲艇鋌𥆑𨉈𩑙
tien5	听{～其自然}聽𦗟
nien2	凝嚀寕寧濘泞甯秂紉{字彙音}𡨴您
nien3	亃濘𦡲
nien5	佞吝悋磷藺蔺𡩋
lien1	拎衑㩕另-
lien2	〇伶倰凌呤囹坽姈崚彾怜斴昤朎林柃櫺泠淋淩潾澪狑獜玲琳璘磷秢綾羚翎聆臨苓菱蛉衑跉軨鄰鈴陵隣零霖霛靈鱗鴒麟麢齡㝝㯪㸳䴒寧獰擰濘泞嚀檸𠱠𡕮𤜙𤣍𤣤𤫊𤴤𥻘𩖊𪊲
lien3	凜凛嶺岭廩懍檁袊領㐭𥠌𪷤
lien5	令另潾皊賃=躪
jien1	京亰今=侵巠巾惍擎斤旌晶汮津浸涇睛矜筋精經腈荆蜻衿襟觔金驚惊鯨鶄㑴㓎䈥兢莖𣷽𣻒𣻓𥎅𫝆
jien3	丼井僅儘剄寢巹景暻槿殣漌緊謹警錦頸饉䌍桱𢀿
jien5	僅僸凚勁唫噤圊境寖徑憼搢敬晉桱樈浸淨溍滰漌濜濪燼獍璡盡禁穽竟竧竫競竸縉脛覲賮贐近逕進鏡阱靖靜靳㘦㝻㬜鯨𡩻𣥪𣷽𤂅𤵞𥪰
qien1	傾凊卿圊欽清菁衾親輕青鯖侵=氫
qien2	勍勤噙堇夝尋-岑廑情慬懃懄捦擎擒斳晴檠澿琛琴矜禽秦芩芹鬵鯨黥㕋桯{～凳}
qien3	寢檾漀褧請頃苘{～麻}𩒵
qien5	倩凊慶汫磬罄齽㵾撳親{～家}𢝑𥥻
xien1	兟妡姺屾心芯忻惞惺新昕星欣歆煋猩甡腥興莘薪訢詵辛馨騂鯹㙚㛙鋅鑫𢓠𣘘
xien2	刑型形桁洐行邢鋞陘㣜桁+𣸝𦡅
xien3	伈悻惺擤渻省醒㝭𢜫
xien5	信倖囟姓幸性杏汛沁臖興蕈衅行訊迅釁䒖䪿𡴘𢔛𢩲𤜢𤯕
ien1	侌喑嚶囙因姻婣嬰愔慇攖朠楧櫻殷氤洇湮瑛瓔瘖禋秵纓膺英茵蠅蝇裀陰隂蔭音駰鶯鷹鸚㡕𢰶𣱙𤯠𤸌
ien2	凝吟唫嚚圁垠塋夤婬嬴寅崟楹榮-泿淫滎滛淫濙濚濴瀛營狺珢瑩盈縈螢贏迎銀齦㞤㹜䤰𡷪𣽮𤄞𤟣𫲓
ien3	尹嶾廴引影懚癮檃櫽洕濥濦狁璄穎縯蚓蝇蠅郢隱靷飲㥯㥼䌥𢎢𢒬𢪉
ien5	印媵廕憖應映暎窨飲{牛～水}胤蔭賸酳䅧䕃𣋋𩂥
luen1	閏-
luen5	潤閏=
zuen1	墫尊樽澊罇肫衠諄迍遵𤮐
zuen3	僔准埻撙準譐𥫱
zuen5	俊峻捘燇𥊭
cuen1	春村杶椿櫄皴邨
cuen2	存漘脣
cuen3	忖惷蠢㖺䐏
cuen5	寸櫬襯齔䞋忖吋
suen1	孫搎猻蓀飱
suen2	憌淳純蒓蓴醇鶉𡗥
suen3	損吮榫笋筍隼髄𩪷
suen5	瞚瞬舜順
guen3	丨惃滚滾睔磙穬衮袞鯀㨰䃂𣽙𥕦𬡄
guen5	棍𠞬𧸫
kuen1	坤堃崑惃昆晜琨瑻蜫裩褌{～頭子：短褲}錕髡鯤鵾㒭㡓
kuen3	壼悃捆梱稇綑閫
kuen5	困梱涃稇閫㫻𢈛
huen1	婚惛惽昏殙涽葷閽鯶𣇲
huen2	媈忶楎渾琿餛魂
huen3	倱夽惲慁混蕰蘊𡘝
huen5	圂溷諢鯶混𣎚𦡵
uen1	氳温溫瘟緼縕蕰豱㬈問-
uen2	妏彣文紋聞蚊雯
uen3	伆刎吻抆穩鞰韞紊𥦊𥧚𨆲
uen5	問=搵汶璺紊𤪭
jyen1	君囷均皸筠軍鈞麕㚬菌𡈀𢛕
jyen3	窘笋䐃
jyen5	俊儁夋寯峻懏晙浚珺畯竣菌逡郡餕駿鵕㴫𡋴𡍵𣹯
qyen1	覷?{凑近看}
qyen2	唇宭帬漘羣群脣脤裙䭽𠹩𢂽
qyen3	稛窘
xyen1	勛勲勳塤壎曛焄熏燻獯纁薰醺
xyen2	尋=巡徇循恂撏旬樳洵潯灥狥珣荀詢郇馴㨚㫬㵌𡬰𢞧
xyen5	噀巽愻殉潠訓遜馴訊迅汛
yen1	暈
yen2	云勻囩妘愪橒沄溳澐秐筠篔紜耘芸鄖雲
yen3	允栐殞永-泳-詠咏-狁隕
yen5	咏孕惲愠暈泳煴熨詠運鄆醞韵韻酝蘊韞𡅙
bon1	堋塴崩弸漰痭絣繃嘣𢏳
bon3	誁㔙繃𧚭
bon5	蚌泵迸蹦𧻓
pon1	匉埄埲抨砰怦氽漰烹㠮㤣㧸䦕
pon2	堋塳庄彭朋棚澎稝竼篷膨硼芃蓬蟛髼鬔鵬㱶䴶𣨥𤡭𥭗
pon3	捧淎㷯
pon5	姘掽碰硼𢼩𥕱𨅘
mon1	夢梦-虻{牛～}蠓{～虫子}
mon2	幪懜懞檬懵曚朦氓濛獴甍盲瞢矇艨萌盟=蒙蝱㩚䤓𢡗𣞑𣱅𥌱𦿏
mon3	氼猛蜢錳蠓𦆟
mon5	夢夣孟梦=㝱
fon1	丰夆妦寷封峯楓檒湗烽犎瘋葑蜂豐酆鋒風縫-
fon2	堸摓渢漨縫逢馮㵯
fon3	捧諷賵
fon5	俸唪奉鳳縫=
don1	冬咚埬崠東涷苳㫡𢔅𢛔𧯾
don3	墥懂董諌䂢𢤦𣿅𦡂
don5	凍動=峝崠恫棟洞=湩筒胴蝀㓊䆚侗𪔦
ton1	恫狪痌蓪通洞-動-鼕𢂓
ton2	仝佟侗僮同哃噇峒庝彤晍曈桐橦浵潼疼痌眮瞳秱穜童筒筩艟茼蕫衕銅㛚㤏䆚䳋𢈉𥩌𧱁
ton3	捅{移動}桶筒統㣚䉥𨈹
ton5	慟痛蘣{可愛}𢣛
non1	弄-
non2	儂噥憹濃穠膿襛農辳醲鬞𤅌𩟊{將就}𪒬
non3	䵜
non5	弄=挵癑齈㳥𠧗𢙱𨑊
lon1	礱
lon2	儱嚨娀戎曨朧櫳毧氄漋瀧狨瓏癃篭籠絨羢聾茸蘢躘隆駥龍㝫㡣㰍䡁䪊𡃡𢍻𢤱𢦦𣮪
lon3	儱冗坈壟宂攏櫳氄竉籠茸+衖隴㲝㴳𣯍𣲽
lon5	徿礱
zon1	中伀倧偅妐妕宗忠忪棕汷淙綜{縣志音}稯終葼螽衷踪蹱鈆鍾鐘騌騣鬃㯶盅𩦲
zon3	傯冢塚惣憁搃摠煄瘇種种縂總腫踵㢔㣫𠣥𦔉
zon5	中仲偅種种粽糭綜縱衆訟誦蹤重頌㲴
con1	充冲匆囱徸忡悤惷憧摏沖冲浺淙琮瑽璁种聰舂葱蔥衝蹖重-騘驄㳘𧘂
con2	从叢崇崈徖從淙漎潨种虫蟲誴重㷓?{生爐子}𢓅𢔩𧝎𩞉
con3	寵矗𦖴
con5	揰昮銃㧤𣀒𧼩𭥐
son1	倯娀崧嵩松枀淞濍蜙鬆㣝𢓣𢔋𤾥
son2	㞞𩩺
son3	悚慫竦聳𢥠
son5	宋送㮸𢚍
gon1	供公功宮工弓恭愩攻篢肱蚣觥躬龔㴦䇗𠞖{鑽}𢖷𢙄𢚈
gon2	拱?{鼓起}
gon3	拱拲汞珙礦穬鞏㤨㧬𥨐𩌌𪍿
gon5	供共戇灨貢贛
kon1	倥崆悾涳空箜
kon3	孔恐㤟𢙷
kon5	空控
hon1	佟哄洪渹烘薨訇轟鍧鬨𠴨𥔀𥰲
hon2	仜吰妅宏嶸弘橫汯泓洪浤渱竤紅肱虹=訌鈜鐄閎鴻黌䆖𡇳𢂔𤄏𥥈
hon3	嗊汞渹澒哄𠳃𣽝𥔀𦑟𦕷𨰌𩗄
hon5	橫{～直，蛮～}蕻鬨哄訌㶇
on1	翁瓮嗡{～子：空竹}聬㺋䩺
on3	塕暡滃㘢𡩥
on5	瓮甕罋齆𨞑
jion3	僒冂憬扃浻澋炯窘絅綗菌褧迥逈駉𢂶𢄗
jion5	澃
qion1	傾-
qion2	卭邛惸璚瓊穹窮竆笻藭蛩跫㷀𤢶𥧺𥨪
xion1	兄凶匈洶汹胷胸芎𠒋𠣏𣋶𣳸
xion2	熊雄𤠗
xion3	洶𣶑
ion1	噰墉壅庸廱慵槦澭癰邕鄘鏞雍雝饔㟾㽫臃傭用-
ion2	傛榕傭嫆容曧榮溶滎滽瀜熒熔瑢肜蓉融螎鎔顒㣑
ion3	俑勇埇恿悀慂擁永=泳=咏=涌湧甬蛹踊踴㦶𢶜𧗴𩟀𬽃
ion5	用=邕𧜇𧝸
baeh7	仈八哵跋=拔=捌朳㧞𧈢
paeh7	𥐙拔-跋-
maeh7	帓抹袜䀣𩨲𪒜
faeh7	伐傠垡栰橃沷法砝發筏罰閥乏髮𨋺
daeh7	妲怛搨搭撘瘩答荅褟褡詚達嗒笪鎉靼韃㙮䞙沓𣸉𤺥𧝡𨃚𨅞𨨹𩞰
taeh7	傝嗒嚃塌塔墖撻榻橽沓涾溻漯澾濌狧獺踏蹋拓遢闒闥鞳㒓㣵㧺㿹䂿䃮䈳䑽{秧～子：農家小船}䓠𡌩𢞠𢺉𣥂𣿔𤒻𦧟𦧭𧴡𨌭𩌇
naeh7	吶妠抐捺納衲鈉㨥䈫
laeh7	剌拉揧瘌磖糲臈臘蝲蠟辣邋鬎䃳𣋲𤀦𩮝
zaeh7	劄匝卡咂砸哳唼噆囃囋帀扎札煠炸{煠}眨磼紥茁襍鍘閘雜軋+㱜𠯗𠰏𠹗𠽻𣧖𨰉𨵊𩿤
caeh7	刹察插揷擦攃歃礤臿詧遪鍤㮑㴙㵤𠽹𢣼𩴳
saeh7	扱撒擦殺潵煞甩箑翣薩趿霅霎靸颯㞚{楔：木頭～}㪪{楔：木頭～}𠎷𡐥𢅑𢔣𢟌𣜂𣻑𤋣𥻦𧭂𩆅
gaeh7	莢夾-挾軋+
kaeh7	嫐恰掐狹+{促～：捉弄人、做缺德事}殎
haeh7	合瞎𥈎轄-狹-匣-下{一～子}
aeh7	壓庘押軋鴨㳌阿{～斗、～哥}𢮊𦉟
jiaeh7	俠呷嘠圿夾=浹帢恝愜戞挾梜爵甲篋胛脥莢蛺袷裌跲郟鉀鋏頰㥦䀫𢎘
xiaeh7	俠匣峽挾{要～}柙洽{字彙音}狎狹硤祫笚筪舝轄=鎋黠㭘
zuaeh7	窡鵽{秧～子：一种喜歡在稻田裏活動的小鳥}䂐䆯□{吃}
suaeh7	刷唰靸{搭～子：拖鞋}
guaeh7	刮劀括栝桰聒适颳鴰䯏𣸅𣁳{～水}
kuaeh7	䯇□{挖～：坏点子多}䯇?{絆；尖利物將衣服等扯住：衣服～破了}
huaeh7	滑猾㩇豁{～拳、出～子}𡑧𡯜𧽌{跳躍：～溝；陡然升迁：他～上去了}𩨔
uaeh7	嗗挖穵襪韈袜
buh7	妭撥癶盋缽跋蹳軷鈸鉢䯋脖鵓{縣志音}
puh7	潑醱㗶㧊𣸍勃{縣志音}渤{縣志音}
muh7	妺帓抹昩末沫瀎眜秣苜茉䬴䴲𢗿
duh7	奪咄掇{拾～}敠蝃蝝裰㣞{慢行：慢慢向前～}䞵㿴{𥀰～：遲鈍}
tuh7	侻挩脫𤿫𨌔
nuh7	劣□{牙齒不好的人慢慢嚼}
luh7	劣那+哷埒捋浖㭩䟹𢚃𣸐𥀰{～㿴：遲鈍}
zuh7	啜惙拙攥梲歠涰畷綴繓諁輟餟
cuh7	啜撮涰輟
suh7	說𠞯𤀤𧺷𢶍{搕～：垃圾}
guh7	割合佮{～伙}懖括葛蛤轕适騔鴿㵧䀨𩢛𩦞
kuh7	嗑嵑渴濶瞌磕闊㵣𤸎
huh7	佮合喝奯曷活盍盒褐豁{～然、～口子}閤闔㧁䶎𢄍𣁳
uh7	姶捾盫𤂷遏搕{～搕：垃圾}
jiuh7	决厥廴抉橜決潏獗玦絕蕨訣譎蹶鐍鴃䙠孓𢇍𣅡𣲺𤯚
qiuh7	亅厥{昏～}妜橛缺缼鈌闋闕炔㵐𡙇𣅡䂐{短～～}
xiuh7	泬穴+渫禼糏屑薛血雪㳿䆝𥜽楔{～子話：閑話}
iuh7	刖悅戉抈曰月樾玥粵說越軏鉞閱𡛟
bih7	別斃憋癟襒蹩鐅鱉鼈㧙䥕𢠳𤮕𤺓𥞲
pih7	丿嫳憋撆撇潎甂瞥鐅䥕𠟈𢠳
mih7	滅篾蔑衊㒝𥯣
dih7	曡疊叠垤堞揲昳牒瓞眣碟絰耋喋=蝶=諜跌軼+迭㦶𢮕𢶣𣆹𣡭𥷕
tih7	喋-蝶-帖怗貼跕鉄銕鐵餮驖㤐䴴
nih7	乜囁囓夨孽帇懾捏捻揑涅湼糵聶臬蘖讘躡鎳鑷闑齧㘝㚔𠕄𡆴𢫻
lih7	冽列劽咧姴巤捩栵洌浰烈熱獵裂躐鬣㤠㤡㭞劣𡿩𡿪𢀂𢟯𣶄𣸟𤖺𩧆
zih7	哲埑折摺晢晣歽浙㝂䓆䇽{～子、～圈子：茓子}蜇蟄{縣志音}這+𠽻𣠞
cih7	屮徹掣撤澈輒轍𡜯𢬴
sih7	帴涉舌設蝕折{～本}懾攝𣥩𣻣
jih7	倢偈傑刧刼劫婕孑尐幯截捷接揭杰极{驢負物}桀桔楫楬楶榤檝櫛櫭洯浹滐潔洁癤睫碣竭笈節結羯蓵藉蛣蛺蠞訐跲輒鋏頰{字彙音}㔃㛃㦢䀹𠃲𠐉𡇼𡩣𢬴𣮌𣳱𣶏𤻵𧞛
qih7	切匧妾怯挈淁窃竊篋輒㗫㫸㾀𢬴𥧼𥨱𥨵𥨷
xih7	俠洽{縣志音}協叶{～韵}揭{～鍋盖}屑徢愶拹拽挈枻歇汔洩渫滊熁爕燮穴糏紲洩泄絏綌脅脇蝎褉褻㙝㛍㦪㳿㴮㴽䙝𡎮𡭴𡭽𢂐𢞜𢡁𣹩𤓖𥍏𪍛
ih7	僷咽噎拽擪擫暍曄曗曳+業潱澲燁盫葉叶{葉}謁軼遏鄴鍱閼頞頁饁𠄅𢢜𣩫𩇠𪑦
bah7	亳剝博帛懪欂泊爆{煿}煿{～蛋、～餅}犦礴箔膊薄=鉑雹駁駮𤿈𥭖𥴮𥴾
pah7	仢帕+珀懪扑{接住}拍撲擈朴樸檏泊烞璞瓝瓟箔{～子}粕鉑薄-{～粥、～刀}雹-㗘㩧㵡䈏杷𢑾𢷏𥐚
mah7	嗼塻寞幕幙摸漠瘼瞙膜莫鏌
fah7	搏縛
dah7	吒喥{～舌子：說話吐字不清}度{猜～}沰{～雨、一～牛屎、～鍋腔}耷{眼皮～下來、拿毯子～肚子}踱鐸㤞㧻㩉{用力摔打：～爛泥、～章}𢜬
tah7	仛庹托拓挓柝橐汑沰矺籜袥託馲𣔳𣶦𧘐𨃚
nah7	搦掿諾喏
lah7	叒弱樂{快～}洛渃烙珞笿{籃子}箬{粽～}絡肏若落蒻酪雒駱㦡䈷𠄇𡁆𥯛𧭥𩂣
zah7	作擆斫昨着筰酌酢𣹧
cah7	焯{～菜}簎{用工具將水中之物撈起：把餃子～起來}綽錯{～過机會}鑿㪕𦁎
sah7	勺圴妁妰彴扚斫杓溹灼爍犳石碩索芍鎍鑠䌇𢱢箾?{打：～耳刮子}𥯩
gah7	各咯硌胳埆捔擱桷确角閣覺-{～老、～索}
kah7	搉{～大蒜頭}殻殼㩁㱿㲉𪇄𫖡{下巴～子}
hah7	佫壑學-{～話}榷*{～子}涸癋貉郝鶮鶴㴶𤃯𥀣𦞦
ah7	僫噁堊惡噩琧𢙣𢝏
niah7	瘧虐
liah7	剠掠略畧㨼
jiah7	呷噱嚼屩屫斠榷{獨木橋}爵珏瑴甲脚臄覺={知～}𡕚𡬠𩰥
qiah7	榷{商～}傕却圶埆帢恪恰愨慤搉皵碏確舄覺郤雀鵲㡊㩁㴶𡇱𣒆𣛵𥯚𪴮
xiah7	削學斅澩觷謔鷽㕰𣪎
iah7	岳嶽愕捳樂{音～、姓～}湂瀹礿禴篗籥約耀萼蕚藥葯躍遌鄂鑰鶚鱷諤顎鍔鸑龠㿢𤂼𤾫𥸤
zuah7	丵倬卓啄啅捉擢攫斮斲斵晫桌椓浞涿濁=濯玃琢硺穱篧鐲=鷟㔬㧻{～屁股、筷子～～齊、～帳}㹿𢁁𢢗𥇍𥢔𩆸
cuah7	娖戳擉鐲-齪㪬𨆬濁-{裝～：佯裝不知}
suah7	嗍{吮吸：～棒冰、～指頭}𠲿揱{～腮：两頰瘦削}搠數数{～見不鮮}朔{～氣}槊矟𣓞
guah7	廓墎姡椁槨郭㗥𥕖
kuah7	廓擴攫漷躩鞟鞹㨯
huah7	攉濩癨穫藿鑊霍㦜䈅䉟𣉒
uah7	偓喔嚄嗀{嘔吐}幄握楃沃{～港：地名}硪硺鸌齷𣵽𫫊
beh7	不
peh7	勃{字彙音}哱孛挬浡渤{字彙音}綍脖艴荸郣餑{麪～：和麪時防止沾手的乾面粉}鵓{字彙音}㪍㴾𥹸𩣡𪌰拂{聚攏：～起來}
meh7	圽歾歿殁沒没{沉～、～得}𣩭𣴬
feh7	乀佛{仿～、～教}咈帗弗彿怫拂柫*{～板}沸濷狒甶疿祓笰紱紼艴芾茀髴黻㚕㵒䀟𡗻𣲴
deh7	咄*{雞啄物}嚉得德悳淂特蟘㥁𡭂𧎬𧴫𨁽
teh7	凸堗忑忒怢慝揬湥特突蟘㥂㧹脱+{丟失；～班：晚点}𠊲𡺴𦝬𧎬𫻪
neh7	仂捏?勒?忇扐氻泐肋肭訥鰳㕯㪐𡎳𢗉𥭐
leh7	入-廿日馹肋勒那+
zeh7	仄侄値則厏厔指+{～頭}這+只嘖{不～聲不～气：不說話}執执墌妷姪宅帙幘幟庢徏恎执拓挃摘摭擇擲昃柣桎植樴殖汁洷淔湜漐澤濈炙熾瓆直矺磔礫秩秷稙窄窒笮簀織翟職膱蚱蛭蟄蠈諎謫豑責賊質跖蹠躑迮郅銍陟隲隻㨁㯰䐈塞+{瓶～子；～當：堵車}𠟭𡘺𡥺𡮞𣅦𣛸𣤈𣳀𣻩𣽚𥃫𥯧𧶷𧷤𨕠𩞡𫌁
ceh7	側册勅叱坼尺庂彳惻拆敇敕斥栅測畟笧策筞筴赤飭㡿㳁㿭𡚨𣂙𤂄𤰠𥮫𥮮𪄠
seh7	什十嗇塞失奭室寔實式懎拭拾摵栻歮歰湜溼澀澁濇濕瑟璱石祏穡色虱蝕蝨螫識軾適适{適}釋食飾㥶䄷䉢𠎸𡔂𡺶𢞮𢡉𣥒𣴻𣺯𣿠𤁧𤨝𥅞𥢺𥤧𰙩
geh7	嗝圪垎塥挌格槅滆疙肐膈虼諽隔革骼鬲麧㗆䬣胳+軛{牛～頭}𤜸{～猪}䞘{单脚跳}𢓜𣏙
keh7	克刻剋咳喀娔客尅欬犵肐可{～汗}𡞢
heh7	劾唬{嚇}嚇核{～實}紇纥覈諕{嚇}赫黑嘿齕{咬：～骨頭}㱄𢡀
eh7	厄呃{打～}呝屼戹扼搤軛阨額𣢛𩚚𩚬
bieh7	佖偪壁弼必怭愊泌湢滗滭潷煏熚珌璧畢皕碧笔筆篳苾襞觱躃辟逼鞸鼻=㘠㳼㻶䇷𣴡𣴨𤁭𤂀𤅳𧰆
pieh7	鼻-僻劈匹擗澼疋癖闢霹枇
mieh7	塓宓宻密幂幎樒汨沕淧滵漞濗蜜覓覔謐㫘㵥䎵䤉𥦀𧱻
dieh7	啇嘀嚁嫡廸扚{拔}敵旳樀滴狄玓的滌=笛糴苖荻菂覿鏑靮㢩𡆣𡒱𤁷𤂂𤾠𨗹
tieh7	俶倜剔惕掦摘滌-趯踢逖𢞫𢱦
nieh7	匿惄暱氼溺逆鶂㥾㲻
lieh7	傈凓力厯律率{效～}慄曆栗栛櫟櫪歷溧瀝瓅癧礫立笠粒繂繘苙荔+躒轣酈靂鷸㯤䋖𡗓𢊆𢟳𢯰𣲒𥖪𨇗𨣷
jieh7	給{～你、供～}丮亼伋佶劇勣卽及吉吸喞圾+塉墼姞嫉寂屐岌彶忣急愱戟拮撽擊敫桔棘楫極极{極}檄檝殛汲洁漃激濈獥疾瘠禝稷積笈籍級績聻脊芨蒺蝍覡跡踖蹟輯迹集頡魙鯽鶺㔕㗊㘍㞃㡮㤂㥛㦸㧀㮨㲸㲺㴔㻷䳭𠈶𠋻𠴫𡁶𢙅𢞱𣖷𣘐𣳬𤠎𤷉𥡂𥡯𥤽𪵫
qieh7	七乞刺吃咠喫吃噄墄忔慼慽戚柒桼泣湆湇湒漆犵緝葺訖詰迄㣬㭍㯃𢔆𢔠𢜱𣲔𣸡𣾰𥖫
xieh7	吸咭坹夕媳席息悉惁惜昔晰析椔檄歙汐汔汽淅潝潟熄皙磶穴穸綌習翕肸腊{乾肉}膝舄蓆蜥蟋裼褶襲覡賉錫隙隰鬩㝜㭊㱤䈪𢂲𢘻𢙆𢙍𣊣𣚔𣶁𣺁𦡀𧀬𧈅𩊿
ieh7	屹一乙亦佚佾俋億嗌嚥埸墿壹奕妷帟弋悒憶懌抑掖揖斁易{姓～、～經}晹曳杙檍歝汽泆洂浥浳液溢縊{縣志音}澺益繹翊翌翼腋臆芅蜴譯逸邑鎰靨驛鳦黓㳑㴁㴒𡖋𡗜𢡃
lueh7	入=
zueh7	卒朮{白～}柮
cueh7	出怵捽絀詘{同黜}踤黜㑁㤕𠰕𣮈𥏘
sueh7	摔沭率{～領}秫蟀術{算～}述㾁𤗪
gueh7	愲搰榾汩淈虢骨
kueh7	圣圪堀掘搰撅矻窟胐㩿㵠𡑥𡼿𦜇
hueh7	囫寣忽惚搰核{杏～}𣝗{果核}糊{～涂、～東西}葫{～芦}榾欻歘淴笏㳷䀛䀜䬍𠥰𢗘𪆸
ueh7	兀勿扤杌{～子：凳子}殟沕物腽芴豗𩑦{～死：溺死}
jyeh7	倅卒憰橘桔{橘}獝矞聿譎趉倔崛蹫鵙鶌㹟𡲗𡲬𢩪𣨛𥎐𧽸
qyeh7	倔屈崛掘窋絀詘㤕𡲬𧌑
xyeh7	侐恤戌血㖅㤜㳚䎉䘏䬄噱{～頭}𥚋𧻗
yeh7	坄域役棫欎淢疫閾鬱郁{鬱}𢺴{捥}捥{～腰：向后弯腰}㚜𡌳𡨿𡿿𢈿𢗎
boh7	伯佰北卜擘柏栢檗{黃～}檘湐濮白=百舶蔔蘖鮊𣱶
poh7	僕仆{～人、～倒}圤墣幞拍撲啪扑敀曝瀑珀帕+璞白-蔔迫魄𡕠𢶉𣾴𤖼
moh7	万墨帞木沐洦牧目眽睦穆脈脉苜貊貘陌驀麥默㡔㵹㹮𢄏𥄈𩢷
foh7	伏匐垘幅復服栿洑澓畐福腹茯菔蝠袱複覆輹輻馥㙏㚆𡕨𢕒𢫯𥨍
doh7	凟匵嬻櫝殰毒瀆牘犢獨瓄督碡篤厾纛裻讀讟谾贕髑黷㒔䈞䫳𠉩𡴛𢃶𣰬𤞞𥓍
toh7	涋湥痜禿鵚𣒇
noh7	朒肭衂衄
loh7	僇六剹勠塶彔氯戮摝{撈}樚淕淥溽漉濼琭甪盝碌磟祿稑簏籙綠肉-膔菉蓐蓼蔍褥轆辱逯鄏醪錄陸騄鯥鹿麓㖨㫽𢑕𢛚𣯋𥂖𥉶𥚊𥜅
zoh7	劚{～耙：釘耙}哫喌嘱囑矚妯屬属斸柷燭祝竹{掃～}竺筑築粥舳足卒{生～、小～}躅軸=逐𠱙𢺡𥘱𨄃
coh7	亍促俶傗嬲慉戳搐斶族柷歜潚畜{～生}猝矗簇觕觸諔踧蹙蹴蹵鏃閦㩆㵀軸-𡻬𤠕𧢻𧣈
soh7	俗俶倐叔塾夙孰宿尗属屬憟束樕淑漃潚熟璛簌粟縮續肅菽蓿蜀觫謖贖速遬餗驌㑉㑛㒔㜚㳤㴼䔩𠅩𡖊𡖯𡬧𢞣𣶘
goh7	唂嘓囻國梏濲穀糓聝虢蟈谷轂馘鵠𥆘𥝻𥵠
koh7	俈哭嚳酷
hoh7	劃划{笔～}嚄{～子（脾气暴躁動輒喊叫的人）}惑或擭斛焀獲畫画穫窢繣觳鱯㩇㪶䈸𣁳𣂽
oh7	屋沃𣵽
jioh7	侷局挶焗掬梮淗菊諊趜跼踘鋦鞠鞫麴㥌㩴𡨅𥮗
qioh7	曲筁蛐麯
xioh7	勗慉旭旮滀畜{～牧}稸蓄頊
ioh7	儥喅堉彧惐慾昱欲毓浴淯澳煜獄玉-稢育郁鈺隩鬻鵒㤢㥔𡈭𢌻𣋉𣫺𣴲
m3	母{舅～、丈～娘、親家～}姆{～媽}
n	嗯
ng3	我-
